фактическ: город
репарац: потребовал запрошенные
экспорт: превосходил
обычн: обычную
оказа: оказались пережив
мыслен: мысленно
служ: служили
перееха: целиком молодое
приверженц: приверженцем
мнен: поражения
оплот: сделать
последств: последствий
заход: заходят
дополнительн: дополнительные
мероприят: мероприятиях мероприятии
арх: архив
предсказа: предсказал
черкес: черкесов
экономик: передовых экономика удержать отраслей
уговор: долгих
лидир: занимал
впечатлен: впечатление
сто: стоит
мечтан: мечтаний
возглавля: возглавляет
поступ: поступить
арм: армии армия армию
присутств: требовали
должн: должны
суд: предстал
сум: сумев
беспокойств: беспокойство
жестк: требовала жесткого жесткое отомщена жестко жесткие
назван: названии названием названию
благодар: благодаря
денег: палатках
провальн: скандалом
секретн: проводит
участвова: некоторое участвовала
примыка: примыкают
проект: условий проекта совместных
связ: связи укреплению
недовольн: недовольных
вперв: впервые
совместн: виде
опас: отношении
вьющ: вьющимися
дела: поступают делал делать вашингтоне
гонен: гонения
щупл: щуплым
дискусс: дискуссии
полага: помимо
отреза: отрезаны
устраива: устраивают устраивает
выматыва: однопартийцами
беремен: беременной
прелом: преломить
барон: барону
сделк: чехословакией
нападут: нападут
укрепля: программе укреплять
заработк: заработка
заявля: заявляют
сионист: сиониста сионист сионистов
родин: родина родине
весел: веселья
уровен: повысить
нов: установить нового количества новом новой новую новые
ног: встающего
убежд: убежден совета
раввин: раввин
почувствова: почувствовал
част: частях большую
подъеха: подъехала
медсестр: медсестрой
слов: слов словам слова словом слово
постоя: рутина
сдела: сделав предлагая сделают сделал
единомышленник: единомышленников
рожден: рождения
кровав: кровавых
поруча: поручают
абдел: гамаль
деактивирова: нажмите
сложн: сложных
цар: царь
дают: связей
зажиточн: зажиточным
палестинск: палестинской палестинских палестинские палестинским
фигур: значимой
совет: прося
нос: носят гурионом
нот: направляет
вперед: вперед
пример: личный
ноч: ночами ночь
стабилизирова: торговые
колониальн: колониальные
военизирова: военизированное
трудя: трудящихся
исраэл: исраэле исраэль
государствен: выдающемуся государственность государственный часть
летн: летнего летний
национализац: делает
отмеча: настояниям
перебра: перебрался
трудн: трудные
лета: летают
обрабатыва: обрабатывают
курс: курсом выбранного
сша: сша
лидер: лидер лидера лидером лидеру лидеры лидеров
машин: машина
групп: группу группой
техник: техника
приступа: побеждает
требован: требования отвергает
пуска: пускают
постепен: постепенно
культур: культура
плаван: плавания
переизда: переиздать
перенест: велит
могуществен: превратится
провозглас: провозгласить провозгласив
цви: цви
врач: врачу
ужесточа: систему
напряжен: формированию
купа: купался
склад: склады
враг: враги врагами
вклад: видны
броса: бросает
жител: жители жителя жителей
овац: овацией
укреп: сильно укрепили
взор: взор
словн: словно
новоприб: новоприбывшими
сын: сына сын
бальфурск: бальфурской
интерес: интересы
утрачен: возвращая
средств: средства
сказыва: сказывается
потребова: неожиданный
евр: евреи
отключ: комментарии
борьб: борьбы борьба борьбе
толп: толпы толпа
болгарск: переехали
едв: хватало
вашингтон: востоке
убед: убедили убедить александрии
разорва: разорвать
числен: численное
счита: считал решится считали
прибыва: прибывают
цел: главной приезжать
премьерск: побороться заняв
лент: лента ленту
сообща: сообщал сообщает
внешнеполитическ: наступила
подрыв: подрывая подрывом
вооруж: вооружиться
спор: противоречия
иностра: поиски иностранных
веден: ведении
серьезн: приводит мнению
африк: азии африке
воодушевлен: воодушевленный
стратег: интегрироваться
комисс: комиссия комиссии
отраз: сирия
след: следующий следам протяжении следует вдвое
институт: института институты
организац: организацию организации организация международных
аргентин: скрывавшегося
бюджет: дефициту
статус: международного
приемлем: приемлемое
лекц: лекции
так: такого таком таким
кибуц: кибуцев переезжает
соратник: соратников соратники спор
теодор: теодора теодор
событ: событие событии
течен: течение
поборот: выборы
приближен: приближение называли
собира: собираться
турк: туркам
соратниц: соратница
турн: турне
некотор: отставки турбулентные
противостоян: фокусируется
отряд: отряды
соглаша: соглашаются феврале
соглашен: соглашение
конрад: канцлером
стамбульск: стамбульский
попа: попало
остава: оставалось
бар: бар
спорт: спорт
израильтя: израильтян
услов: москве важных
возвра: перезапускать
престиж: международный
бежа: бежавших
израил: израиль экономическая израилем израилю израиля
приход: приходилось приходом
крах: экономического
спорн: подчас спорные
попол: разделен
парадн: парадного
поня: понял
краж: кражей
подчинен: подчиненная
железн: железные
рассказыва: рассказывает рассказывающую рассказывать
ограничен: ограничения
программ: ядерной
ежедневн: останутся
главн: главное достигнув
соответствен: порядок
фамил: фамилией фамилию
лавирова: подобно
страда: страдать
неразрывн: неразрывно
октябр: октября
израильск: зашли израильское израильской израильские облегчают летописи израильским
игрок: влиятельным
спекулянт: борется
отдел: отдела
бедн: бедных
улыбк: улыбку
созда: создал созданной созданную создать
нападен: верили отразить
нападет: протокол
вдовол: вдоволь
помн: вкладе
перестрелк: перестрелкой
занов: пришлось
выполн: выполнив
волос: волосами
энтузиазм: энтузиазмом энтузиазм
амбициозн: ставит
торжествен: торжественно
перестреля: перестреляем
тел: тель
тер: премьерский
полемик: полемику
пришл: смысле
полн: полны полный
подавл: подавлен
приглашен: приглашения приглашенных
местечк: местечке
нависл: государством
десят: десятью десятого десяти
бел: белую белой
достав: найти
бен: бен
выстраива: относительно
восторжен: восторженными
рамк: рамках
жесткост: проявлять
запрет: запретили
долг: отставку
долж: насер
останавлива: останавливают
услуг: услуг
десятилет: умер
кандидат: оптимальным
числ: числа числе
гражда: новых
период: периодов ожидания
беш: бешено
пойт: пойти
веселя: веселящихся
видн: видных видного трудов
очеред: экспорт
чита: читать
мечет: пороге
виде: видео
превраща: превращался
подход: подходит
положен: нынешним
едут: едут
вруч: вручили
продовольств: денег
процветан: внешнеполитического
нынешн: существования
сгуща: сгущаются
пережит: свежи
дебат: дебатов
назнача: назначают
принима: принимает принимать
повергл: репараций
объединен: объединенных объединения
бумаг: бумаге
палестин: палестине палестины палестину
присоединя: поздно
отрасл: собственных
окончан: окончания
прокат: прокатились прокатилась
защища: защищать
обитан: обитания
недел: недель недели
поддержива: насера поддерживает
обж: идее
египетск: египетские египетских египетском
включ: включая
повод: поводов
маляр: малярией
культурн: библиотек
оформ: оформить
спешн: спешно
сред: среда среди
социальн: социальные
налаживан: выбор
редактор: редактора
распад: объемам
мног: многим игроком многих
уста: устав
контакт: любых
избежа: избежать
язык: язык
преодол: кризис
останов: остановился
возрожден: возрождении
взят: взять взятым
катастрофическ: продовольствия
разн: разные разных
письм: письмо
взял: опасность
неожидан: неожиданностью
фермер: фермерам
нападок: нападок
плонк: плонки
освоен: школы
примкнут: примкнуть
огн: огня огнем
ожидан: превосходит
физическ: физический
площадок: инициатором
потесн: потеснить
малыш: малыша
удовлетвор: удовлетворены
супруг: супруге
облав: облаву
одн: давления одну одним одни одна
целик: общинами
согласн: согласны
пода: желает нюрнбергом
столиц: столице иной
ведут: ведут
действова: негодование
лорд: лорда
итал: италии
стычк: стычки
команд: проявив
кровопролитн: угроза кровопролитная
огранич: ограничили ограничить
корабл: корабль корабли
летопис: веку
уникальн: вставшие
увековеч: увековечить
участ: участию участие участившимися
давид: давид давиду давиде давида
десятк: десятки десятков
прислуша: прислушались
кресл: премьерское
облегча: организаций
март: марте марта
массов: массовым
существова: отмечает
песк: непригодных
глав: главу глава
сомнен: сомнений
глаз: глазах
ближн: ближний
протокол: тайный
сраз: сразу
сража: сражаться
встающ: вызовом
поступа: поступает партии
болезн: болезни
вполн: вполне
располага: располагались
назарет: назаретом
набожн: набожная
университет: школ университет
новост: новостями новости
корол: безуспешно
перв: первые первых выросло первым первого первая
расступ: расступилась
непрост: решая
мапа: мапай
юнош: юноша юноши
приня: принять приняла приняли
бол: боль болью
добр: деактивирована добра
осужден: осуждения
джеймс: джеймсе
равн: равно
основ: основой
птиц: птицы
отставк: вынужден задумывался сближению
перечеркнул: перечеркнула
поал: поалей
поначал: поначалу
холок: жертвы холокосте
ярост: повергло
перечеркнут: синая
герман: германия германии укрепляет
премьер: шаретом премьер
встреча: встречают встречает
последова: моссада
отыска: отыскать
земледел: земледелием
высок: высоко
реальн: пожаловать
тяжел: франции распад тяжелый
заста: застав
проводим: первостепенным
михаэл: михаэля биограф
синайск: процветания перечеркнуть
разведк: поставках
авиац: авиации
жертв: слушания
найт: моссад
компромисс: искать находить
независим: независимость независимых независимого независимости независимое
младотурк: младотурках
вызов: настоящим леса
ждет: ждет
возглас: возгласами
сина: синай
предлага: статуса
маленьк: маленькому
соглас: согласись согласие
успех: успехом успехи исполнение
произойт: произойти
усилива: усиливаются
убыл: иммиграция
рейх: рейхом рейху
вернут: вернуться
наряд: душу
вернул: вернулся вернулась
возглав: возглавил
подпольн: подпольное подпольная
конфликт: конфликт
бригад: бригада бригады
несконча: нескончаемый
туч: тучи
стремлен: стремление
преврат: ухода
самоуправля: самоуправляемые
поезд: поезд
исследовательск: ядерный
х: х
показа: важным
отправ: отправился отправил
узаконива: узаконивающую
вариант: колонии
убийц: получении
клятв: клятве
памят: ярость
безопасн: убыль безопасности
подписыва: севре
нажм: опечатку
коллективн: договора
резк: резко
удаст: удастся
оон: оон
сообщен: побед
боев: приступить боевой боевых боевые
власт: властей власти властями
немыслим: шок
французск: секретную вторгнутся
объявлен: объявления
перевод: переводе переводом
фронт: второго
важн: считает одно важнее принципиально
останут: нападения
город: резолюции города
газет: газеты газет
национальн: национальный национального
кров: пролитая
час: часов
локшинстарш: локшинстарший
внутр: оппозиции
традиц: традициям
шанс: шансов
крикнул: крикнул
льва: льва
могл: могли
мета: метался
удержа: валюту
движен: движении движение движения
подписа: подписал
больш: подвергается большой кнессет
мест: занял оснащение
надв: надвое
борет: активно
равня: ключевым жизненный
охраня: охранявший охраняли
вход: вход
инженер: инженера
офис: офисы
аналогичн: аналогичный
видет: видеть
бесспорн: бесспорной
гран: оказался
гарнир: гарнирами
британц: британцам британцы британцев
редакциярекламаконтактыпресс: отключены
видел: освоении
авод: авода
жизн: жизни
граб: грабят
израильтян: израильтянам израильтяне
населен: населения увеличить
погружен: погруженным
сформирова: сформированная
пыта: пытается
полноцен: полноценной
американц: правительство контактов
пошл: мест
смог: смог
встревожен: встревоженные
развива: проекты
авторитетн: становиться авторитетных
скрыва: доставить
репатриант: показать
отвезл: отвезли
отц: отца отцом деятелю
советск: сообщения бывшими вмешивается
чиновник: чиновников чиновника навещают
почв: почву
гостиниц: гостиницы
злил: злило
посетител: посетителе
яфф: яффы яффу яффе
скандал: разгоревшимся
турецк: турецкие турецкий
вызыва: вызывает
обнаруж: обнаружили
крик: крик
богат: богатых
принесл: стратегия
последовательн: правоту
исчезновен: исчезновения
ховев: ховевей
транспортн: транспортными
жел: желая
иерусал: иерусалим
жен: женится
прозападн: придерживаться
перебрасыва: перебрасывают
собак: собак
был: былой
закалк: закалка
установ: итоге
разделя: разделяют
войск: войска войск
негодован: международное
израилев: израилевой
локшин: локшин
мелк: мелкого
дефицит: приводило
египет: египет
угрожа: протеста
недобр: недобрых
пожалова: добро
отказа: отказаться
эрец: эрец
плоньск: плоньске плоньск
старш: старший
дипломат: силами
возника: возникает
авив: авива авиве
возраст: возрасте
галер: галереи
проявля: компромиссы безнадежной
политик: политика налоговую современные политик политике политиков
окончательн: ответственного окончательному
запрошен: настаивал
достич: которым
жив: живя
тупик: тупик
горожан: горожане
жил: следующих
приказыва: операции
зохар: немолодого зохара
стара: стараются
посредничеств: посредничестве
возвращен: возвращения непреклонность
телевиден: транслировались
добровольц: добровольцами добровольцем добровольцы добровольцев
еврейств: еврейства
меир: меир
преимуществ: преимущество
пост: посты руководящем занять
востоковеден: востоковедения
иордан: ним
вернувш: старика
корпус: корпус
итог: конечном
минут: минут
масштабн: масштабных масштабную
клетк: клетке
объявля: объявляют внезапно
перереза: перерезав
стремительн: стремительно
жит: жить
неформальн: неформальному
внутрен: раздирали
вскор: вскоре
заверш: завершилась
пришел: соседнем
гурионперв: гурионпервый
озер: озере
ответ: ответ ответа
диверсион: поручил
никт: никто
обществ: общества
порт: порт
несмотр: несмотря
срок: срока
букет: букет
иммигрант: первыми ноги прибывших
идеал: идеалы
единств: единство
облагород: обжить
держа: поддержкой
избра: избран
территор: новыми территории
уда: удалось удается
ввп: ежегодный
август: августе
вдво: население
отверга: иерусалима
ав: авив
турц: турции турцией
кварта: квартал
аз: налаживал
аэропорт: крупнейший аэропорта
ал: мечети
ввс: ввс
мысл: ужасах
месяц: месяца месяц месяцев
наемник: наемники наемников
экстремист: экстремистами
жми: жми
недовольств: недовольство
возвраща: возвращаться
организова: организовать организовал
бо: боев боясь
оказыва: оказывается
нашл: ооо
превосход: реальность значительно
провокац: каждую
достигл: достигли
заключа: нарастает
век: деятелей веке золотому золотым
вел: требование
очередн: очередной очередная очередное
вер: верил граждане верен веру
декларац: декларации декларацию
сотрудничеств: площадок предложил военном
ласка: ласкает
цвет: цвет
коричнев: коричневой
окажет: сирии
оккупирова: военным
кампан: синайской синайская
нача: начало выживание начал начали
возникш: возникшее
реша: решает решают
иракск: иракский
посольств: терактов
оруж: оружие ядерным оружия
значительн: значительное импорт
легион: легион легиона
возникл: разногласия
раздум: раздумий
возмезд: возмездия
взволнова: взволнованным
появлен: появлении появление
возьмет: возьмет
вслед: вслед
узк: узкого
речк: речки
юност: юности
заруч: стремится
уговарива: место
канцлер: немецким
настр: настрого
интенсивн: интенсивных
переж: едва
нестабильн: переживал
достигнув: выводят
контрол: контроль контролем
трехмесячн: покой
задач: выживания похожими задачей
нищет: нищетой
придержива: продолжило
гехалуц: гехалуц
трет: третьим положением третьему
смогут: смогут
подразделен: подразделений подразделения подразделению
влиятельн: экономик
пар: пару
ед: еды
предста: эйхман
искусств: искусств
отколовш: отколовшаяся
проник: проникся
разгоревш: объясняют
лондон: лондона лондоне лондоном лондон
торча: торчащими
саид: саиде
факт: обязан
довел: довелось
уйт: уровне
вид: видят видя результаты
барак: бывших
защит: союзника защиты
внов: вновь
чуд: чудо
науч: научиться
ноябр: ноября ноябре
иммиграц: иммиграцию преодолен иммиграции
негев: негевом
переживан: переживания
договор: премьерства сотрудничества кнессете
наук: наука
прогресс: наибольшего
пережива: переживает проблемами
эпох: эпоха
предоставлен: договаривается
памфлет: памфлет
известн: известно известный
сторон: стороне сторон стороны
постав: поставив
крыл: крыла
поток: поток
гамал: пришел
крауз: краузе
чум: чумы
призна: признает признавшего
тысяч: тысячами тысячи
ассамбле: ассамблея
родн: родных
библиотек: посольств
колон: бывшие
пуст: решительным
ид: идеи давней
варшав: варшаву
подконтрольн: подконтрольной подконтрольный
безработиц: росла
ин: трансиорданией
оборон: обороны оборона
республик: советскими
сыгра: центр
присужден: голосует
обяза: дипломата
план: плана полагались план
публичн: публичных
товарищ: товарищем товарищи
гроз: грозится
плав: экономику
группировк: группировка
призыв: призыву призывом
заболел: заболел
ключев: столкнулась сыгравший
считан: считаные
ровн: ровно
английск: английское английском
пет: петах
террор: террор
вста: встаю
шарет: кабмин моше бразды
собра: собрались собралось собрать собрался
граждан: думали
предстоя: предстоящем
гитлер: гитлером гитлера гитлеру
авигдор: авигдор
понятн: понятно
непригодн: прежде
попрос: американцы
поставок: поставок
чест: честь
убива: убивают
огромн: поставку обладал
безнадежн: казалось
изкор: изкор
примирительн: выжившим
ма: мае мая
вставш: вызовы
ответствен: эйхмана
увлек: увлекся
вод: воды
иврит: ивриту
вол: воли
отлич: отличие
побед: серии победу победой победил победа
диверс: диверсии
неприязн: неприязнь
громк: разразился
местн: местных местному
сист: карточную
насер: абдель неспособности
корреспондент: корреспондентов
выживан: закончилась важную
организ: организует
пил: пиля
молч: молча
стряпч: стряпчим
мандат: мандата
участк: участки
направля: советское
государств: государства еврейским западными государство государств государстве государству
налогов: ужесточает
османск: османской османская
проблем: проблемы экономическими
ужас: ужас пережитых ужасом
намерен: намерении намерение
раздел: раздела фактически разделе
латинск: африки
подростк: подростков
суэцк: национализации цели
сверстник: сверстников
лучш: лучшим
дума: проводимой
операц: пересмотреть диверсионную подготовку
оо: редакциярекламаконтактыпресс
оп: опыт
берегов: береговой
надпартийн: надпартийной
индульгенц: репарации
молод: защитил молодого молодая молодые молодому период
американск: американских
открыт: обеспокоенный
грин: грине грина грин
увелич: задачу
направ: направил
безуспешн: соседями
утр: утром
колен: колени
сердц: сердце
судебн: судом последовавший
взгляд: взгляды правых
бойц: бойцов бойцы
растет: оружием
восстан: восстания
бывш: иммигрантам ближайшими великобританию бывший
сион: сион сиона
мечт: мечте мечты
стабильн: развиваться
круг: круга
отпуск: трехмесячный
выступа: премьера
ребенк: ребенком
полицейск: полицейский полицейские
революц: революцией
наход: лавировать таланты
эйхма: окончательное преступника
египт: противостоянии египте
озвучива: озвучивает
погибнет: погибнет
потер: потери
пожелан: пожеланиями
париж: канала
ру: ру
непропорциональн: непропорционально
впоследств: впоследствии
понима: понимает понимал
оттоманск: оттоманское
оттуд: оттуда
охра: охраны
стат: стать статью статьи статей
воен: военная попросил договариваются чиновники франция военное военной
европейск: европейских выжившие
стар: старого
тикв: тикве тикву
рабоч: рабочая рабочих
стал: стали стала
посад: посадил
правот: курса
категорическ: случай
став: началась угрозами
работ: работы
центр: центре культурных исследовательский
мессершмит: мессершмиты
попятн: попятную
север: север севере
прорва: прорваться
привлеч: израильский
налажива: михаэль
получен: мысль инвестировали
пок: уйти
инфраструктур: строительство
вмешива: оккупировать
пол: сады
укрепл: америки
человек: человеком
лес: виноградники
лет: летом
неспособн: убедив
вооружен: вооруженных вооруженные вооружений вооруженному командующего
лех: лехи
взрыв: взрыва
то: кампании
структур: структуры
публикац: публикации
карт: карте
котор: которую переговорах котором
уб: прогресса
времен: временно временного временем
здан: здания
гурион: гуриона гурион гуриону разногласиям
осозна: осознает
силов: силовые
осен: осенью
запад: оплот западе
шаг: спорным шаги шаг
признава: признавало
связа: связана
прав: политики правило решимости право
ахдут: ахдут
ус: усы
угас: угас
внезапн: отпуск
нараста: напряженность
уч: учить учит
относительн: вопросу
про: военные
лик: каналом
лим: лимит
фруктов: выросли
верн: верная
устоя: устоять
обеспоко: обеспокоены
вывел: вывел
член: членов
книг: книгу книгой книги
разобра: разобраться
грандиозн: страной
этикет: этикету
ха: ха
союзник: привлечь республиками иностранного
альтернатив: существовало
одкб: коллективной
позвол: позволило
зал: зале
сосед: соседей арабскими провокацию
занима: занимавшейся занимают равнялись занимает
светл: светлое
монбаз: монбаз
лиц: лицам лица
встреч: встреча встречены встречу
карточн: вводит
лиш: лишив лишившись
севр: французским
современник: современников
теракт: теракт серию теракты
внешн: выстраивать внешним внешне
вдобавок: вдобавок
приговор: миру казни
устро: вариант операцию
бунд: бунд бунда
выписа: выписали
дворц: дворце
кана: суэцкого
одновремен: одновременно
отказ: сотрудничестве отказ
вежлив: вежливость
кровопролит: кровопролития
ликован: ликование
родител: родители
охранник: охранника
вблиз: государствами
донос: доносится
пут: путь путей пути намеченным
символическ: символическую
активн: политику плоды активному активную активной
плуг: плугом
русск: русской русское
подар: подарить
тигр: тигр
немц: имущество
строительств: экономики
самолет: самолет огромного
должност: должность
срочн: срочном
журналист: журналисты
подчас: пусть
узна: узнав узнают
пересмотрет: соответственно
навеща: бокере
убежда: убеждается
торгов: вводить
отступа: отступающих
нелегальн: нелегальную нелегальной
выж: выживших иммигрантами компенсаций
двунациональн: двунациональное
труд: труд трудом исторические труда многие
путешеств: путешествия
превосходя: превосходящих
полуостров: полуострова
старик: немыслимым возвращение
полудн: полудня
облада: альтернативы
осад: осаду
процесс: судебный
молодеж: молодежь молодежи
шел: последовательно
европ: европой европу
достойн: обеспечена
разоблач: сеть
доказыва: история
уступ: выдержал
артур: артур
продолжа: тяжело продолжают немцы
выздоровлен: выздоровления
помоч: помочь
вечер: вечером
помощ: помощь помощи
современ: равняются
раздира: коалицию шарета
лод: лоде
истечен: истечения
изгнан: изгнания изгнании
здоров: здоровье
сежер: сежере сежеры сежера
валют: стабилизировать
заключ: заключил последней заключили
попытк: примирительный попытку
ведомств: разведывательных
опасн: нависла
интегрирова: иммигрантов
будущ: будущее будущий будущего будущей будущих
желан: желании
оглушительн: оглушительным
прекрат: прекратить
напечата: напечатало
каир: центров
нацистск: аргентине
салоник: салоники
немецк: немецких договорился
почетн: основателю
уцелел: уцелели
отнят: компенсация
арен: ареной утраченные
роков: роковой
непреклон: приближенные жесткость
нацизм: нацизма
охват: охватило
кавказск: кавказской
музе: музея
спецпроект: спецпроекты
протяжен: истории
рост: рост активного
казн: смертной
росс: россия потрясениям
задумыва: зохар
четырех: четырех
росл: бюджета
достоин: достоин
охвач: охвачен
мотор: мотор
плод: принесла
ситуац: ситуацией ситуации катастрофы ситуацию
каза: кандидатом отказом
воздержа: воздержаться
середин: середине
кажд: кровь египтом
опечатк: нашли
канад: канаде
вынужд: скандал
пройд: россии
ссуд: предоставлении
российск: российской
канал: суэцким
уезжа: уезжает
политическ: громкий кризису политические политическую веком участвовать
золот: положила станет
завершен: завершения
юг: юге юга
использова: использовать
юн: юный юном
значим: прежнему
разведывательн: военных
шли: холокоста
завоюют: завоюют
поруч: лавон
завер: заверил
настоя: настоял настоящее граждан бокер
завет: развития
общин: целыми общины общин общинах
ядерн: строится угрожает ключевую
сказа: сказаться
импорт: краха
ссср: ссср
знаком: знакомится
ввест: ввести
строг: строго
отнын: репатриантам
жарк: жарких
яр: ярым
помим: территориями
сверка: сверкающей
кумир: кумир
возделыв: возделывая
пыл: пылу
семейств: семейства
араб: арабами арабов
эшафот: эшафот
бульвар: бульваре
оптимальн: угрозы
мощн: мощная
поворотн: избавиться
цион: цион
кабмин: убеждая
назва: выдающегося
тренировочн: тренировочный
содружеств: предложили
заложник: заложники
брикс: одкб
рутин: ежедневная
подума: подумала
зно: зноя
количеств: абсорбция
специальн: специально специальной
шок: настоящий
виноградник: поля
друз: друзья друзьями
объем: лидирующие
стро: димон
друг: другими другого
хага: хагана
предпринима: предпринимает
наступ: войн
тайн: подписывают
изнурительн: изнурительного изнурительный
народ: народа народ народом
фокусир: вернувшись
действ: действия решительных боевым действие действиях
покида: покидают
велик: великим
привел: привел
приезжа: европейские
феск: фески
инициатив: инициативы
августовск: августовский
стоя: стоящих
поражен: пользоваться
региональн: державой
перезапуска: заново
отстоя: отстоять отстоял
агентств: агентство агентства
ран: ран
объясня: историки
одесс: одессы
стол: столь столом
протест: протестам ноты
деревн: деревни
интернет: интернет
командован: командование
ротшильд: ротшильда ротшильду
вступ: вступил вступить вступила
траур: траур
штаб: штабу
основател: основателя основателем основатель отцу
официальн: официально
великобритан: объединяющее великобритания великобритании великобританией
унесл: унесла
госпитал: госпиталя
репатриац: репатриацией
знал: знал
поставк: сделку поставкам долларов
комментар: прав
беженц: беженцами
сотрудник: сотрудник
джеймск: джеймском
приступ: приказывает
решительн: жестких третьего
работа: работал
сильн: успех сильное внешнюю
вызва: вызвали убийц
устремл: устремлен
англичан: англичанам
необходим: необходимые необходимо экономических необходимым необходимость
руководя: присутствия
накладыва: накладывают
подходя: отставке
произвел: произвело
евре: евреев евреям евреями
нейтральн: нейтрального
кризис: экономическому экономический
трансиордан: пополам король трансиорданию
иргун: иргуном иргуна иргун
грузов: грузовое
привед: приговор
лежат: лежат
реакц: реакцию
димон: вблизи
историческ: мемуары исторической
километр: километрах
оста: осталось остается остаются оставшуюся
прояв: успешно
вышел: вышел
инцидент: инциденте
абсорбц: размещение
реш: решил странах решить действовать решено
международн: спекулянтами международным международном оглядки международной большему укрепил присуждение
генеральн: генеральная
ирак: ирак ирака
залог: видел
высажива: высаживается
оснащен: университетов
польск: польской польском
продвига: продвигаются продвигаться
бегств: бегству бегством
погибл: погибли
чувств: чувствую
люб: категорически любые
обеспокоен: обеспокоенные блеф
содержа: содержащую
премьерств: учреждений
упор: упор
захватыва: захватывать
соверш: готовится
гистадрут: гистадрута гистадрут
моссад: разведке престиж
соседн: соседний давлению
люд: людей
разраз: разоблачена
отвеча: отвечают соседа
год: годы
лагер: лагеря
министр: министра министр возникли
неизбежн: неизбежность
сент: сент
пинхас: могущественного
разгора: разгораются
создан: создания создание созданию
особ: особым
вывод: выводе нато
расход: урезать
близ: близится
привод: очередь позиция
волн: волна
вторгнут: нападет
транслирова: шли
мат: мать
перемир: перемирие
псевдоним: псевдонимом
приб: потребления
улиц: улицах аэропорт
глубж: глубже
выда: именем отношение
бразд: пример
объединя: содружество объединяющей
иерусалим: иерусалиме иерусалимом иерусалиму столицы
апрел: апреле апреля
амма: аммана
незадолг: незадолго
адольф: адольфа
погруж: погружаясь
гнев: гнев
пересажива: пересаживается
отмечен: отмеченный
войн: войне жил война войны войну
историк: историк подал
войт: войти
спровоцирова: спровоцировал
эмигрирова: эмигрировать
конечн: нападение
состав: ввп
деятельн: деятельность
порядк: порядке
поселен: поселений поселение поселения
вечн: вечны
блеф: окажется
отчая: отчаянное
лива: ливан
слушан: судебные
похож: уникальны
пишет: пишет
жела: желанную пустынные
волнен: волнения
руин: руинах
ухудша: израиле
шпионск: фиаско
секретариат: секретариат
написа: написавшего написал
отомщ: израильтянина
поиск: взялся
разноглас: серьезным сильные
франц: находит присоединяются французские
возл: возле
египтя: египтян
голод: голодом
шест: шести
исполнен: приведен
голов: головой
всеобщ: всеобщая
противореч: внутренние
голос: декабря
переговор: переговоров абдалла переговоры
род: родился
эзр: эзры эзра
скептическ: скептически
оппонент: оппоненты оппонентам
втор: открытием
рол: роль
избав: расширить
конференц: конференции конференция
рекоменд: рекомендует
готов: готовиться советский
вступа: вступал вступает
америк: америке латинской америку
образ: образом
обоснова: обосноваться
мобилизац: мобилизацию
ввод: действий расходы
конц: конце
эмиграц: эмиграцию
дорог: дороги
обрамлен: обрамленной
случа: случаями держав
удал: полностью политической
настоян: уступить
практическ: практически
предел: пределы
александр: александр каире
приглаша: приглашают
утвержда: утверждали утверждал
инвестирова: спасательным
лысин: лысиной
бальфур: бальфура бальфур
потреблен: уровень
отъезд: отъездом
давн: непреклонен
антиримск: антиримского
училищ: училище
переселенц: переселенцев
дизентер: дизентерией
вывест: фронта
мир: мир телевидением договориться
оборонительн: оборонительные
писа: удалился
выдержа: уговаривают
напада: нападают
прекращен: прекращении
скор: скорее скорейшего
феврал: февраля уговоров
получ: получив получил получится получившие
зашл: сотрудничество
оглядк: отвечает
публик: публикуют
руж: ружье
экономическ: посту экономические позиций тяжелейшему проектов выплате наряду
декабр: декабре руководству
рук: руки
правлен: правлением правления
ежегодн: роста
столкнул: задачами
компенсац: индульгенция выплату
издан: издание
прям: прямо
позиц: прозападных позиции жесткая
бриз: бриз
югославск: болгарская
дивиз: дивизий
зачитыва: зачитывает
несокрушим: несокрушимой
отнес: отнесся
дедушк: дедушка
блюд: блюда
иде: идеями идея
дипломатическ: проявляет
пожизнен: пожизненного пожизненно
порядок: поддерживать
цаха: цахал
руш: рушилась
наибольш: достичь
полезн: полезным
сопровожда: сопровождающиеся
существен: существенно
отда: отдал отдает отдало
расшир: грандиозной
арабск: арабское арабские арабских арабской арабский арабского арабская мире
импер: империи империя
ашдод: ашдода
деятел: политического государственному почетное
наступа: наступающие
вопрек: вопреки
решим: доказывает
момент: поворотным момент моменты моменту
приглас: пригласили
авторитет: огромным
заседан: заседании
мор: морю море
принципиальн: амбициозную
закуплен: закупленные
вышл: вышла вышли
сможет: сможет
синагог: синагога синагог
основа: основать
инициатор: непростую
решен: решению решение решении решения
мгновен: мгновение
закупк: закупку
биограф: биография имени биографа
любя: любящие
неоднозначн: неоднозначную
провод: проводят парижа
средн: запада
личн: подать
нужн: нужна
поздн: действиям
делегац: делегацией делегациям
мош: министром
повыс: попытка
продвинул: продвинулись
результат: результате дают
жизнен: анализируется
полож: кампания
сковородк: сковородки
сближен: сопротивлением
полос: полосы
вышедш: вышедшее
дал: дали
смертн: приговорен
документ: документу документам
предложен: одобрения предложенный предложение
мечта: мечтать
египтян: египтяне
сопротивлен: сопротивление сопротивлению провальной сопротивления
фиаск: терпит
выросл: песках переехало
дан: данное данному
контрнаступлен: контрнаступление
весьм: весьма
дат: дать
элиях: элияху
имен: деятеля помнят
зачита: зачитал
состоя: состояться
неподалек: неподалеку
первооткрывател: первооткрыватель
станет: израильского
подверга: раздирают
мрач: мрачен
издава: фигурой
кругл: круглым
медлен: медленно
сионистск: сионистском сионистских сионистско сионистской сионистского сионистский
формирован: формирование приступает формировании
сановн: сановным
вынуд: вынудили
пошел: ухудшалась
муз: музею
предлож: казалась устроил
выуч: выучиться выучить
полмиллиард: ссуды
предводител: предводителя
прожива: проживающих
границ: границы границами
оцен: оценили
восток: восток среднем
вмест: вместо вместе
уход: пост должен
британ: британии британию британия
почтительн: глубоко
правительств: странами правительства
обетова: обетованной
настроен: настроений
резолюц: резолюцию предлагалось
танц: танцуют
имуществ: отнятое
начал: начале началом
заня: занялся кровопролитной соглашается никого заняли заняться
руководств: израильскому руководство шагам руководством
накрыва: накрывающей
наступлен: наступление
танк: самолетов
стуч: стучит
глубинк: глубинки
работник: работники
обеспеч: безопасность
возобнов: возобновил возобновились
дел: делу безработица
вопрос: вопроса вопросы вопрос соратниками
ближайш: условиях
сохраня: сохранялось социализма сохраняйте
однопартийц: компромисс
договарива: германией францию
намечен: шел
мемуар: писал
вреза: врезался
москв: региональным
прообраз: прообраз
преступник: нацистского
полност: шарет
усил: брикс
покупк: покупку
сталкива: подходящий
собствен: собственной полученные процесс собственное
британск: британские британских британскими британскую британской британское британский британского британским
суток: суток
существован: фактом ставили
отказыва: отказываются
расширен: расширение
уильям: уильяма
передов: руководства
восточн: восточной акса
отношен: налаживания акций почтительное отношения
иска: постоянно
австр: австрии
абдалл: трансиордании
турбулентн: пройдя
услыша: услышал
продл: продлившееся
ряд: ряды рядах
сад: садилась фруктовые садится
последн: взглядов последнюю иордания
бокер: сде удалится
паул: паулой
многовеков: многовековой
хил: хилым
сам: самых самым
подлодок: танков
школ: инфраструктуры улицы
пролит: отныне
образован: образовании
подобн: умел
называ: называться старик
танцева: танцевать
ицхак: ицхаком
давлен: санкционного давлением международному
гост: гостям
переезжа: объявляет
принят: принятии
неожида: пошел
женщин: женщин
смысл: некотором
начина: начинают начинает
формир: формируется
предлаг: союзники
западн: укрепляя
мужчин: мужчина мужчин
научн: научный
уреза: дело
низкоросл: низкорослый
предшествова: предшествовало
сво: труды
первостепен: опасаясь
порог: убит
станов: арене становилась становится
лавон: уход пинхас
полигон: полигон
атак: атакует
парт: партий ведомств партию партия
пообеща: пообещали
потрясен: политическим
очаг: очаг
герцл: герцль герцля
законч: закончится плану закончился
палатк: бараках
дооснаст: дооснастить
развит: успешного развитие
настаива: отвращение
отвращен: вызвала
анализир: издавать
станут: станут
обеспечен: обеспечение
продолж: продолжили продолжил американцев
терп: операция
обществен: общественно
происход: происходит
пользова: продолжали
немолод: выматывали
сде: кибуц
хвата: катастрофически
накупа: накупавшись
поддельн: поддельным
ценност: ценности
перейт: перейти
еврейск: еврейское еврейский еврейского еврейских еврейские еврейскому противниками еврейской еврейскую
истор: историей моментом путем историю
обуч: обучить
спеш: спешить
прова: провал
сед: седыми
аденауэр: конрадом
призыва: призывают призывает
сем: семья
прооттоманск: прооттоманские
экзистенциальн: сталкивалось
межарабск: межарабская межарабской
сер: устроить ликующий
налад: наладить
представител: представителей представитель представителями
сет: шпионская
умел: авторитетом
умер: доме
всплеск: всплеску
прекраща: прекращается
кнессет: предложения перенести
очевид: лавона
реальност: следующие
одобрен: внутри
стрем: надежды
памя: память
возрод: возродить
дне: дней
неоднократн: неоднократно
дни: дни
социалистическ: социалистического социалистические
дом: дом своем дома
осознава: осознавали
поддержа: поддержал поддержать
исполк: исполком
поддержк: заручиться
глубок: сохраняется
дня: дня
доб: добился
хорош: хорошие
голд: голда
подъезд: подъезда
вымолв: вымолвить
нац: наций нации
наш: нашей
успешн: века залог
сил: силы силой сил силах силам вооруженными
син: вывести
депортир: депортируют
доллар: полмиллиарда долларами
агитирова: агитировать
праздну: празднуя
сир: совершить сирию заключила
сукн: сукно
регулярн: регулярные
мяс: мясом
нат: растет
держав: мировой
информац: информация
гуманитарн: грани
земл: землях земли землю земле
самооборон: самообороны
диаспор: югославская
приказ: приказ
социализм: последнего
столкновен: столкновения столкновениях столкновений
противник: противника восточном противников
берег: берег берегов берегу
бомбардировк: бомбардировку
хаган: хагане
дневник: дневнике
спуст: спустя
иосиф: иосифа
сканда: политический
расчист: расчистил
джеймсск: джеймсской
нюрнберг: собственным
требова: существование ситуация
объедин: объединившую объединившая
берет: берется берет
безучастн: безучастны
оппозиц: серьезной
отвергнут: отвергнуты
размещен: размещении диаспоры
катастроф: гуманитарной
спас: спасаясь
идет: идет
подготовк: продолжал
отправля: отправляются отправляют отправляется
артер: артериями
коллег: коллеги
сионизм: сионизма
миров: мировую мировая авторитетной
забот: забота
мандатн: мандатного
надежд: надежд теряя
акс: аль
приеха: приехал
председател: председателем
акц: выступал акции
сми: сми
осужда: осуждает
польз: пользуются пользу пользуется
федерац: федерация
союз: союз
чехословак: заключает
проживан: проживания
стран: союзников мусульманскими страны страну стране той
уровн: достойном
портрет: портретами
южн: южного
коалиц: правительственную коалиции коалиция
спасательн: плаву
укреплен: усилия
душ: составил
нег: негев
свеж: свежий памяти
качеств: качестве
ненасильствен: ненасильственной
выбор: делают носу
избира: избирают
правительствен: нестабильность
мусульманск: отношений
сужд: суждено
израильтянин: каждого
подража: подражать
заяв: заявил
угроз: экзистенциальными подлодок молодую
впроголод: впроголодь
небольш: небольшой небольшое небольшом
разворачива: разворачивают
сны: сны
погружа: погружается
побежда: кресло
брос: бросил
выбра: стабильность
воспоминан: воспоминаниям воспоминания
обещан: обещание обещанию
просуществова: просуществовавшему
судн: судно
кладут: кладут
крупн: назван крупнейшее крупнейшим
капитулирова: капитулировала
аэродром: аэродромом
страниц: страницы
санкцион: необходимых
пустын: пустыне облагородить
прежд: заветам
талант: дипломатические
становлен: становления
радикальн: радикальная
ник: очевиден
прежн: десятилетия
авивск: авивского
миллион: миллионы миллионами
июл: июля июлю
выплат: аденауэром пошла
июн: июне июня
учрежден: учреждения государственных
терза: терзают
xx: xx
ctrl: ctrl
enter: enter
