встал: встали
нащупа: нащупать
бесснежн: бесснежное
ру: ру
восхит: восхитить
стат: стать статьи
обычн: обычную обычной
европейск: европейскими
мамк: мамкой
капризн: капризные
стал: стала стали стало
полетел: полетели
щеняч: щенячьего
посад: посадить
объясн: объяснили
ката: катают
ориентируеш: ориентируешься
северн: северная
показыва: показывает показывать
север: севера север
арх: архив
экономик: экономика
связк: связки
сто: стоим
манхэттен: манхэттене
человек: человека
приятн: приятно
наравн: наравне
охот: охотиться
макияж: макияжа
леч: лечь
знакомств: знакомства
должн: должны
структур: структуры
изверга: извергает извергается
ездов: ездовом ездовым ездовой ездовыми ездовых ездовые
график: график
пальц: пальцем
косичк: косичками
котор: которым
денег: денег
силов: силовые
секретн: секретные
прав: правил правило
доста: достали
участвова: участвовали
самоотвержен: самоотверженно
пловц: пловца
целенаправлен: целенаправленно
весн: весной
начнет: начнется
заб: забыть
дела: делала
ребят: ребята ребятами
едет: едет
верн: верный вернусь
вывед: выведены
книг: книгу
шкаф: шкаф
проснул: проснулся
россиянин: россиянин
сосед: соседа
занима: занимается заниматься занимаюсь занимаются занимаетесь занималась
встрет: встретили встретить
плачеш: плачешь
гавашел: гавашели
нов: новые новой
ног: ногами
част: частью
слов: слове
непривычн: непривычно
постоя: постоянно
выдава: выдавать
особен: особенностями особенности
выкопа: выкопали
деактивирова: деактивирована
сложн: сложных сложно сложный сложное сложнее
родител: родителями
пут: пути путь путем
вперед: вперед
ноч: ночью ночь
распростран: распространено
природ: природы природа природе
окрепнут: окрепнут
витал: виталия
строительств: строительством
летн: летняя летней
покор: покорила
темнот: темноте
подросток: подросток
труд: трудом
путешеств: путешествия
сожален: сожалению
жалост: жалость
сша: сша
лидер: лидер
процесс: процесс
техник: техника
взаимодействует: взаимодействуете
экстр: экстрим
постепен: постепенно
подготовлен: подготовленными
культур: культура
противн: противно
волонтер: волонтерила
лнр: лнр
комфортн: комфортно
заледенел: заледенело
случайн: случайно
помога: помогала помогать помогаем
выр: вырыли
нрав: нравится нравилось
врач: врач
выш: выше
здоров: здоровыми здоровой
лор: лори
натянул: натянули
протаптыва: протаптывать
мышц: мышцы
брезент: брезент
наоборот: наоборот
нуж: нужен
грамотн: грамотно
спецпроект: спецпроекты
протяжен: протяженность
плох: плохо
цеп: цепь
росс: россии россия россией
помог: помог
помогл: помогли
лебед: лебедев
фбр: фбр
спортсмен: спортсменами
толк: толку
заканчива: заканчивается
сзад: сзади
росл: росла
четырех: четырех
мотор: мотор
зим: зимой
ситуац: ситуации ситуацию
каза: казалось
мужик: мужиками
цел: целыми целая цели
цен: ценно
местност: местность
лент: лента ленту ленты
почесалк: почесалках
дева: девается
кажд: каждому каждой каждого каждую
опечатк: опечатку
настро: настроен
отличн: отлично
краеведческ: краеведческом
везл: везло
идут: идут
всяк: всякие всякими
столб: столбом
серьезн: серьезно серьезный серьезная
растут: растут
стратег: стратегии
целовашк: целовашках
пройт: пройтись
примерн: примерно
взаимопомощ: взаимопомощи
замерз: замерз
шли: шли
начнут: начнут
петропавловск: петропавловска
разведен: разведенными
ссср: ссср
вулкан: вулкане вулкану
езд: ездили
паца: пацана пацаны
строг: строго
след: следующий следующем следующее
тащ: тащить тащит
ям: яму
снежн: снежной снежная
воронов: вороновой воронова
лекц: лекции
так: такую таких
вулка: вулкан вулкана вулканы
нормальн: нормальному
поменя: поменялось поменяется
контролируеш: контролируешь
грабл: граблям
засыпа: засыпает засыпали засыпал
мощн: мощные
блогерш: блогерши
назва: назвал
беринг: берингия берингию берингией берингии
охотнич: охотничьей
формул: формулу
обсуд: обсудить
количеств: количество
ген: генами
попа: попала
спорт: спортом спорт спорте
содержат: содержат
покоря: покорять
покрыва: покрывает
услов: условиях
переночева: переночевали
представля: представляете
друг: другими другом друг друга другую другу
бежа: бежать
приход: приходилось
помеша: помешало
правильн: правильно
иммунитет: иммунитетом
рассказыва: рассказываю рассказывать
программ: программе
вселюдиприродапутешествиятрадициинародыдостижениякультураистор: вселюдиприродапутешествиятрадициинародыдостижениякультураистория
циклон: циклоны циклон
полен: полениться
ежедневн: ежедневно
главн: главное
действ: действующий
полет: полетим
пепел: пепел
рац: рацию
приезжа: приезжала
голуб: голубое
бедн: бедных
запланирова: запланировано
раз: раза
ран: раннего
помн: помню
интернет: интернет
побереж: побережью
щенок: щенок
сработа: сработали
бега: бегает
сопровод: сопроводить
пришл: пришла пришло пришлось
легенд: легенда
беж: бежишь бежит
питан: питания
определя: определяют
бел: белого белый
привлека: привлекало
комментар: комментарии
рамк: рамках
прощ: проще
каюр: каюр каюром
работа: работала работает работать
сильн: сильно сильной сильный сильными
нанесен: нанесения
долг: долгого
долж: должен
останавлива: останавливались
тает: тает
заслужива: заслуживает
числ: число
тренирова: тренировала
трасс: трасса трассу
чист: чистого чистый
подозрева: подозреваемого
клуб: клубы
хозяйск: хозяйские
вниман: внимания
сотруднича: сотрудничать
пойт: пойти
одобр: одобрит
маршрут: маршрутов
тренировк: тренировки
очеред: очередь
виде: видео
приключен: приключения
подход: подход
пойд: пойдем
обстановк: обстановки
температур: температура
посоветова: посоветовалась
километр: километров километрах
оста: остаться остался осталась остались
вконтакт: вконтакте
быстр: быстро
перевал: перевалы
лыж: лыжи
популяризац: популяризации
упряжк: упряжкой упряжки упряжке упряжках упряжку
реш: решила решили
общ: общем общая
сбил: сбились
пригожин: пригожин
зада: задает
обитан: обитания
пропуст: пропустила
сред: среда
чувств: чувствуют
нулев: нулевая
толка: толкать
наблюда: наблюдать
люб: любых любой любят любому
похуден: похудения
контакт: контакт
язык: язык
равнин: равнине
останов: остановятся
уперт: упертостью
снял: сняли
фот: фото
обязательн: обязательно
затянул: затянуло
транш: траншеи
совмест: совместить
гор: горой гору
разн: разных разные
взял: взяла
завтр: завтра
взяв: взяв
люд: людям
дожд: дождь
горист: гористая
удовольств: удовольствие удовольствием
тормоз: тормозить
лагер: лагеря
открыва: открывают
девочк: девочка девочки
пробивн: пробивные пробивная
потеря: потеряли
облак: облаках
знает: знает
май: майя
продаж: продажу
наблюден: наблюдений
настольк: настолько
обращен: обращения
потребн: потребность
посид: посидим
команд: команда
плюс: плюс
издевательств: издевательство
подня: поднялся поднялись подняться
спокойств: спокойствие
апрел: апреля
скосар: скосарев
парамушир: парамушире парамушир
россиянк: россиянка
уникальн: уникальная уникально
ограничива: ограничиваться
камчатк: камчатке камчатки
фатьянов: фатьянова
полпут: полпути
сентябр: сентября
март: марта
испытан: испытании
войт: войти
сомнен: сомнения
глаз: глазами
встают: встают
холодн: холодно
недейств: недействующий
зависет: зависеть
болезн: болезни
половин: половине
ракет: ракеты
новост: новости
перв: первую первой первого первая
воспита: воспитать
проведен: проведенных
приня: приняли
камчатск: камчатского
добр: добром добро добра
чемпион: чемпиона чемпионов
каш: каша
планир: планирую
привыкл: привыкли
ушел: ушел
пепл: пепла пеплу
чукотк: чукотки
птиц: птицы
безумн: безумная
участник: участники
как: какую какие
турист: туристов
детств: детства
фиксир: фиксируются
преодолен: преодоление
встреча: встречается
нащупыва: нащупывали
прошл: прошла
род: родилась
реальн: реальный
втор: вторая
тяжел: тяжело тяжелее
высот: высоты высотой
сфер: сфера
слива: сливалось
насыпа: насыпало
вертолет: вертолет
быва: бывало
готов: готовы готовилась готовились готовить
максимальн: максимальная
найт: найти
соревновательн: соревновательного
влиян: влияние
студентк: студентке
успел: успел
образ: образ
занят: занятии
лапк: лапки
дорог: дорога дорогое дорогу дорогой
случа: случае
появ: появится
удал: удалить
вернут: вернуться
вернул: вернулась
возглав: возглавить
четверт: четвертая
вершин: вершине
поют: поют
сошл: сошла
схем: схема
вообщ: вообще
единствен: единственной
стремлен: стремление
веревк: веревки
личност: личность
дава: давай
коммерсантъ: коммерсантъ
показа: показать
сезон: сезон
поэт: поэтому
отруга: отругаю
ветер: ветер
мир: мир
укол: уколов
выдержа: выдержали
трудолюбив: трудолюбивые
идеальн: идеальную идеальная
обсужда: обсуждали
знают: знают
внешност: внешности
этап: этап
организатор: организаторы
вагнер: вагнер
девушк: девушкой девушка
нажм: нажмите
феврал: феврале
китобо: китобоями
провез: провезем
получ: получится получилось
жительниц: жительница
фронт: фронте
важн: важно
провел: провели
дистанц: дистанции дистанция
город: городу город
кров: крови
рук: руку
час: часов часа
ежегодн: ежегодной
украин: украине
гранат: гранатой
метр: метров
встает: встает
раскр: раскрыли
выстав: выставил
сноуборд: сноуборд
сдал: сдался
больш: большое большой
мест: место
иде: идея
изорва: изорвались
равня: равняются
охраня: охранять
подъем: подъемы
эффективн: эффективность
видет: видеть
собачк: собачки
развернут: развернуться
доставля: доставляет
восхища: восхищают
редакциярекламаконтактыпресс: редакциярекламаконтактыпресс
видел: видели видела
жизн: жизни
биатлон: биатлонного
идт: идти
надел: надела
зашедш: зашедшей
подфарт: подфартило
сформирова: сформированы
чвк: чвк
мог: могу
мож: можем
поглядыва: поглядываю
сотн: сотни сотне
мол: мол
момент: моменты момент
пошл: пошли
мор: море
вышл: вышло
лунк: лунки
преодолева: преодолевают преодолеваете преодолевали
подготов: подготовить подготовила
утечк: утечке утечки
заезд: заезду
решен: решение
провож: провожу
провоз: провоз
удив: удивились
личн: личные личных лично
настырн: настырная
вылож: выложившего
послуша: послушаются
любл: люблю
собач: собачьей собачьих
вызыва: вызывали
полож: положили
виск: виска
любв: любви
экскурс: экскурсию
эбек: эбеко
дал: дали
тасс: тасс
взаимовыручк: взаимовыручка
документ: документы документов
сравнива: сравнивать
мечта: мечтала
эсс: эссо
выросл: выросла
фокус: фокусы
ключ: ключе
хозяев: хозяевами
собак: собак собаками собакам собаки собаку собаке собаках
дан: данные
терпелив: терпеливые
удивля: удивляюсь
установ: установить
имен: имени
раскрыт: раскрыты
суров: суровыми суровая
полтор: полтора
дефицит: дефицитов
гиперзвуков: гиперзвуковой
барабан: барабану
пожалова: пожаловать
тренер: тренером
отказа: отказаться
муз: музее
очк: очков
возраст: возраста
галер: галереи
оцен: оценили оценил
проявля: проявлять
рядов: рядовой
глобальн: глобальной
остров: острове
политик: политике
вмест: вместе
минимум: минимум
уход: уходит
капризнича: капризничает
пушистеньк: пушистеньких
увидел: увидела
тупик: тупик
защитн: защитные
обнов: обновила
жил: жил жилья
стара: стараются
начал: начале началом
поучаствова: поучаствовать
танк: танки
камушк: камушки
наступлен: наступлении
медиа: медианная
кра: крае
животн: животных животные животным
улета: улетать
ориентирова: ориентировались
полгод: полгода
слышн: слышно
дел: деле делюсь делом делятся дело
вопрос: вопросы
сохраня: сохранять
жит: жить
заверш: завершить
проход: проходит проходили
москв: москве
срок: сроки
припорош: припорошило
красот: красоту
понрав: понравилось
уда: удалось
территор: территории
планирует: планируете
инстинкт: инстинкты инстинкт
материал: материале
поднима: поднимались поднимается
минус: минус
каремат: карематы
пишут: пишут
восточн: восточному
продолжительн: продолжительной
куп: купил купила
обща: общаются
жесток: жестокого жестокость жестоко
рома: роман
верещак: верещака
продл: продлилось
кита: китаем
мысл: мысли мыслью
последн: последние
налед: наледь
месяц: месяц
шерст: шерсть
сам: самое
захотел: захотел
жми: жми
бегун: бегуна
тренировок: тренировок
бегут: бегут
длит: длиться
организова: организовали организованно
бо: боишься
подобн: подобное
абсолютн: абсолютно
длил: длились
длин: длинные
гост: гости
пробежа: пробежаться
ира: иран
экстремальн: экстремальная
характер: характеры характер
нашл: нашли нашла
глубин: глубины
уважа: уважают
сторожев: сторожевой сторожевую
горя: горящими
снег: снегом снега снег снегу
перепургова: перепурговали
смысл: смысла
недолг: недолго
заключа: заключаются
испорт: испортилась
начина: начинаем начинает
популярн: популярных популярные
соцсет: соцсетях
смертельн: смертельной
развод: разводить
достига: достигать
пентагон: пентагона
сво: своя свой своим
нача: начать начал началось начался начали
пород: породы
соревнован: соревнований соревнования
свор: свора
истин: истину
рекорд: рекорд рекордов
возникл: возникло возникла
вещ: вещи вещей
экспедиц: экспедиций
законч: закончилось
воспитан: воспитания
развит: развито
препятствова: препятствовало
уничтожен: уничтоженных
зеленск: зеленского
папк: папкой
прилетел: прилетели
ценност: ценности
взойт: взойти
переночу: переночуем
пап: папа
пар: пару
задумк: задумка
девчонк: девчонки
виж: вижу
треб: требует
ел: елена
довер: доверили
ход: ходила
пацан: пацанов
тепл: теплые
гонк: гонка гонки гонке
сел: селе
сем: семьи
уйт: уйти
сер: серый
вид: видом видами
убра: убрать
представител: представителей
сет: сети
естествен: естественно
наук: наука
пережива: переживала переживаем
дне: дней
хоч: хочу
сумк: сумке
скорост: скорость
дом: дома
поддержа: поддержал
известн: известно
обидет: обидеться
юбк: юбке
светленьк: светленьких
сторон: сторону
смотр: смотрю
пройден: пройденных
тысяч: тысячи тысячу
хорош: хорошим хорошие
стоимост: стоимость
организм: организме
вынослив: выносливыми выносливость
наш: нашем наших
недочет: недочеты
днем: днем
темн: темно
полюб: полюбила
плач: плачь
сил: силу сил силы
умн: умных
арестова: арестовало
путешествова: путешествовать
нат: нато
информац: информация информации
выброс: выбросы
зарод: зародилось
тапочк: тапочки
приболел: приболели
сход: сходили сходила
земл: земли землей
испуга: испугался
негативн: негативном
нарт: нарта
выкорм: выкормить
голубоглазеньк: голубоглазеньких
видим: видимость
восхожден: восхождение восхождению восхождения
измуч: измучились
погод: погоды погода
двор: дворе
спальник: спальники
смеют: смеются
паник: паника
ко: коем
собра: собрали собрались
спуск: спуски
спат: спать
например: например
подготовк: подготовки
воспитыва: воспитывала
забот: забота
успоко: успокоимся
сми: сми
обстоятельств: обстоятельствах
музык: музыки
ответствен: ответственностью
стран: страна
аренд: аренды
вол: воли
мо: моих моей моими
сна: сна
громк: громкой
дух: духа
местн: местными
сидет: сидеть
неб: небо
душ: души
прошел: прошел
комплекс: комплекса
лап: лапы
разошл: разошлось
алис: алисы алиса
раздел: разделились
заяв: заявили
подростк: подростком
щенк: щенков
карабин: карабины
паникова: паниковать
мокр: мокрым мокро
лучш: лучших
питомник: питомника питомником питомников питомниками питомник
дума: думаю думают
пойдет: пойдет
оо: ооо
оп: опыт
возможн: возможность
интересн: интересно интересных
всу: всу
фотобанк: фотобанк
вилючинск: вилючинский
выбра: выбрала выбрали
раним: ранимые
брос: бросил
буквальн: буквально
хаскоподобн: хаскоподобных
снегоход: снегоходах
утр: утро утра
хочет: хочет
крупн: крупных
крут: крутая круто крутят крутой
дмитр: дмитрий
страниц: страница
пораз: поразил
меша: мешала
поран: поранились
авиакомпан: авиакомпания
взгляд: взгляд
бойц: бойцов
выпуск: выпуска
бывш: бывший
вожак: вожаком
копа: копать
порва: порвались
тянул: тянулась
наверх: наверх
ребенк: ребенком
никак: никаких никак
карабка: карабкались
непонятн: непонятно
avacha: avacha
killnet: killnet
race: race
ctrl: ctrl
appl: apple
enter: enter
