обрат: моей
максимальн: хотела
ру: расти
говор: наплывом языке
влиян: оценили
студентк: похудения
коронавирус: вакцинации
америк: америке латинскую
стат: статьи
строител: инженеры
сравн: могу
обычн: обычную
оказа: естественно
учет: поставить
конц: девушек конце
стал: страна фронте
дорог: вышли
жительств: вид
предлага: смесь
объясн: лнр
маленьк: любят инфляция
ребенок: ребенок
северн: азию
появ: деньги миллионеры
удал: студентке
гуля: педиатра
реализова: сможем
центр: мировым
работ: удаленная искать
тельм: сан
вернут: вернуться
прогулк: увидели экономики
вернул: отложить
арх: архив
экономик: благо экономика
пож: наоборот
получен: упрощенное получением требования
манхэттен: жилья
послед: последующим
инвестирова: продали
вообщ: редкость
единствен: врачей
послеродов: собственная
каса: сечение
макияж: нанесения
то: документы
стечен: благоприятном
личност: раскрыли
присутств: переводчицы
структур: структуры
суд: суда
редкост: огромная
макс: переводчиком
логическ: рассуждать
показа: северную
родильн: центром зарплаты
екатерин: паспорт архива
поэт: месту
отправ: задумали
котор: которому договор
наплыв: удивлены
прописа: четко
мир: мир путешествовать
уз: пришла
укол: популярных
силов: силовые
осен: записаться
благ: идет
секретн: выложившего утечке
совершен: детей
обсужда: российского
прав: думаю дочка праве похожие
связа: красоты
внешност: удивились
хорх: самолетом
обратн: нужна абсолютно
вовс: присутствие
вагнер: чвк
нажм: опечатку
связ: обратная
феврал: февраля операционную
вперв: рожала
негатив: столкнулись
при: приходите
совместн: экскурсий
консульств: российское
дела: дочери показаний гуляем
претендова: претендовать
власт: власти
получ: дней россияне дочь
верн: получать
объявлен: отношения
клиник: частной частную зарабатывают
навяза: пытается
узнава: обращались
фронт: утечки
важн: результаты
провел: провела
устраива: другому
город: стране альтернатива
разобра: ребенка
вскармливан: грудного грудному
беремен: изменено беременности беременных
декабр: парке
легализова: приехать
дружелюбн: ситуацию уехал
столкнул: разу
чат: папка июля
украин: очков
прост: автобусов
левошин: максим
раскр: последние
шанс: деньгах
выстав: лидер
альтернатив: единственная
сосед: маленьких
позир: гордиенко
здравств: проходя
занима: родителей
ложн: ложном
следова: раздули
удивл: сроке
встрет: можем
подруг: рассказывали
действительн: выйдет
нов: китаем
больш: самый месяца моменту доплачивать консульстве
мест: одному
ждат: вырос
устро: неплохо
инженер: образованию
длительн: остаться
недвижим: покупать
направлен: популярным
выручен: инвестировали
выписк: тельмо
постоя: получили
перелет: проблем
сдела: удивила
айрес: йоги айреса испанского
рожден: рожденный дают свидетельство легализоваться
отда: сделано
эффективн: оценил
медперсона: сложно
видет: видеть сможешь
деактивирова: нажмите
сложн: вообще поездке
терап: интенсивной
родител: ребенку ним вида
дают: страны
редакциярекламаконтактыпресс: всу
вспомн: сразу
пут: прошли
обыск: обыски
жизн: жизни
русск: столько объявления появилась толпе отношение
операцион: папашу
зашедш: заявили
систем: потока
чвк: уничтоженных
мог: россии
самолет: наблюдает
упрощен: ес
пыта: никто
мож: прогулку
шварцма: валентина
переписыва: неделю
переводчик: прием
узна: шоке
государствен: иностранцы будущего
летн: внешности
момент: ребенком классно
папаш: отведет
смож: условия
частн: спокойнее разница государственных
архив: личного
пообща: ру
нема: самостоятельно
сможеш: континент
путешеств: дохода путешествия
переводчиц: нашей
вышл: стрессовой
сможет: палата
сделок: платят
сша: визы
неплох: шанс
лидер: ракеты
созрел: задумались
групп: период
техник: техника
медицин: уровню
утечк: преднамеренной влияние
решен: решению
привязыва: сильно поскольку
требован: изучить
хотел: вскармливанию
культур: культура разных
удив: задержанием наступлении
налог: сделок
черногор: друзей
лнр: популярные
продолжа: желающих
задержан: история
личн: приехало продажу палате
живет: волну
нужн: врачу
ужасн: плохая
поздн: поздних позднее
случайн: совершенно
обраща: агентствам
помога: помогала
бесплатн: платных личная бесплатной
нрав: родилась
вылож: личность
неизвестн: действительности
помощ: обратились дружелюбно
врач: правильно нато одни страховку квалификация
бразил: соседнюю гражданства
климат: местный
дочк: феврале
результат: какие
опыт: впервые своим
здоров: важно
полож: праву
заключ: компанией
экскурс: интересам
подад: делать
страховк: билеты
документ: секретных документами подадим
будущ: матери
наоборот: городу
спокойн: заночевать
задержа: задержали
прочита: случайно
показан: госпитале
интерес: группы
жен: левошин
доплачива: нахождения
собак: выгуливает
стимуляц: навязать
дан: личные
удивля: здравствуйте
грудн: касается консультанты
отключ: комментарии
имен: новорожденным
въезд: въезде сложностями
иностранц: больницы
отделен: перевести
спецпроект: спецпроекты
испанск: говорите знаем
летел: истории
раскрыт: рекорд
закон: закреплено
плох: ситуации город логически
толп: распознать
росс: россия заинтересовало опыта сотрудничать
помогл: официально
задумыва: рассказали
фбр: документов
роддом: плохо
гиперзвуков: новой
мотор: мотор
ситуац: узнала списывает
пожалова: добро
фирм: строительной
счита: русским
деньг: местных вырученные
сечен: кесарево
отказа: отказали итоге
списыва: принять
цел: реакция цель
очк: умных
лент: лента ленту
середин: середине
кажд: обязанности
опечатк: нашли
канад: сша
галер: галереи
оцен: украине врач
выходн: родными
рядов: относятся
российск: получила въездом
политик: тупик
всеполитикаобществопроисшествияконфликтыпреступн: всеполитикаобществопроисшествияконфликтыпреступность
вмест: сочи предлагают
уезжа: родственники
минимум: план
полиц: полиция
зарабатыва: налоги
новорожден: позируют
покупа: обосновываться
муж: зоомагазины екатерина
увидел: поздравили
тупик: зашедшей
иностра: преимуществ
обнов: манхэттене
поездк: подготовка
жил: аренды снимаем
билет: обратные
ньюбер: хорхе
достаточн: информации
примерн: рожает
наступлен: зеленского
заночева: сможет
медиа: подозреваемого
професс: работала
девушек: следовало
настоя: настоящая
преимуществ: любим
йог: чаепитий
инфляц: ужасная
ссср: ссср
знаком: подруги
принесет: молоком
произошл: первопроходцев
итог: обязательно
масштабн: профессии
стольк: напугало
разгорел: разгорелся
дел: путь дело
педиатр: заплатить
аргентин: аргентину аргентине произошло
вопрос: вернулись
рассказа: друзья
квалификац: устраивает
планируеш: говоришь
договарива: родах
проход: русские
так: отдал
ответ: здороваются
никт: естественные
перевест: придется
семейн: обстоятельствам
срок: разрешены справляется сроках раскрыты
покупк: делаем
собствен: общая
поздрав: дому
трудоустро: первых
ручк: медперсонал
измен: мария
бак: вылетом
красот: услугам
раст: продолжает
территор: рожденному
дет: созрели
разниц: врачи
блогерш: летней
назва: пригожин
снима: источник
некотор: действуют интернете
отношен: негативного плохое
иска: момент
обуча: школу
аз: посмотреть
служб: служба
аэропорт: аэропорту
вылет: коронавируса
кита: испытании
бар: правда
посмотрет: отправиться
спорт: спорт
район: историческом
специальн: помощью приходят
шок: коноваловой
последн: выбрали отключены
друз: гостили второе
зна: компанию
месяц: занимало профессионально
услов: еда
сам: бразилию
сан: районе
стро: неизвестно
захотел: иран
жми: жми
друг: роддом
дик: вторых
приход: мамам испански
вырос: срок
правильн: равно
школ: ходить
поня: фирмы
образован: вместе
абсолютн: собрали
посмотр: действовать
компан: компании английский специальную
рассказыва: сравнить
развлека: салонам
гост: сентябре
программ: россией
получа: видимо
ира: макияжа
главн: главное
действ: правила
нашл: ооо
записа: очередь
женщин: последнюю женщин
очередн: той
обязан: прописаны
популярн: эффективность аргентина болезни
смертельн: язык
раз: дружелюбные
изуч: культурах
агентств: риелторские каким
пентагон: секретные пентагона
сво: делятся
уеха: родил
паспорт: паспорта конечная
отдельн: диаспора
реша: родов
зарплат: маленькие
посольств: устроиться
замеча: хорошая
интернет: интернет прочитали
россия: распространяются
прода: поэтому
опрашива: опрашивать
олимпийск: масштабной
раздул: историю
рекорд: обновила
возникл: летели
гордиенк: жена
вслед: вслед
парк: собаку
завяза: работа
официальн: сторон
пришл: планирование лео
консультант: специальные
госпитал: государственный бесплатном
интенсивн: отделение
гражданств: гражданство получения
станут: россиян
знан: трудоустроиться
резонанс: коляской
уничтожен: назвал
соотечественник: многие
комментар: шварцман
зеленск: потребность
туризм: родильный туризме родильного
анестез: эпидуральную
поеха: идею
папк: отдельная
работа: познакомились зачастую
сильн: бизнесы
континент: уезжаешь
преднамерен: заявил
нанесен: блогерши
ценност: ценности
долж: легче
зоомагазин: открыла
пар: супружеской встретить
ед: климат
услуг: посвященный
виз: получение
заинтересова: родителям
задума: америку изначально
числ: въехало
истор: достаточно воспользоваться всей
ход: покупки должен
довер: мастерами
ес: режим
период: примерно
отведет: ручку
подозрева: подозревают арестовало
легч: гораздо
пробл: никаких
сложност: большими
сотруднича: захотел
реакц: помощь
очеред: большая
вид: постоянный очередности
сет: опытом
представител: данные
виде: видео
кесарев: анестезию
подход: нравится
едут: едут
рожа: рожать чаты клинику минимум
мастер: русскоговорящими
доход: источники
придет: пойдет
безвизов: иностранного
историческ: бар
естествен: выступают максимально
оста: планируешь эмоционально обсуждали
водител: негативом
договор: напрямую заключен
спрос: перелеты связь
наук: наука
бизнес: местном миру
принима: медицины
хот: хотят поняли
разреш: врача
дне: рождении
платн: принимают
сумм: большие
дом: соседи
реш: россиянками
известн: стало
общ: клинике
сторон: каждой
постав: клиники
поток: большого
пригожин: политике
доч: ждать
первопроходц: немало
честн: вопросу
обитан: обитания
реж: безвизовый
недел: станут
эмоциональн: тяжело
тысяч: тысячи
включ: странах
родственник: остались
родн: видеться
хорош: целом туризм хорошие
профессиональн: реализоваться
стоимост: медианная
миграцион: миграционная
чаепит: совместных
ид: нашу
сред: среда
родд: знакомые
нахожден: терапии
наш: узи вспомнили
аргентинск: положено аргентинского
въеха: въехавших наблюдается
мног: направлением
наблюда: рождения ажиотаж
стройк: олимпийской
посвящен: чат
аргентинц: рядовые
люб: онлайн россию людей
можеш: делают
плат: агентства
похуден: уколов
язык: русском удалить
планирован: семейное
умн: выпуска
план: посольство долгосрочные
фот: фото
обязательн: вовсе
арестова: фбр
автобус: водителей
путешествова: хотим
нат: представителей
информац: сети редакциярекламаконтактыпресс
больниц: частных подбором
салон: местным
распозна: развлекается
латиноамериканск: разобралась некоторые
строительн: соучредителем
правд: аргентинское
земл: земли
разн: пожить декабря
отлож: пришлось
негативн: какого
диаспор: русская
впуст: впустили
видим: осень
удален: дикая
соседн: включая
напуга: команду
люд: простых
россиян: стран
сканда: скандал
английск: знает
зачаст: больницах
рассужда: переписывать
собра: баку
ближ: оказался
дочер: жительство
русскоговоря: связаться
идет: кафе
знает: айресе
волн: русскоязычных
подготовк: живет
одн: работают можешь ответ привязывали
россиянок: россиянок
мам: вместо
продаж: выставил
ле: имени
самостоятельн: узнавали
мар: пар
миров: стала
классн: месяц
забот: забота
потребн: объяснили
свидетельств: выдали
действова: выходные
сме: принесет
приеха: русских уругвае длительный
распространя: законах
сми: сми
выда: выписке
огромн: договариваться
команд: такую
обстоятельств: разным стечении
справк: спросили
здорова: удивляются
познаком: строители
австрал: канаду
апрел: ньюбери
заплат: учет
россиянк: пообщалась россиянкам
стран: осталось латиноамериканская страну латиноамериканские привязывать некоторых
аренд: стоимость
шестер: шестерым
эпидуральн: выбрать
смотрет: госпиталь
уровн: смотреть
отлич: одно
мо: поехать
поскольк: японию
четк: котором
южн: южной
местн: посмотрим местное доверия местные бизнесе завязанная
горазд: передвигаться
япон: австралию
сентябр: беременна
март: марта
передвига: показать
испытан: известно
войт: войти
конечн: аргентинцы
обосновыва: вернемся
соучредител: муж
буэнос: буэнос
сраз: честно
онлайн: обучаться
валентин: планы
проблем: вскармливания
стрессов: сложной
заяв: сфера пентагон
латинск: путешествий
болезн: смертельной
похож: родители
ракет: гиперзвуковой
ажиотаж: большой
жела: число
закрепл: право
вакцинац: справку
благоприятн: рожаем
новост: новости
перв: работу
дума: резонанса
относ: туризма
приня: отказались
партнерск: ближе
миллионер: суммы
добр: деактивирована добра
пойдет: отличие
оо: информация
всу: бойцов
равн: считаю
выбра: бразилии хочет
риелторск: договоришься
супружеск: черногории
выйдет: обстоятельств
палат: послеродовая бесплатных
хочет: решает
как: замечала спросить апреля
все: концов
соч: мужем
матер: здоровья
молок: проблемы
каф: ходим
бойц: вагнер
прошл: соотечественники
выпуск: сроки
род: приехал роды решили роддоме партнерских стимуляцию
выгулива: женщина
бывш: бывший
реальн: пожаловать
втор: знания получить
тяжел: дорогие
изначальн: недвижимость
коновалов: екатерины
выступа: подход
ребенк: родить территории пары
воспользова: точки
точк: любой
уругва: задумывались
коляск: прогулке
сфер: программе
откр: стройки
июл: айрес
долгосрочн: строить
справля: система
подбор: помогли
напрям: жилье
русскоязычн: одну
никак: возникло
источник: хороший появились
rodrigo: rodrigo
abd: abd
ctrl: ctrl
appl: apple
telegram: telegram
pisarenko: pisarenko
ap: ap
plaza: plaza
getti: getty
reuter: reuters
killnet: killnet
dorrego: dorrego
martin: martin
imag: images
enter: enter
michel: michel
setboun: setboun
dni: dni
acosta: acosta
natacha: natacha
