быва: бывают
обрат: обратить обратиться
максимальн: максимальная
ру: ру
покуп: покупая
банк: банк банка
провер: проверить
влиян: влияние
студентк: студентке
стат: статьи
обычн: обычную обычного
оказа: оказаться
инвестор: инвестор инвестора инвесторам инвесторов
подешевет: подешеветь
рискова: рискованный
учет: учет
ждет: ждете
конц: конце
стал: стало
предлага: предлагаемых предлагает
дорож: дороже
объясн: объяснили
маленьк: маленьким
приобретен: приобретенные приобретенных
превыша: превышают
случа: случае
удал: удалить
завис: зависят
работ: работы
дополнительн: дополнительный
доступ: доступ
вернут: вернуться вернуть
арх: архив
экономик: экономика
гарантирова: гарантированы
предел: пределами
мосбирж: мосбирже
привлеч: привлечь
получен: получение полученного получения
александр: александр
торговл: торговля торговлю
сто: стоят стоит
манхэттен: манхэттене
основан: основании
инвестирова: инвестировать
фондов: фондовая фондовом
лет: летом
макияж: макияжа
то: той
личност: личность
депозитарн: депозитарный
снижен: снижения
должн: должна
структур: структуры
исчисля: исчислять
резидент: резидентов
коммерсантъ: коммерсантъ
нест: нести
подешевевш: подешевевшие
котор: которым
прописа: прописаны
вариант: вариантов вариант
мир: мир
укол: уколов
силов: силовые
секретн: секретные
предприят: предприятии предприятием предприятия
прав: прав право правила
участвова: участвовать
связа: связана
внешност: внешности
обратн: обратно
вагнер: вагнер
нажм: нажмите
вперв: впервые
получ: получите получить
дивидендн: дивидендной дивидендную
подтвержда: подтверждающая
полага: полагается
фронт: фронте
сферакриптовалютаинвестиц: сферакриптовалютаинвестиции
центральн: центральная центрального
украин: украине
гранат: гранатой
сделк: сделки
актив: активов активы
раскр: раскрыли
выстав: выставил
россиянин: россиянин
рубл: рублей
сосед: соседа
позиц: позицию позиции
облага: облагается
лиц: лиц
заработа: заработать
руб: руб
уровен: уровень
нов: новой
внешн: внешних
част: часть
счет: счета счетов счет счетах
брокерск: брокерский брокерского брокерская
акционер: акционерам акционеров акционерами акционеры
убытк: убытки
допущен: допущенные
внимательн: внимательно
определен: определенное определенные
отзыв: отзывы
эффективн: эффективность
особен: особенность
видет: видеть
деактивирова: деактивирована
дают: дают
редакциярекламаконтактыпресс: редакциярекламаконтактыпресс
торг: торгам
жизн: жизни
расчет: расчете
зашедш: зашедшей
чвк: чвк
климатсоциальн: климатсоциальная
индивидуальн: индивидуальный
всегосэкономикабизнесрынкикапиталделов: всегосэкономикабизнесрынкикапиталделовой
лиценз: лицензия
вопрек: вопреки
летн: летней
натал: наталья
торгов: торговое
путешеств: путешествия
акционерн: акционерного
категор: категории
сделок: сделок
сша: сша
лидер: лидер
техник: техника
утечк: утечке утечки
решен: решение решения
требован: требования
селиверстов: селиверстова
владельц: владельцам
тыс: тыс
культур: культура
передава: передавать
удив: удивились
прозрачн: прозрачна
налог: налоги налога налогом налог налогах налогов
провод: проводить
лнр: лнр
продолжа: продолжает продолжать
личн: личные
рынк: рынке рынка
вылож: выложившего
вычет: вычета вычет вычетом
помощ: помощью
врач: врач
выш: выше
приложен: приложение
рискует: рискуете
скандал: скандалами
документ: документы документов документе
будущ: будущем
удержива: удерживает удерживать
взнос: взнос
выплачива: выплачивает
интерес: интересах
инвестиц: инвестициях инвестиций
агент: агент
средств: средства средств
дан: данном данные
иис: иис
установ: установить
спецпроект: спецпроекты
приобрест: приобрести
раскрыт: раскрыты
закон: закону законом
рост: рост роста
росс: россии россия россией
фбр: фбр
поручен: поручения
гиперзвуков: гиперзвуковой
мотор: мотор
убед: убедиться
ситуац: ситуации ситуацию
имеет: имеет
пожалова: пожаловать
фирм: фирма
счита: считается считаются
деньг: деньги
отказа: отказались
шорт: шорт
цен: ценная цена ценой ценными ценных ценные
понадоб: понадобится
очк: очков
лент: лента ленту
приравнива: приравниваются
упадет: упадет
опечатк: опечатку
владеют: владеют
галер: галереи
оцен: оценить оценили оценил
российск: российского
вознагражден: вознаграждение
политик: политике политику
вмест: вместо
минимум: минимум
обыкновен: обыкновенные обыкновенным
финансов: финансовые
зарабатыва: зарабатывать
покупа: покупаете покупает покупать
тупик: тупик
обнов: обновила
сегмент: сегмент
бирж: биржа бирже
прибыл: прибылью прибыль
жил: жилья
имуществ: имущества
стратег: стратегии стратегий
достаточн: достаточно
почита: почитать
наступлен: наступлении
перемест: переместиться
медиа: медианная
преимуществ: преимуществ преимущество
список: список
ссср: ссср
ориентирова: ориентирован
повыша: повышается
след: следующие
ранжир: ранжирует
дел: делятся
камаз: камаз
организац: организации организация организациях
статус: статус
размер: размер
клиент: клиенту клиентов
коротк: короткую короткой
бездокументарн: бездокументарной
ваш: вашего
так: таком таких
обществ: общества
генерир: генерирует
срок: срок сроки
покупк: покупки
собствен: собственности
течен: течение
держа: держать
уда: удалось
разниц: разницу
блогерш: блогерши
назва: назвал
внест: внести
инвестицион: инвестиционный
сэконом: сэкономить
возрастет: возрастет
противоречат: противоречат
держател: держатели
обсуд: обсудить
некотор: некоторые
отношен: отношении
куп: купить
квалифицирова: квалифицированных
кита: китаем
спорт: спорт
специальн: специальных специальная
собран: собраниях
практик: практику
ряд: ряда
последн: последними последние
сам: самых самые самыми
захотел: захотел
жми: жми
друг: друг другу
теоретическ: теоретически
подобн: подобный
листинг: листингом листинга
называ: называемый называемую называется
рассказыва: рассказывает
компан: компанией компании компания
ограничен: ограничения
программ: программе
управлен: управлении управления
получа: получает получать
ира: иран
влож: вложиться
главн: главное
действ: действует
нашл: нашли
щелкун: щелкунов
голосова: голосовать
обеспечива: обеспечивают
эмитент: эмитентах эмитентом эмитентов эмитент эмитенты
заключа: заключать
предполага: предполагают предполагает
начина: начинающего начинающим начинать начинающих
миридон: миридонов
популярн: популярных популярные
смертельн: смертельной
рад: ради
изуч: изучить изучая
пентагон: пентагона
объясня: объясняет
ран: ранее
помн: помнить
распределен: распределении распределения
зарплат: зарплаты
станов: становятся
лежа: лежать
интернет: интернет интернете
убыток: убыток
вкладыв: вкладываясь вкладывая
го: го
московск: московская
прода: продать проданы продаете
рекорд: рекорд
ласточкин: ласточкин
официальн: официального
пришл: пришлось
развит: развитием развитие
владеет: владеете
предусмотр: предусмотрены
сайт: сайте
уничтожен: уничтоженных
посредник: посредник
придержива: придерживаться
зеленск: зеленского
трех: трех
нанесен: нанесения
щедр: щедрых
ценност: ценности
долг: долгов долгий
долж: должен
газпром: газпрома
десятилет: десятилетий
капита: капитал
оставля: оставляете
базов: базовые
необходим: необходимо
числ: число числе
устав: уставе
период: периода
подозрева: подозреваемого
пробл: проблем
вниман: внимание
сотруднича: сотрудничать
котировальн: котировальный
сбербанк: сбербанка
очеред: очередь очереди
вид: виде
представител: представителей
сет: сети
виде: видео
ликвидац: ликвидации
положен: положения
подход: подход подходит
регулятор: регулятора
попада: попадает
доход: доход дохода доходы
придет: придется
оценива: оценивает
оста: остающегося остаться
нескольк: нескольких
заключен: заключения
подорожа: подорожают подорожать
договор: договора
наук: наука
принима: принимают принимать
тип: типы
позволя: позволяет позволяющих
булкин: булкин
сумм: сумма сумм
бумаг: бумаги бумагам бумаге бумагами бумага бумагах бумаг
рейтинг: рейтинг
дол: долю долей доле
реч: речь
олег: олег
известн: известно известны
общ: общем общих
залог: залог
пригожин: пригожин
предостав: предоставить
обитан: обитания
состо: состоят
тысяч: тысячи
брокер: брокера брокером брокеру брокер
серг: сергей
принцип: принципе
хорош: хорошие
стоимост: стоимости стоимость
профессиональн: профессиональный
обм: обмен
внебиржев: внебиржевых
предусматрива: предусматривает
глеб: глеб
сред: среда
может: можете
люб: любом
плат: платят платить платит
похуден: похудения
потреб: потребуется
язык: язык
согласова: согласовать
умн: умных
фот: фото
обязательн: обязательно
арестова: арестовало
погашен: погашения
нат: нато
составля: составляет
информац: информация
выгодн: выгодным
депозитар: депозитариях
ключев: ключевых
выгляд: выглядит
владет: владеть
год: годы
ликвидн: ликвидные ликвидность
пакет: пакетом
владен: владение владения
конкретн: конкретного конкретных
открыва: открываете
предъявля: предъявляются
ожидан: ожиданиям
критер: критериев
берет: берете
физическ: физических
ставк: ставка
особ: особых
размещен: размещением
пополн: пополнить
потеря: потерять
прич: причем
идет: идет
запис: записей
например: например
перспективн: перспективной
одн: одним
продаж: продажи продажу
самостоятельн: самостоятельно
продав: продавая
забот: забота
откроет: откроет
приб: прибыли
надежд: надежде
потребн: потребность
ведут: ведут
акц: акции акций акциям акциями акцию акция акциях
инструмент: инструментов
сравнительн: сравнительно
сми: сми
надежн: надежность
обстоятельств: обстоятельств
плюс: плюс
музык: музыки
апрел: апреля
дивиденд: дивидендов дивиденды дивидендах
заплат: заплатили заплатить
врод: вроде
участ: участие
аренд: аренды
привилегирова: привилегированным привилегированные
уровн: уровне
использован: использование
отлич: отличие
громк: громкой
льгот: льгота льготы льгот
испытан: испытании
войт: войти
выбор: выбор
налогов: налоговый налоговые налогового налоговых
печата: печатаются
опытн: опытный
раздел: разделены
заяв: заявили
автоматическ: автоматически
болезн: болезни
ракет: ракеты
преф: префы
закрепл: закреплен
обанкрот: обанкротится
ндфл: ндфл
новост: новости
существ: существуют
перв: первом
управля: управляющая управляющей
небольш: небольших небольшой
распределя: распределяемой
формат: форматов
проведен: проведения
добр: добро добра
оо: ооо
возможн: возможности
всу: всу
выбра: выбрать
брос: бросил
пропорциональн: пропорционально
внес: внес
хочет: хочет
как: какие какими
участник: участник
крупн: крупных
голос: голосующими
площадк: площадка площадках
освобод: освободить
бойц: бойцов
прошл: прошлом прошлые
выпуск: выпуска
прежд: прежде
высок: высокой
бывш: бывший
реальн: реальный
стабильн: стабильные
лдв: лдв
втор: втором
выпуст: выпустила
выступа: выступает выступать
риск: риски риск
понесет: понесете
воспользова: воспользоваться
сфер: сфера
стандартн: стандартных
откр: открыт открыть
выплат: выплаты выплат выплате
форм: форме
взайм: взаймы
ри: риа
долгосрочн: долгосрочное
доказа: доказав
рекоменд: рекомендуют
new: news
fotodom: fotodom
ru: ru
shutterstock: shutterstock
killnet: killnet
ctrl: ctrl
appl: apple
globallookpress: globallookpress
fizk: fizkes
enter: enter
