ру: ру
оценк: оценкам
говор: говоря говорить
ливонск: ливонская
впоследств: впоследствии
львин: львиную
фактическ: фактически фактическими
грабеж: грабежей
значен: значение
стат: стать статьи
казак: казаки казаков казаках
обычн: обычную
оказа: оказался оказалась
банд: банды
консолидир: консолидирующей
служ: служили
памятник: памятника
стал: стало
мнен: мнению
объясн: объяснили
последств: последствия
казач: казачья казачье
показыва: показывает
север: северо
арх: архив
экономик: экономика экономики
гедиминович: гедиминовичам
охоч: охочих
манхэттен: манхэттене
внучат: внучатым
человек: человека
каса: касается касалось
вооружен: вооруженных вооруженной
макияж: макияжа
арм: армии армия
изготов: изготовили
представительн: представительному представительный
структур: структуры структур структуре
суд: судя
мужск: мужской
ветв: ветви
царств: царство царства
котор: которое котором которым
демократияисторик: демократияисторик
уз: узами
силов: силовые
осен: осенью
перешл: перешла
секретн: секретные
запад: запад
ящик: ящик
шаг: шагом
трактовк: трактовка
участвова: участвовали
связа: связанного связаны
никитич: никитичем никитич
прав: права
компромиссн: компромиссной
либ: либо
связ: связи
весн: весной
заб: забыть забыли
годун: годунов
верхушк: верхушка
претендова: претендовали претендовал
иванов: иванова
дискусс: дискуссии
вывел: вывел
член: члены членов
исключен: исключением
центральн: центральной центральных
врем: времен
россиянин: россиянин
сосед: соседи соседа
разгром: разгрома
запорожск: запорожских
современник: современников
очевидн: очевидное
нов: нового новой новые новым новая
двинул: двинулась
внешн: внешней
аристократическ: аристократического
приговор: приговорили
отражен: отражения
слом: слом
част: части
превалирова: превалировало
чьим: чьими
слож: сложились
примир: примириться
алекс: алексею
уезд: уезды уездов уездах
чьих: чьих
пригодн: пригодной
литератур: литературы
слов: слово
пострада: пострадавшего
постоя: постоянно
системн: системного
якоб: якоба
сдела: сделали
деактивирова: деактивирована
цар: царя царей царем царе царь
родител: родителями
фигур: фигурой
совет: совету совета
активн: активно
отчетлив: отчетливо
русск: русских русского русский русской русскую русским
пример: пример
упорн: упорных
федорович: федорович федоровичу федоровича
истреблен: истребление
затуха: затухал
природ: природе
динамичн: динамично
процедур: процедура процедурой
систем: система системы
кремл: кремле кремль
выход: выход
класс: классу
завоева: завоевать
алексе: алексея
государствен: государственного государственное
дяд: дядей
летн: летней
выж: выживших
архив: архиве
подросток: подросток
нема: немало
трудн: трудно
путешеств: путешествия путешествие
крестьян: крестьяне
закреп: закрепиться
сожален: сожалению
мозжухин: мозжухин
осад: осадила
сша: сша
миха: михаила михаил
лидер: лидер
русикровав: русикровавые
процесс: процессы процессом
аппарат: аппарата
групп: группами
сакральн: сакральном
приписа: приписан
истреб: истребил
техник: техника
окрестн: окрестностях
европ: европы
постепен: постепенно
культур: культура
мемуарн: мемуарной
налог: налоги
пятин: пятинные
разбойнич: разбойничьи
лнр: лнр
продолжа: продолжалась
запорожц: запорожцев
черед: череда
разлучен: разлученному
разношерстн: разношерстную
рюрикович: рюриковичам рюриковичей
неизвестн: неизвестного
малозначим: малозначимым
современ: современных
врач: врач
филарет: филарет филарета
древнерусск: древнерусская
заключ: заключила
враг: враг враги врагом
агресс: агрессии
отступ: отступил
поколеба: поколебались
текст: тексту
соправительств: соправительством
самодержавн: самодержавной
будущ: будущий будущего
наоборот: наоборот
лобб: лобби
прекрат: прекратить
сын: сына сын сыну
бояр: бояре боярами
уцелел: уцелел
женитьб: женитьбы
агрессивн: агрессивная
поскор: поскорее
марионеточн: марионеточное
стародубск: стародубских
пожар: пожар
отключ: отключены
борьб: борьбе
спецпроект: спецпроекты
протяжен: протяжении
взаимн: взаимное взаимные
казн: казней казна
болотников: болотникову
росс: россии россия россией россию
употребля: употреблял
едв: едва
фбр: фбр
крестья: крестьян
престол: престоле
фронтпоч: фронтпочему
мотор: мотор
извест: известие
ситуац: ситуации ситуацию ситуация
служебн: служебному
битв: битве
каза: казалось
счита: считалось считался считали считалась
семибоярщин: семибоярщины
беседова: беседовал
причин: причин
конкурент: конкуренты
цел: целом целому целей целых
цен: ценой
отлича: отличался
трон: трон троне
лент: ленте лента ленту
человечеств: человечества
руководител: руководителями руководителей
опечатк: опечатку
российск: российского
отчужден: отчуждению
станиславск: станиславский
политическ: политический политической политическую
разорен: разорении разоренной
властн: властный
деулинск: деулинское
конфронтац: конфронтации
иностра: иностранным
всяк: всякий
назар: назаров
серьезн: серьезный
юн: юный
делагард: делагарди
настоя: настоящим
выключ: выключила
ссср: ссср
замечательн: замечательный
строг: строго
след: следующих след следует
институт: институт
лукин: лукин
организац: организации
государев: государевой
попыта: попытался
приемлем: приемлемым приемлемый приемлемой
так: такую
письмен: письменных
созыва: созывались созывали
картин: картина
провинциальн: провинциальной
событ: событий
семейств: семейства
маргинал: маргиналов
течен: течение
хран: хранились
гарнизон: гарнизона
блогерш: блогерши
капитуляц: капитуляции
назва: назвать назвал
собира: собираться собирались
описыва: описывала
формул: формула
клушинск: клушинской
некотор: некоторых
противостоян: противостояния
потенциальн: потенциальные
болезнен: болезненные болезненным
отряд: отряды
количеств: количество
служб: службу
благородн: благородных
остава: оставались
логичн: логичным
спорт: спорт
выпа: выпавших
воцар: воцариться
иванович: ивановича
зна: знаем
многотолкуем: многотолкуемых
представля: представляли
стро: строилось
друг: другом другому
приход: приходилось
восстанов: восстановился
совершеннолетн: совершеннолетним
крушен: крушение
сбор: сбор
ворпоч: ворпочему
рассказыва: рассказывается
степен: степени
программ: программе
составл: составлена
главн: главное главнее главными
действ: действующий
двоевласт: двоевластием
литовск: литовской литовского литовским
фамил: фамилий
привел: привела
октябр: октября
состоян: состоянии
поражен: поражения
боярств: боярство
угрюмов: угрюмова
региональн: региональному
отстоя: отстояла
патриарш: патриаршем
созда: созданному создать
предшественник: предшественника
патриарх: патриархом патриарх
ран: раннем
осажда: осаждали
несравнен: несравненно
нижн: нижнего
конструкц: конструкцию
интернет: интернет
необычн: необычный
командован: командованием
московск: московских московским московском московской
бегл: беглый
тем: теме
основател: основателем
пришл: пришлось
велич: величие
полк: полков
замара: замарали
диктова: диктовать
приглашен: приглашению приглашение
поставлен: поставления
комментар: комментарии
поставл: поставлены
сотрудник: сотрудник
сильн: сильные
нанесен: нанесения
долг: долгим долгих
долж: должен
расстриг: расстрига
минин: минина
норм: нормам
кандидат: кандидата кандидатом кандидатах кандидат кандидатов
заслужива: заслуживает
необходим: необходимо
числ: числа число числе
подходя: подходящей
правител: правителем
подозрева: подозреваемого
кризис: кризиса
вынужден: вынужденной
сотруднича: сотрудничать
комнат: комнате
привед: приведу
автор: автора
виде: видео
коллаборационизм: коллаборационизме
тушинск: тушинский тушинского
явн: явным
историческ: исторических
оста: осталось
монарх: монарха монархи монархии
вырабатыва: вырабатывались
быстр: быстро
правя: правящей правящему
принима: принимала принимались
воспринима: воспринималась
реч: речь речи речью
многолетн: многолетнего многолетней многолетняя
международн: международные
общ: общего
остав: оставил оставила
гражданск: гражданской гражданская
окончан: окончания
сигизмунд: сигизмунд
пригожин: пригожин
обитан: обитания
состо: состоит
федор: федора федором федор
династ: династией династии
грамот: грамота грамоты
серг: сергей
обо: обоим
сослов: сословий сословию сословием
сред: среда среди
польск: польского польско польский
социальн: социальному социальной
погибл: погибли
мног: многое многих
уста: устали
люб: любом
похуден: похудения
клушин: клушине
язык: язык
целесообразн: целесообразности
катастрофическ: катастрофические
правд: правда
гот: готов
разн: разными разным разных разные
избирательн: избирательный избирательного
новгородск: новгородскую
люд: людям людях людей
лаврент: лаврентьев
ставш: ставшего
образн: образно
год: годы
конкретн: конкретных
царевич: царевича
потеря: потерянных
прич: причем
принадлежа: принадлежал
смоленск: смоленск смоленской
одн: одно одни одном одних
продаж: продажу
широк: широкое
согласн: согласно
перемир: перемирие
смуща: смущать
столиц: столице
потребн: потребность
свидетельств: свидетельствам
петр: петре петра
тушин: тушине
ведущ: ведущий
насчитыва: насчитывалось
достоверн: достоверно достоверных
экземпляр: экземплярах
донск: донских донские
апрел: апреля
опир: опираясь
таков: таковые
ярославл: ярославль ярославле
врод: вроде
уникальн: уникальным
участ: участие
лазаревич: лазаревич
поскольк: поскольку
марф: марфе
историк: историк историков историкам историки
войн: война войны
март: марте марта
испытан: испытании
войт: войти
кровн: кровными
существова: существовало
состав: составу составе
сомнен: сомнению
подпис: подписи подписях подписей
глаз: глазами глазах
протокол: протоколы
деятельн: деятельность
сраз: сразу
духовенств: духовенству
шестнадцатилетн: шестнадцатилетнего
убийств: убийства
неясн: неясных
григор: григория
упомина: упоминаются
болезн: болезни
ракет: ракеты
вполн: вполне
жела: желавшие
выража: выражались
новост: новости
избран: избрание избрания избрании
принц: принцы
корол: король
перв: первой первых первые первого
корон: корону
руин: руинах
трехсот: трехсот
государ: государь государя
проведен: проведения
юнош: юноша
добр: добро добра
родов: родовой
прибалтийск: прибалтийский
голов: головах
противореч: противоречиях
участник: участники участников участникам
как: какую какому какие каких какого
детств: детстве
матер: матери
преодолел: преодолело
родствен: родственными
рассматрива: рассматривались
площадк: площадкой площадки
переговор: переговоры
наследствен: наследственный
род: родов рода родиться родилась
реальн: реальным реальные реальный реальную
втор: второго
рол: роль
точн: точно
точк: точки
сфер: сфера
мер: мерой
легитимн: легитимной легитимность
максимальн: максимально
найт: найти
компромисс: компромиссы компромисса компромисс
влиян: влияние
студентк: студентке
тыльн: тыльной
парламент: парламента
русикак: русикак
столбовск: столбовский
заверша: завершающем
образ: образом
ввод: вводить
конц: концов конце
обид: обидами обиды
дорог: дорога
геро: героя
случа: случае случаях
удал: удалить
наподоб: наподобие
поневол: поневоле
практическ: практически
вернут: вернуться
выяв: выявил
преда: предать
вернул: вернулся
александр: александр
старомосковск: старомосковское
вообщ: вообще
доминир: доминирующую
преврат: превратившись
личност: личности личность
небезопасн: небезопасна
смут: смута смуты
незач: незачем
сочт: сочтя
показа: показали показал
поэт: поэтому
кандидатур: кандидатуру кандидатуры
вариант: варианты
вывест: вывести
мир: мир
навел: навела
укол: уколов
исследован: исследования
совершен: совершенные совершенно
обсужда: обсуждались
знают: знают
внешност: внешности
этап: этапе
организатор: организаторам
подписыва: подписывались
орга: орган
вагнер: вагнер
чрезвычайн: чрезвычайные
нажм: нажмите
коллективн: коллективно
ополчен: ополчения ополчений
ива: иван ивана
россиикосмосоружиеисторияздоровьебудущеетехникагаджетыигрысофт: россиикосмосоружиеисторияздоровьебудущеетехникагаджетыигрысофт
патриотизм: патриотизме
новгород: новгорода
власт: власть власти
получ: получил
публик: публику
общегосударствен: общегосударственных
фронт: фронте
важн: важно
экспедицион: экспедиционный
город: городов город
призван: призвании призвание
враждебн: враждебным
владисла: владислав
украин: украине украину
правлен: правления
ежегодн: ежегодно
гранат: гранатой
отец: отец
раскр: раскрыли
подлин: подлинное подлинного
боярин: боярином боярин
выстав: выставил
площад: площади
непримирим: непримиримого
могл: могло
опа: опала
анастас: анастасии
действительн: действительности
кстат: кстати
больш: большой большое
наде: надеясь
посполит: посполитая посполитой
порядок: порядок
счет: счет
андр: андрей
длительн: длительной
аналогичн: аналогичный
ясн: ясно
эффективн: эффективность
посыл: посылом
видет: видеть
бесспорн: бесспорно
насильн: насильно
мягк: мягко
редакциярекламаконтактыпресс: редакциярекламаконтактыпресс
представлен: представлений представленные представления
сословн: сословными
независя: независящих
репрессирова: репрессированного
жизн: жизни
лжедмитр: лжедмитрий лжедмитрию лжедмитрия
забвен: забвению
отягощен: отягощенная
зашедш: зашедшей
населен: населения
чвк: чвк
индивидуальн: индивидуально
мог: могу
пыта: пытался
полноцен: полноценная
земск: земский земского земских земские земском
момент: момент
мон: монах
ожесточен: ожесточенной
обсужден: обсуждения
романовн: романовны
приглаш: приглашен
заседан: заседаниях заседаний заседание
инокин: инокине
смог: смог
развива: развивалось
основн: основным основном
посадск: посадским
борис: борису бориса борисом борисе
племянник: племянником
сторонник: сторонниками
пополня: пополнялось
небезупречн: небезупречно
средневеков: средневековья
опальн: опальными
привест: привести
годунов: годунова годуновым годунову годунове
андре: андрея
дошл: дошли
утечк: утечке утечки
решен: решение решения
мгновен: мгновенно
удив: удивились
всерьез: всерьез
личн: личные личными
васил: василия
делегат: делегатами делегаты делегатов делегатам
сюжетнаселен: сюжетнаселение
поздн: поздних
бесчеловечн: бесчеловечные
советск: советские
аристократ: аристократии
отц: отца отце отцу
смерт: смерти
ушедш: ушедший
делегац: делегация
соблюст: соблюсти
вылож: выложившего
выбира: выбирали выбирать
верховн: верховную верховной верховная
ввел: ввел
результат: результатам
объективн: объективно
опыт: опыта
прокляст: проклясть
павел: павел
явлен: явлением
пониман: понимание
документ: документы документов документа документе документ
ссылк: ссылке
жен: жениться жены
имел: имел имелись имели имела
был: былые
дан: данные
кончин: кончины
установ: установился установить
имен: именем
указа: указал
состоя: состоялся
раскрыт: раскрыты
хват: хватило
станет: станет
царск: царском царские царский
подверга: подвергал
шуйск: шуйского
осторожн: осторожности
гиперзвуков: гиперзвуковой
простонарод: простонародьем
отсутствова: отсутствовали
освобожден: освобождения
вряд: вряд
пожалова: пожаловать
медлен: медленно
михаил: михаилу
деньг: деньги
брат: брат братьев
пятидесят: пятидесяти
изъя: изъян
очк: очков
экзотическ: экзотическое
возраст: возраст
галер: галереи
границ: границей
прегрешен: прегрешения
доеха: доехала
оцен: оценили оценил
дво: двое
сохран: сохранились
политик: политики политике
вмест: вместе
финансов: финансовая
боярск: боярским боярской боярских боярская
жив: живом
тупик: тупик
име: имеем
вторжен: вторжением
злейш: злейшим
обнов: обновила
правительств: правительством правительство
настроен: настроения
ваз: ваза
жил: жилья
начал: началу
ворва: ворвались
возвращен: возвращения
заня: заняло
потомк: потомков
наступлен: наступлении
шведск: шведский шведское шведским шведских шведскую
неженат: неженатого
медиа: медианная
княз: князья князя князей
учитыва: учитывать
высш: высшей
танд: тандем
ошиб: ошибиться
вернувш: вернувшийся
ориентирова: ориентированное ориентировалась
михайлович: михайловичу
корпус: корпус
произошл: произошло
таинствен: таинственных
итог: итоге
обеспеч: обеспечить обеспечила
патриархат: патриархат
возобнов: возобновилась
дел: дело деле
вопрос: вопроса вопросы вопрос вопросов
рассказа: рассказал
сохраня: сохранялась
игра: играл
внутрен: внутренних внутренней
неудачн: неудачных
показательн: показательный
проход: проходили
москв: москвы москву москве
никт: никто
обществ: общества
усил: усилий
семейн: семейная семейным семейного
распра: расправ
срок: сроки
утвержен: утверженная утверженной
избра: избравшем избрал избравшего
уда: удалось
территор: территорий
дет: детям
материал: материалы
монах: монахи
трубецк: трубецкого трубецкой
восстановлен: восстановления восстановлению
смел: смелая
отношен: отношениями отношений
иска: искали
кита: китаем
практик: практика
ряд: ряду
последн: последний последним последнего последние
месяц: месяца месяцев
мученическ: мученически
примиря: примирялись
сам: самое самый самых
стрельц: стрельцам
первенств: первенствующих
захотел: захотел
жми: жми
учест: учесть
школ: школы
преувеличен: преувеличенная
тотальн: тотальном
образован: образование
подобн: подобная
романов: романовых романовым романова романову
управлен: управления
ира: иран
принят: принятии
характер: характере характер
нашл: нашли
складыва: складывались
век: века веке
вел: вели велись
предполага: предполагалось
постриж: пострижен
западн: западные
популярн: популярных популярные
опустошен: опустошении
смертельн: смертельной
влекл: влекло
элементарн: элементарный
научн: научный
достига: достигало
пентагон: пентагона
оккупирова: оккупировал оккупировала
сво: своем свой
первостепен: первостепенное
посольств: посольство
забыва: забывались
лежа: лежала
значительн: значительной
го: го
королевств: королевство королевством
рекорд: рекорд
кузьм: кузьму
плен: плена
сведен: сведений
мудрост: мудрости
представ: представить
контрол: контроль
бессудн: бессудных
уничтожен: уничтоженных
факультет: факультета
происход: происходило происходил
обществен: общественных
задач: задач
зеленск: зеленского
трех: трех
трет: третьим третьи
сомнительн: сомнительный
ценност: ценности
переступ: переступить
влиятельн: влиятельные влиятельных
повест: повесть повести
истор: истории история
зрен: зрения
праздник: праздник
насущн: насущных
сем: семьи
психолог: психологии
многолюдн: многолюдности
произошел: произошел
экзистенциальн: экзистенциального
представител: представителем представителям представители представителей представителями
сет: сети
красн: красной
вплот: вплоть
одобрен: одобрения
дореволюцион: дореволюционные
тимофеевич: тимофеевича
договор: договорились
наук: наука наук
кившенк: кившенко
эпох: эпохе эпохи
терроризирова: терроризировали
дол: долю долей
дон: дону
поддержа: поддержали
известн: известно известной
сторон: стороне стороны
крым: крым
обойт: обойтись
поддержк: поддержка поддержки
остальн: остальных
пожарск: пожарского пожарский
глубок: глубокого
принцип: принципу
хорош: хорошие
двоюродн: двоюродный
стоимост: стоимость
воссозда: воссоздались
пуст: пуста
предыдущ: предыдущей предыдущих
нахожден: нахождения
оборот: оборот
наш: нашей нашего
швед: швед
сыгра: сыграл
большинств: большинство
сил: силу
умн: умных
швец: швеции
арестова: арестовало
регулярн: регулярно
новшеств: новшество
нат: нато
гуманитарн: гуманитарных
составля: составляли
насил: насилия насилий
информац: информация
сход: сходятся
родоначальник: родоначальником
земл: земли землю
замет: заметил
стокгольм: стокгольм
царствован: царствование
грозн: грозным грозного
понят: понятия
переста: перестали
черн: черный
костром: костромы
идет: идет
платон: платонов
например: например
примечател: примечателен
вне: вне
забот: забота
страт: страты
гравюр: гравюра
вор: вора
роман: романов
польш: польши
казачеств: казачество
сми: сми
убива: убивать
обстоятельств: обстоятельства
рябушкин: рябушкина
ма: мая
крестьянств: крестьянству
музык: музыки
иван: иваном
стран: странная страну страны стране странно страной
аренд: аренды
вол: волю
штурмова: штурмовали
побед: победу
портрет: портрет
громк: громкой
коалиц: коалиции
сист: систему
сиден: сидение
выбор: выборе выборы
собор: соборы собор соборе соборах соборов собора
государств: государства государством государство
дум: дума думы
царствова: царствовал
запросн: запросные
угроб: угробила
заяв: заявили
подростк: подростка
исследовател: исследователей
об: обо
управля: управлял
орган: органом органу
относ: относился относиться
оо: ооо
оп: опыт
возможн: возможность
всу: всу
молод: молодой
выбра: выбрать
брос: бросил
просуществова: просуществовавшей
всенаука: всенаукав
все: всея всей
пепелищ: пепелища
дмитр: дмитрия дмитрий
серге: сергея
бойц: бойцов
выпуск: выпуска
наверн: наверное
бывш: бывший бывшие
выборн: выборным выборного
палач: палач
выступа: выступало
наверняк: наверняка
прежн: прежние прежней
ник: никого
спасител: спасителя
июл: июля
наход: находилась находился находились
никак: никак
источник: источников источник
ii: ii
killnet: killnet
ctrl: ctrl
xix: xix
xvii: xvii
appl: apple
iii: iii
xvi: xvi
enter: enter
