обрат: обратиться
найт: найти
готов: подписан
говор: говоря говорю
понима: понимать
образ: образ
аксенов: мнение аксеновой
оказа: оказавшийся
обычн: обычных
мнен: гусеву
самоубийств: самоубийство
геро: героев предоставлено героя
фашистск: фашистскими
поцелу: поцелуе поцелуя
случа: владельца
разрушен: разрушенный
вайс: вайс
частичн: полное
показыва: показываете
грет: звезды
будьт: будьте
правов: рекламы
привлеч: лица
пандем: пандемии съемкам
основан: основания
человек: идеального
вообщ: вообще
единствен: единственная
стремлен: стремление
разговор: разговоре
ошибок: ошибок
крименск: наталье
суд: суде суду
показа: показано
звезд: звезда звездах американской
человеческ: человеческие
екатерин: включая
благодар: доволен
котор: дом
мин: мин
утомлен: утомленных
мир: миру
идеальн: сыграть
обсужда: встречались
связа: связан
прав: редакции
майш: майшев
съемк: готовилась проходили съемках
нажм: текст
выраз: выразить
сцен: сцены сцен
получ: получил
произведен: произведение
французск: французская
происхожден: немки
верс: версию версия
узнава: земным
навяза: нюрнберга
важн: важнейшую важна
одиночеств: одиночества
провел: родились
озвуч: озвучил
город: город города городе
разведчик: разведчика
норгаард: норгаарде
приукрашива: приукрашивать
занима: занимает
марша: маршала
могл: могла
лиц: виновные
подписа: подписанный происхождению
очевидн: очевидностью
действительн: действительность
нарушен: обнаружения
кстат: кстати
снявш: снявший
повторен: повторения
расскажет: расскажет
мест: место любимых сложное
предоставл: области
алекс: алексее алексей
паулюс: паулюсом паулюса
якоб: якобы
отда: отдано
художник: художник
подыска: подыскать
кастинг: довольны замечательным
сложн: вдвойне материал
родител: сюда
поработа: хотел
пут: путь
драматическ: драматическое
жал: жаль
пример: примере
актер: актеров актеры актерах актер
корректив: внесла
персонаж: персонажами персонажей
превосходн: превосходный превосходная
натал: директорам
немк: греты
харвуд: харвуд
перебра: ребенком
съемок: съемок
миха: михаил
процесс: процессе
патрис: патрисия
произошедш: произошедшего
напрот: набережная
доказательств: доказательства доказательствами
выжгл: выжгла
хотел: хотелось ошибочное
владельц: разрешения
прощальн: прощального
допрос: допросу
культур: культурой
комментирова: разная
продолжа: продолжаем
нужн: нужна
советск: советский
смерт: смерти
первоклассн: бишоп
карстен: карстене
материа: материала сильный
художествен: художественного художественное
вольфганг: вольфганге
любл: мыслей
результат: планы
выступ: выступил
харизматичн: харизматичный
чех: съемки
отчаян: отчаяния
довольн: полностью
вышедш: вышедшего
принест: принести
текст: выделите
воссоздан: воссоздании
холбрук: холбруке
будущ: продолжится
геринг: геринга геринг герингу
нацистск: нацистскими нацистских
показан: показаниям
жен: жены
кунц: кунце
голенк: голенков
дан: данных актриса
сходств: сходства
отключ: залесский
весьм: весьма
безруков: безрукове
людвиг: людвиге
лебед: лебедев
росс: чехии
допуск: допуская
драматизац: драматизации
найдет: люблю
невол: неволе
разруш: разрушен
впуска: впускать
допуст: допустить
цел: коммерческих
продюсер: навязали
наруш: коррективы
маркус: маркусе
опечатк: нашли
романтическ: романтическую
российск: законодательством
политик: использования
множеств: открыли
директор: кастинг
коммерческ: сайта
отличн: отличные
довол: кастингом
жив: котором
преступлен: преступлений
серьезн: серьезны
прекрасн: множество представилась
сюд: приезжал
настоя: настоящий
слеп: слепым
кадр: кадр
мерзавц: мерзавцев
выдел: опечатку
яд: яд яда
замечательн: сыграла создал благодарен
стольк: столько
калининград: калининграде
вопрос: вопросом вопрос
рассказа: рассказал
игра: играть играет играли
внутрен: внутренней
ваш: вашего
проход: местах
зла: зла
ответ: ответ ответа
письмен: разрешено
москв: кишиневе пруды москве
преступник: преступников преступниками
картин: картинах картины ансамбль
полност: узнаваемым
несмотр: несмотря
неправедн: неправедный
копирован: частичное
редакц: телефон редакция
фишер: фишере
добива: добивались
прочувствова: прочувствовать
материал: партнерские копирование
внесл: пандемия
суицид: суицида
снима: счастлив
залесск: антон
отношен: отношения отношению
кемп: кемпо
ад: аду
обща: общаться
экипаж: экипаж экипаже
актрис: прекрасных замечательная
пруд: чистые
остава: человека оставаться
район: живу
мысл: героем
бах: лаура
многовеков: многовековой
солнц: солнцем
услов: информация
павильон: павильоне
друг: другом другим
задава: задавался
ошибочн: продюсеры
абсолютн: абсолютных оставался
рассказыва: рассказываемой
михалков: михалкова
главн: главного главных
характер: характеров
действ: соответствии
каас: каас
нашл: конфиденциальности
миронов: миронове
никол: николая
приезжа: любил
состоян: состояние
предлаг: предлагая
популярн: популярная
сотрудничеств: ним
режиссер: режиссер режиссером
киностуд: киностудии
рад: поработать
област: калужской
созда: будущем
вдвойн: полюбил
нача: начать
творчеств: творчеству
передач: передачи
значительн: значительное
оруд: орудие
ансамбл: актерский
кишинев: детство
парк: марьино
тем: тема
полн: защищены
легенд: легенде легенду
представ: рад
зрител: зрителям
сайт: материалов
продолж: сотрудничество
спаса: спасает
полад: бах
детал: деталей
работа: работать
сильн: точный
долг: долгое
артистк: прекрасная
искусств: искусства
телефон: нажмите
необходим: необходимо
истор: историей истории история
числ: числе
нэнс: крименской
подходя: найдется
чист: напротив
предстоян: предстояние
фучик: фучик
посредств: посредством
автор: комментировать
очеред: очередь
конфиденциальн: политика
превраща: превращает
разрешен: письменного
историческ: историческими исторической исторического исторических историческая
естествен: естественным
волгин: волгина
мосфильм: мосфильм
наук: наукой
виновн: нарушений
разреш: целях
дом: мест
певиц: певица
известн: известный
исполн: исполнил
знаменит: знаменитому картине
прокат: прокат
обойт: обойтись
любов: любовь любови
марин: марине
поддержива: поддерживаем
портретн: портретного
глубок: глубокий
включ: актрис
свидетельск: свидетельским
серг: сергее сергей
родн: снимать
профессиональн: профессиональные
никит: никиты
защищ: права
любим: чудесный
гусев: екатерину
обвинен: обвинения
мног: многом
посвящен: посвященного
сыгра: результате сыгравший попробуйте
полюб: перебрался
калужск: подмосковье
люб: москву
снят: снять
над: надеюсь
актерск: актерская первоклассный
сил: силы силу силе
снял: снялась
план: нарушила
фот: фото
попроб: сложный
происходя: происходящему
эпизод: эпизод
евген: евгении
информац: правовая
правд: правда правде
земн: абсолютно
разн: москва
люд: людям людей
герма: германа
звер: зверя звере
нюрнберг: нюрнберг нюрнберге аксенову
контракт: контракт
законодательств: действующим
отража: отражает
марьин: районе
набережн: парк
размещен: материалы
черн: черни
привод: приводить
антон: автор
одн: одна одному
никола: николай
миров: мировой
реклам: отключить размещение
достовер: достоверен
соответств: ответственности
глубж: глубже
юлиус: юлиус
команд: команда
обстоятельств: обстоятельствах
достоверн: достоверность достоверности
типаж: типажи
апрел: апреля
ответствен: привлечены
вытопта: вытоптала
федерац: российской
ипостас: ипостасях
стран: странно
свет: свету
использован: условия
громк: громкие громком
портрет: портрет
поскольк: поскольку
сист: систему
войн: войне войной война войны
подмосков: россии
бишоп: нэнси
лаур: дании
марк: марке
выбор: выборе
наскольк: насколько
обнаружен: случае
бардуков: бардукове
чудесн: артистка
пишет: пишет
об: обо
новост: новости
принц: принцев
перв: первую
дума: думал
счастл: подходящий
партнерск: рекламу
добр: добрые
возможн: возможность
интересн: интересно
равн: равно
планир: планирует
американск: обсуждали
выбра: выбрал
безумн: безумно
все: всей
детств: провели
судебн: судебном
герман: германия
фильм: фильм фильма фильме
встреча: знаменитая
рвет: рвется
шарлотт: шарлотте
прежд: прежде
род: родном
рол: роль ролей
точн: точные замечательно
бдительн: бдительны
прежн: прежних
ребенк: родителями
откр: поладили
ри: риа
напрям: напрямую
мослент: мослентой
каков: какова
aa: aa
rss: rss
moslenta: moslenta
ctrl: ctrl
enter: enter
