ру: ру
понима: понимать
фактическ: фактически
стат: статьи
воен: военного военные военных военный
обычн: обычную обычного
стар: старые
оказа: оказаться
служ: служит служил
стал: сталь
локац: поспешно
самоубийств: самоубийство
северн: севернее
последств: последствия
работ: работа работе работы работой
центр: центром
показыва: показывают
арх: архив
экономик: экономика
неприметн: паркуется
килограмм: килограмма
пол: полями поле
сто: сто
размеща: размещать
просматрива: просматриваются
человек: человека
охот: охотится
пункт: пункты
заполня: заполняет
поступ: поступить
вооружен: вооруженных вооружении вооруженным вооруженными
арм: армии
разговор: разговор
то: той
мобильн: мобильны мобильные
банальн: банально
структур: структуры
неярк: неяркое
ветк: ветка
карт: карты
попрост: попросту
разгар: комьями
карм: карма
времен: временно
здан: здание
подкреплен: подкреплений
силов: силовые
запад: западе
ум: уме
авдеевк: авдеевку авдеевке авдеевка
железнодорожн: железнодорожная
прав: правило правят
радиолокацион: радиолокационную радиолокационные
обратн: обратно
внезапн: внезапных
уч: учились
уш: уши
связ: связи
ушл: ушли
весн: весны
неплотн: неплотным
дронобойн: дронобойного
дела: делают
извн: извне
угледар: угледар
лопатк: лопатки
располож: расположились
вывел: вывели
контрбатарейн: контрбатарейной контрбатарейную
отреза: отрезать
разобра: разобрался
избавля: избавляется
прием: приемы
прост: простая простым
лин: линии линию линия
рубл: рублей
занима: занимать
лиц: лица
украинц: украинцы
нов: новые новая
ног: ног
част: части часть
тишин: воцарившуюся
похваста: похвастаться
крупнокалиберн: крупнокалиберная
слов: продолжает словам
завод: заводы
одновремен: одновременно
постоя: постоянно
сдела: сделала
особен: особенности
деактивирова: нажмите
сложн: сложно
судьб: судьба испытывать
пул: пуль
пут: путем
донос: посадки
вылетел: вылетел
активн: активные
ноч: ночам
расчет: расчете расчет расчеты расчетов расчета
систем: система системы системой
строительств: строительством
трепетн: трепетно
самолет: самолеты
должност: должности
срочн: судьбу
узна: узнал узнает
частн: частный
путешеств: путешествия
труб: труб
атакова: атаковать
ресурс: ресурс
укрепрайон: укрепрайоны укрепрайону
миха: михаил
машин: машины машина
процесс: процесс
осколк: осколков
групп: группы сопровождающий
техник: техника технику
выпуска: выпускали
требован: требование
хотел: хотел
культур: культура
дружб: дружбы
заезжа: заезжаем
волонтер: волонтерам волонтеры
продолжа: безотказно продолжается
заглуша: заглушает
беззвучн: моторы
зависа: зависает
вечер: вечера
неизвестн: выныривает
современ: современные современной
помощ: помощью
батальон: батальон
выш: выше
передвижен: передвижения
улетел: улетел
тонк: похожий
вычислен: вычислений
склад: складам
опасн: опасность опасна опасности опасно
промышлен: промышленных промышленности
ракетн: ракетная ракетных
жител: жителей
сигнал: сигналы
оглушительн: оглушительный
лоб: лоб
навык: навыки
ироничн: иронично
марьинк: бою марьинке марьинку разгаре
грамотн: грамотность
калькулятор: калькуляторов
подчеркива: подчеркивает
однообраз: однообразия
экскаватор: экскаваторами
средств: средством
завтрака: завтракает
борьб: борьбы борьбу борьба
отделен: отделение отделения
спецпроект: спецпроекты
росс: россия
едв: едва
подкуп: подкуп
толк: одиночными
мотор: планер мотор
допуст: реактивщиков
убеж: убежишь
счита: считают
напичка: напичкать
причин: причине
полудюжин: полудюжины
вынырива: облаков
цел: цели цель целое
спецоперац: спецоперации
цен: цена
местност: местности
отлича: отличается
распутиц: распутицы
сериал: сериалах
лент: лента ленту ленты
сообща: сообщает
кажд: каждого
опечатк: нашли
конча: кончается
российск: российским российские российских стихают российской
отнюд: отнюдь
выезжа: отвечает
настигнет: настигнет
идут: идут
веден: ведения
кутуз: кутузов
юв: юво
юг: юго
ведет: ведет
билет: билеты
желез: железо
окошк: окошко
противотанков: противотанковыми
примерн: примерно
добавля: добавляет
разгружа: разгружают
соприкосновен: соприкосновения
проспект: проспектом
кадр: кадр
йог: йогу
ссср: ссср
посыплет: посыплется
замечательн: замечательно
след: следить пару следующей
дежур: дежурят
поясня: поясняет
так: такого таких
досягаем: досягаемости
касательн: касательно
техническ: техническое техническими
мощн: мощные
выкурива: позволяющий
беспилотник: беспилотники
приближен: приближение
грохот: грохот
собира: собирает собирать
подбира: подбираются
фабричн: фабричных
формул: формул
нанос: выслеживать
звуков: звуковая
откуд: откуда
обсуд: передышку
гиацинт: гиацинты гиацинт гиацинта
противостоян: противостояние
огнев: огневого
залп: одиночный
служб: служба
попа: находились
снаряд: снарядов попал снаряда снарядами снаряды
остава: оставаться
штурм: штурм
спорт: спорт
полдн: полдня
воцар: марьинки
покрыва: покрывается
неприятел: неприятеля
звон: звон
представля: представляют представляет
стро: строя
скаж: хочу
возвра: локацию
закр: закрыть
зон: зоне
приход: приходится
помеша: помешало
реактивн: реактивной
подчинен: подчиненных
кинжа: кинжал
рассказыва: рассказывает
донецк: донецком донецка грады донецкой донецку
коммуникац: коммуникации
получа: получает марьинка получалось
ежедневн: ежедневно
поспешн: командует
главн: главной главную главное дня
разбира: сильно разбирать
действ: посмотреть
воздух: воздухе
покида: покидаем покидает
страда: страдают
наведыва: наведываются
обеспечива: обеспечивают обеспечивает
взросл: взрослых
зажигательн: зажигательными
пристрелива: следует
увоз: увозят
инициатив: инициативе
поражен: поражении поражения
индустриальн: индустриальным
уверя: уверяют
наблюдател: наблюдателей
успева: замечают
штурмовик: штурмовиков
улыбк: улыбкой
кирилл: кириллов
ствол: ствола ствол
припаркова: припарковался
вника: вникать
сигна: сигнала
громыха: укрытию
конструкц: конструкции
интернет: интернет
возвод: возводятся
командован: командование
клепа: клепают
мобилизова: мобилизованный мобилизованного
штаб: штабе
привычк: привычкой
воева: воевать
применя: применяемых
пришл: пришла
знат: знать
госпитал: госпиталях
определя: определяются
винтик: винтик
штат: штате
радар: радаров
прощ: проще
работа: работают работать работаем работал работает
сильн: хочется
долг: долга
подсказк: появился
оставля: оставлять
театр: театре
агломерац: агломерации
необходим: необходимости
числ: числе
проб: пробыть
трасс: трассе
чист: чистое чистый чистом
дрон: дроны дрона беззвучны дронов
вниман: обратил
виде: видео
вражеск: вражеская
подход: подходы квадрат
явн: явно
реб: ребят
километр: километров
оста: остается
быстр: быстро
новобранц: новобранцев
краснодар: краснодара
характеристик: характеристиками
распространен: распространенному
портативн: портативных
наушник: наушники
реш: решил
минирова: минировать
общ: общих
бронетехник: бронетехнику бронетехники
защища: защищает
обитан: обитания
недел: недель недели
поддержива: поддерживает
стиха: понемногу
землетрясен: землетрясение
профессиональн: профессиональные профессиональный
пехот: пехота пехоты выкуривать
осколочн: осколочных
фантастик: фантастики
оператор: оператор
практикова: практиковал
сред: среда среди
предосторожн: предосторожности
слыш: группу
эдуард: эдуард
мног: многом многие
наблюда: наблюдает
люб: любые любую любой любом любая
заместител: заместитель
фот: фото
несложн: несложно
телосложен: телосложением
критичн: критичной
поразительн: поразительной
отсека: отсекать
сверхмал: сверхмалой
гот: готов
взял: взял
планер: тонкий
электромеханик: электромехаником
координат: координаты координатами
коптер: коптера коптеры
керамик: керамику
реактивщик: главная
отвеча: подходит
огн: огня
степов: степового
год: годы
координац: координации
контракт: контракт
преподава: преподавал
квадратн: квадратных
гильз: гильз
облак: смотрите
автопилот: автопилоте
ближ: ближе
поспокойн: поспокойнее
квадрат: нужный квадратам
волк: волк
волн: волна
одн: одна одном одно
мал: мала малой
выстрел: выстрел выстреле
пушек: пушек
обращен: обращения
бумажн: бумажные
ведут: ведут
густ: непонятно
масс: массу масса
помощник: помощник
подземн: подземные
команд: уходим
насчитыва: насчитывает
экземпляр: экземпляры
апрел: апреля
прилипа: чернозем
десятк: десятках десятки десятка десятков
траектор: траекторию
психанул: психанул
горазд: гораздо
войн: войне
сентябр: сентября сентябре
март: март
войт: войти
превосходств: превосходство
проща: прощаемся
тон: тонн
казарм: казармой
глаз: глаз
сраз: сразу сразить
смартфон: смартфон
посадк: близлежащей
убийств: убийстве
забрасыва: забрасывает
украинск: украинские украинская
похож: неизвестный похожи похожих
горизонт: горизонт
ракет: ракет
железобетон: железобетонные
располага: располагают
подвоз: допустить
новост: новости
перв: первых
рлс: рлс
руин: руины
командир: командир командира
фабрик: фабрик
добр: деактивирована добра
поиск: поисков
равн: равно
авдеевск: авдеевское авдеевском
основ: основе
артист: артист артиста
настигнут: настигнуть
ушел: ушел
голов: голове
птиц: птицы птицами
топлив: топливом подвоза
грунтов: грунтовым
последова: последовало
прошл: прошлого прошлом прошлое
сражен: сражение
обход: обходится
реальн: пожаловать
тяжел: тяжелую тяжелых тяжелые ботинкам тяжелая тяжело
втор: вторых
рол: роль
точн: подсказки
высот: высоты высоте высотах
бампер: бампере
разведк: разведки разведка
способ: способен разработали
форм: форма
мер: меры
сооружен: сооружениями
бпла: бпла
обрат: точно
максимальн: максимальной максимально
найт: найти
готов: готова готовится
безотказн: пехоту
успел: успел
мобилизац: мобилизация мобилизации
конц: конце конца
дорог: дорогам
тягач: тягач
обзор: закрывают
призва: призвали
успех: успех
появ: появилось небе появились
запуска: запускает
удар: удары
пригород: пригородах
вернут: вернуться
тщательн: тщательно
б: б
бригад: бригады
утвержда: утверждает
превращ: превращены
вообщ: пристреливаются
позывн: позывной позывными позывным
единствен: единственной единственный
зарев: зарево
пита: питающая
преврат: превратили
ожида: неприметном
одиночн: вообще доносится
электромагнитн: электромагнитных
сезон: сезон
поэт: поэтому
отправ: отправились
счит: считая
опуска: донецк
мин: минными
вывест: вывести
мир: мир миру
предприят: предприятий
ответк: ответка
миф: мифу
репортаж: репортаже
безопасн: безопасное безопасность безопаснее
повезл: повезло
нажм: опечатку
боец: боец
антибпл: антибпла
красильник: красильников
сообщен: сообщений
боев: боевой боевого
получ: получил ним
разрыв: звуки
приобрел: приобрели
тактик: тактико тактика
фронт: фронта
важн: важнейшую
дистанц: дистанция
город: город города
руж: ружьями ружья
рук: рукой
час: часов
украин: украины
гранат: гранаты
метр: метров
сектор: сектор
сбрасыва: сбрасывали
надпис: надписью
сложен: сложенную
грузовик: грузовиков
площад: площадь площадью
позиц: позициям позиций позиции
сплошн: сплошную сплошной
движен: движение
подписа: подписал
близлежа: слов
специфик: специфику
больш: больших большой
китайск: китайские
мест: место месте
счет: счет
направлен: направление направлении направлениях разрывов
пристальн: пристально
попаст: попасть
сопровожда: тишину
высоток: высоток
удаленк: удаленке
конструкторск: конструкторских
видет: видеть
бесспорн: бесспорно
устанавлива: устанавливаются
бластер: бластера бластеры
редк: редких российская
хитрост: неожиданно
испытыва: внимания
град: град градом направят града граде
редакциярекламаконтактыпресс: обсудить
поднос: подносить
окружен: окружения
жизн: жизни
отработа: отработали
приоритет: приоритете
населен: населенные
актер: актером
чвк: чвк
обогаща: обогащали
мог: хитростях
сокращен: сокращенном
отсижива: отсиживаться
чернозем: чернозема
медикамент: медикаментами
сотн: сотни
вопрек: вопреки
бронирова: бронированной бронированный
марьинск: марьинском марьинское
развалин: развалинах
основн: основном основные
смест: сместилось
пополня: пополняет
проясня: обзор
скрыва: скрывает
передышк: получают
боеприпас: боеприпасы боеприпасов
артиллерист: артиллеристов артиллеристы артиллеристом
нужн: пристрелять
советск: советской
удачн: удачном
кнопок: кнопок
меня: меняли
ствольн: ствольная
застройк: застройка
беспорядк: беспорядки
непогод: редко
захарук: захарук
крошк: крошку
тасс: тасс
пониман: понимания
документ: документ
напарник: напарник
театральн: театральный
сапер: саперов
имен: имени
посторон: посторонних
войск: войска
пульт: пульта
подавля: подавляют
залета: залетают
неподалек: неподалеку
полтор: полтора полторы
дежурств: дежурства
донбасс: донбасс
лифт: лифтах
бессильн: бессильными
ком: тяжелыми
пожалова: добро
сумел: сумел
кабин: кабиной
дерев: густые деревьев
заран: успевают
звук: начинает
галер: галереи
вмест: вместе
минимум: минимум
усея: усеяны
уход: уходят срочно уходило
финансов: финансовую
наводчик: наводчик
жив: живую
понемног: облачность
талмуд: талмуды
име: имея
круглосуточн: круглосуточно
разработа: скажу
жил: жилая
саперн: саперные
вал: вала
спутник: спутниками
бюр: бюро
наступлен: наступлении наступление наступлением
добровольц: добровольцем
офицер: офицер офицерам
преимуществ: преимущество
таска: таскать
вытащ: вытащить
вегетарианств: вегетарианство
полгод: полгода
вспомина: вспоминаю
минут: минуту минуты минут
возобнов: возобновились возобновили
камаз: камаз
маневриру: маневрируя
дел: дели
вопрос: прояснять
вычисля: вычисляют
игра: играл играет
устройств: устройствами
пришел: пришел
рэб: рэб
калибр: калибр
проход: проходят
ответ: ответ ответа
диверсион: диверсионные
инд: индии
баллистическ: баллистических
несмотр: несмотря
военкомат: военкомат
творческ: творческие
собствен: собственно
замкомд: замкомдив
станц: станции станцию
миллиметров: миллиметровых
лишен: лишенная
держа: держать
контрактник: контрактником
поднима: поднимать
корректировщик: корректировщики
выезд: выезд
уничтожа: уничтожать уничтожают
снима: снимался
турц: турцию
стрельб: стрельбы
экипаж: экипаж
окраин: окраины
угол: уголь
куч: кучу
посмотрет: выезжаем
район: районе район
последн: последнее последние последний
пожела: пожелавший
месяц: месяцев
теплот: теплотой
порох: пороха
сам: самые самых
куз: кузов
жми: жми
сутк: сутки
возвраща: возвращаются
пушк: пушки пушками
расстреля: расстрелять
пристреля: заранее
разлинова: разлинованные
бм: бм
бо: боев бои приказа
называ: называют
вероятн: вероятно
точност: точности
управлен: управления
тянет: тянется
принят: принято
неожида: наносить
нашл: ооо
снайпер: снайперы
предполага: предполагает
начина: громыхать начинал
невредим: невредимыми
западн: западные
мужчин: мужчин
научн: научной
батар: батареи
уеха: уехал
прилета: прилетает
нача: началась начали началось
слаб: слабый
станов: становятся
замеча: толку
вслеп: вслепую
полигон: полигоне
оруж: оружия
атак: атак атаке
значительн: значительную
оруд: орудия орудий орудие
парн: парни
приловч: приловчился
припечатыва: припечатывает
койот: койот
парк: действии
узл: узлы узлам
груз: грузию
законч: закончился
развит: развитым
интенсивн: интенсивность
стоянк: снаряд
контрол: контроль
прерыва: прерывает
терп: терпит
трехмесячн: трехмесячный
происход: происходит
задач: задача
округ: округа
спаса: спасают
устремля: устремляется
инженерн: инженерные инженерных
окопа: окопались окопанное
выслежива: колонны
ценност: ценности
подразделен: подразделения подразделениям
пар: залп
базов: базовые
треб: требуется
обуч: обучить
ход: ход
тепл: тепло
проблематичн: проблематично
пробл: проблему
закрыва: деревья
сканир: сканируют
уйт: уйти
красногоровк: красногоровки
защит: защитой
прекраща: прекращается
ботинк: прилипать
противодрон: противодронными
нескольк: нескольких
водител: водителя водитель
наук: наука
стрем: стремятся
позволя: позволяющая способ
пережива: переживать
пво: пво
дне: дней
отзыва: отзывается
хоч: могу
скорост: скоростью скорость
дом: домой домов
способн: способны способными
дот: дотами
сторон: стороне
сид: сидишь
поддержк: поддержки
смотр: слышите
призна: признается признаются
пройдет: пройдет
тысяч: тысячи
дня: получить
доб: добиться
дивизион: дивизиона дивизионе
хорош: хорошего хорошие хорошая хорошему
колон: топлива
микроконтуз: микроконтузий
наш: нашей
оборон: обороны
днем: днем
закат: закат
зарядк: зарядка
гром: гром
большинств: большинство
сил: силу сил силами силам
сим: сим
публичн: публично
товарищ: товарищи
регулярн: регулярно
путешествова: путешествовал
тройк: тройка
плав: плавили
информац: редакциярекламаконтактыпресс
облачн: опускается
группировк: группировка
станисла: станислав
призыв: призыва
артиллерийск: артиллерийской артиллерийского артиллерийский артиллерийских артиллерийские
земл: землю земле
ключев: ключевые ключевую
радиоразведк: радиоразведка
приказ: приказ ожидает
замет: заметить заметив
удален: удаленная
противник: противника противнику противник
скрыт: скрыты скрыться
математическ: математических
погод: погода
бессрочн: бессрочным
кубанск: кубанских
кустарник: кустарника
военнослужа: военнослужащий
упа: упавшие
собра: собрались
сумасшедш: сумасшедшую
закрыт: закрытых
дожда: дождаться
идет: идет
черт: чертах
прячут: прячутся
запута: запутаться
выбива: выбиваем
контролир: контролируется
самостоятельн: самостоятельно
заряжа: заряжающий
забот: забота
сми: сми
надежн: надежны
огромн: огромный
маскировк: маскировкой маскировке
интуитивн: интуитивная
сло: слоем
городок: городок
южн: южного
перешел: перешел
местн: местные местных
сист: систему систем
артиллер: артиллерией артиллерию артиллерия артиллерии
укреплен: укрепления укреплений
неб: небо растворяется
прикрыт: прикрытием
хореограф: хореограф
сбива: сбиваем сбивает
корреспондент: корреспондента
дронобойщик: дронобойщики
наводк: наводки
выживан: выживанию
черноз: жирный
участк: участке
проблем: разбираться
поража: поражаем
намерен: намерении
ювелирн: ювелирные
заяв: заявил
автоматическ: автоматически
угроз: угрозу угрозы угрозой
растворя: дрон
лучш: лучшему
управля: управлять управляют
орган: органе
небольш: небольшой
дума: думаешь
относ: относимся
операц: операции
крайн: крайне
оо: информация
возможн: возможности
всу: всу
жирн: жирного непогоду
взмыва: взмывают
молод: молодого
огон: огонь
американск: американские
скоплен: скоплениям
открыт: открытой
буквальн: буквально
учитыв: учитывая
направ: проблемой
получас: получаса
хочет: вопрос
крупн: крупным
брон: брони
бетон: бетонные
меша: мешает
бойц: бойцов бойцы
прежд: прежде
бывш: бывший
укрыт: возвращаясь
отпуск: отпуск
выступа: выступать
уничтож: уничтожить
преимуществен: преимущественно
пада: падает
июл: июля
миллион: миллиона
наход: находятся направления находится находился
затуп: затупить
справля: справляюсь
потер: потери
каков: каковы
непонятн: стоянки
tpq: tpq
ctrl: ctrl
enter: enter
