ру: ру
влиян: влияние
студентк: студентке
стат: статьи
мобилизац: мобилизацию
обычн: обычных обычную
оказа: оказались
учет: учете
стал: стали стала стало
перееха: переехала переехавшая
квн: квн
объясн: объяснил объяснили объяснила
соглас: согласиться
ольг: ольга
появ: появится
удал: удалила удалить
случа: случалось
призва: призвали
работ: работы
доступ: доступ
вернут: вернуться
арх: архив
экономик: экономика
предел: пределы
призывник: призывников
получен: получение
конфликт: конфликта
манхэттен: манхэттене
слома: сломал
экра: экраны
спецназовц: спецназовцев
макрон: макрона
личност: личность
мотивирова: мотивировать
структур: структуры
суд: судят
готовн: готовности
дава: давай
студент: студентов
всемирн: всемирная всемирной
сообщ: сообщила
звезд: звезда звезды
денег: денег
уб: убило
собчак: собчак
звездн: звездной
мир: мир мире миру
укол: уколов
силов: силовые
секретн: секретные
запад: западу запада
миф: миф
закулис: закулисье
воинск: воинском
рса: рса
обратн: обратно
визит: визита
нараста: нарастающем
девушк: девушке девушка
нажм: нажмите
проект: проект проекта
феврал: февраля
тревожн: тревожный
сообщен: сообщения
аналог: аналог
получ: получила получили получил
проуч: проучила
модн: модный
фронт: фронте
город: городе
байд: байдена
газет: газета
реестр: реестр реестра
национальн: национальность
украин: украине украины
гранат: гранатой
прост: простым
метр: метро
раскр: раскрыл раскрыли раскрыла раскрыть
рекламир: рекламируют
заман: заманили
мстит: мстит
врем: времена
выстав: выставил
луркомор: луркоморье
двойник: двойник
лин: лина
россиянин: россиянин
рубл: рублей
обвиня: обвиняют
сосед: соседа
занима: занимались занимался
позиц: позиция
предупред: предупредила предупредил
встрет: встретила
подруг: подруги
метавселен: метавселенные
нов: новый новой новую новая новое
придума: придумали придумал
больш: большой
миллиард: миллиардов
госдум: госдуму госдуме
счет: счет
госуслуг: госуслугах госуслуги
токсичн: токсичное
порноактрис: порноактриса
мерзк: мерзкий
устро: устроил
опубликова: опубликовал
карьер: карьеры
слов: словами
фестивал: фестиваля
кана: канала
приуча: приучали
принудительн: принудительной
сдела: сделало
эффективн: эффективность
пуга: пугает
особен: особенную
видет: видеть
деактивирова: деактивирована
редакциярекламаконтактыпресс: редакциярекламаконтактыпресс
страшн: страшно страшнее
выставк: выставка
пожен: поженимся
жизн: жизни
кит: китая
распростран: распространил
эфир: эфир
кремл: кремле
журналист: журналистов журналисты журналист журналиста
пекин: пекина
сотн: сотни
американц: американцы
пошл: пошли
шелест: шелест
выз: вызов
путешеств: путешествия
вышл: вышло вышла
съемок: съемок
шо: шоу
осаг: осаго
сша: сша
лидер: лидер
машин: машин
молодеж: молодежь
групп: группы
скрыва: скрывать
эдипов: эдипова
подготов: подготовила
техник: техника
ослаблен: ослаблении
утечк: утечке утечки
европ: европы
культур: культура
противн: противно
удив: удивилась удивился
налог: налогов
создател: создателей
личн: личные
продолжа: продолжается
неопозна: неопознанным
нужн: нужны
поздн: поздно
паутин: паутины паутина
смерт: смерть
помоч: помочь
вечер: вечером
вылож: выложившего
неизвестн: неизвестном
помощ: помощью
променя: променяла
врач: врач врачи
бразил: бразилии
рунет: рунете
невыносим: невыносимой
рынок: рынок
неуважен: неуважении
опасн: опасные опасной опасности опаснее опасно
дал: дал
фанат: фанатами
жител: жители
ловушк: ловушкой ловушку
поблагодар: поблагодарил
документ: документы документов
будущ: будущем
увер: уверены
ироничн: ироничный
фан: фан
задержа: задержала
сын: сына
немецк: немецкий
загадочн: загадочный загадочное
повестк: повестку повесткам повестки
агрессивн: агрессивная
расследован: расследования
штраф: штрафах
малышев: малышева
жен: жена
дан: данные данных
фейк: фейков
контрнаступлен: контрнаступление
потребова: потребовали
подрабатыва: подрабатывал
указа: указал
спецпроект: спецпроекты
раскрыт: раскрыта раскрыты
закон: закона
росс: россии россия россию
лебед: лебедев
фбр: фбр
объяснен: объяснения
гиперзвуков: гиперзвуковой
мотор: мотор
извест: известен
ситуац: ситуацию
пожалова: пожаловать
цикл: цикла
выдвинул: выдвинули
отсутств: отсутствии отсутствие
функц: функция функцию функции
причин: причину причин
камер: камеры
очк: очков
лент: лента ленту
предлож: предложили
мирн: мирных мирный
гранатов: гранатовом
человечеств: человечество
наркотик: наркотики наркотиков
опечатк: опечатку
галер: галереи
оцен: оценили оценил
российск: российским российских российские российском российская российский
дво: двое
романтическ: романтическое
вмест: вместо
британ: британии
обознач: обозначили
полиц: полиции
искусствен: искусственный
радиофактчекинг: радиофактчекинг
военнообяза: военнообязанных
обнов: обновила
шпионаж: шпионаже
объект: объектом
перчатк: перчатки
использова: использовать
жил: жил жилья
дачн: дачных
возвращен: возвращении
худш: худшим
сталин: сталина
путин: путина путин
телевиден: телевидения
медиа: медианная
пельмен: пельменей
изнанк: изнанку
список: список
кадр: кадром
ссср: ссср
ремонт: ремонт
телешо: телешоу
таинствен: таинственным
педофил: педофилии
посл: послом
диет: диеты
дел: деле
вопрос: вопросы
рассказа: рассказали рассказала рассказал
размер: размер
самолечен: самолечения
хакер: хакеры
ответ: ответили ответить
так: такому
москв: москвы
обществ: общества
порн: порно
срок: сроки срок
мотоциклист: мотоциклистов
измен: изменит изменилась
маньяк: маньяками
красот: красоте
британск: британские
дет: детей
блогерш: блогерш блогерша блогерши
август: августа
возненавидел: возненавидела
назва: названы назван назвали назвал
материал: материалы
уведомлен: уведомление
откуд: откуда
космонавтик: космонавтики
некотор: некоторые
отношен: отношениях отношении
жесток: жестокая
кита: китаем китай китае
хитр: хитрее
добав: добавил
спорт: спорт
реалит: реалити
последн: последние
шараг: шарагу
заявлен: заявление
сам: самый самое самых самые
лерчек: лерчек
сгуб: сгубило
провоцирова: провоцировать
интеллект: интеллект
жми: жми
друг: другим
пластиков: пластиковый
молча: молчала
школ: школы школе
бо: боится
спорн: спорные
краж: кражи
называ: называют
гост: гостя
программ: программу
гонорар: гонорары
получа: получать
увлекл: увлеклись
ежедневн: ежедневной
главн: главное
неожида: неожиданного
нашл: нашли
женщин: женщина женщинам
космос: космосе
пресс: прессу
испорт: испортила
мясник: мясников
увол: уволилась
вер: верят
популярн: популярный популярного популярная популярных популярной
прогноз: прогноз
смертельн: смертельной
соцсет: соцсети
мужчин: мужчина
сунак: сунаку
одноклассник: одноклассники
созда: создали
пентагон: пентагона
предостерегл: предостерегли
мстящ: мстящих
паспорт: паспорта
сигна: сигнал
слав: славой
пород: породил
станов: становится
интернет: интернету интернет интернете
россия: россиян
необычн: необычном
ждул: ждули
шантаж: шантаж
учител: учитель
прода: продать
разозл: разозлили
пообеща: пообещал
рекорд: рекорд
вступ: вступил
появлен: появления появление
оригинальн: оригинально
препода: преподать
пришл: пришлось
развит: развития
фотограф: фотографию
мыт: мытье
сайт: сайтах
молчат: молчат
многомиллион: многомиллионные
дианов: дианова
происход: происходит
зеленск: зеленского зеленскому
невиновн: невиновных
нейросет: нейросеть
неочевидн: неочевидные
запрет: запрете
свадьб: свадьбе
ценност: ценности
аспирант: аспирантов
придурочн: придурочная
влиятельн: влиятельных
десятилет: десятилетие
высказа: высказался высказалась
даркнет: даркнета даркнете
истор: истории
гражда: граждан
гершкович: гершковича
ход: ходить
лидирова: лидировала
неуплат: неуплате
подозрева: подозреваемого
ревност: ревности
сел: сел
психолог: психологу
автор: автор
реакц: реакцию
представител: представителей
мошенник: мошенники мошенника мошенниках
сет: сети
виде: видео
объявл: объявлены
защит: защиты
пятерк: пятерки
доход: дохода
прилавк: прилавках
ищут: ищут
обжалова: обжаловать
заключен: заключенными
блогер: блогер блогеров блогером
вконтакт: вконтакте
урод: урод
подозрен: подозрению
ультиматум: ультиматум
депутат: депутаты
договор: договор
наук: наука
тип: тип
урок: урок
уточн: уточнили
реш: решили
известн: известно известная
фоб: фобии
фриланс: фрилансом
сторон: стороне стороны
прогул: прогулы
перечисл: перечислили
обитан: обитания
обстрел: обстрелах
дню: дню
включ: включил включая
евросоюз: евросоюз
подсел: подсели
хорош: хорошие
стоимост: стоимость
википед: википедии
ид: идею
звонк: звонке
сред: среда
им: имена
наш: нашей
зверск: зверское
ургант: ургант
снят: снятый снятого
похуден: похудения похудении
язык: язык языки
большинств: большинства
умн: умных
план: планов планах
коллектив: коллективе
доллар: долларов
арестова: арестовало арестованного
насчет: насчет
нат: нато
гроз: грозит
погон: погоне
информац: информацию информация
трат: тратят
скрыт: скрытом
люд: людей
россиян: россиянам россияне
спуст: спустя
сканда: скандал
интерв: интервью
неизбежн: неизбежна
фсб: фсб
ко: ко
аудитор: аудитории
хамк: хамкой
черн: черный
закрыт: закрытия
развея: развеял
торжеств: торжество
героин: героиней
перспективн: перспективные
продаж: продажу
артем: артемий
рис: рис
наркорынок: наркорынок
наблюден: наблюдения
забот: забота
запуст: запустят запустили
страх: страхи
оскорб: оскорбившим
улиц: улицах
запуск: запуска
попрос: попросили
президент: президент
роман: романах
сме: смесь
сми: сми
ведущ: ведущая
стычк: стычку
маск: маск маске
музык: музыки
апрел: апреля
доктор: доктор
тнт: тнт
участ: участия
аренд: аренды
электрон: электронным
стран: стран
пищ: пищи
десятк: десятки десятков
январ: января
дур: дуров
свет: свете
задолг: задолго
громк: громкой
войн: война
домогательств: домогательствах
март: марте марта
испытан: испытании
войт: войти
песк: песков
аккаунт: аккаунтов аккаунт
дета: детали
комплекс: комплекса
участк: участках
обвин: обвинили
онлайн: онлайн
смартфон: смартфонов
убийств: убийство
секс: секс
ужас: ужасов
откровен: откровения
заяв: заявил заявили
киев: киева
болезн: болезни
ракет: ракеты
ванг: ванги
умрут: умрут
сок: соке
вакцинац: вакцинации
гоблин: гоблин
новост: новости
корол: короля
лучш: лучшее
перв: первого первую первых
мистическ: мистическую
борот: бороться
посет: посетил
добр: добро добра
оо: ооо
возможн: возможности
политолог: политолог
всу: всу
разблокирова: разблокировать
артист: артистов
американск: американский американского
брос: бросил
разоблачен: разоблачений
разблокировк: разблокировки
участник: участники
как: каким
все: всей
круч: круче
участниц: участница участницы
герман: германии
оштрафова: оштрафовали
совок: совок
фильм: фильм фильма фильмов
переговор: переговоры
тюрьм: тюрьму
выпуск: выпуска
бывш: бывший
реальн: реальный
выпуст: выпустили
гараж: гараже
риск: риск
уничтож: уничтожить
ник: никому
артемовск: артемовск
откр: открылась
марокк: марокко
миллион: миллиона миллионы
способ: способ
электричеств: электричество
комик: комик
ри: риа
захват: захватила
илон: илоне илон
спч: спч
уральск: уральских
боксерск: боксерские
минцифр: минцифры
каков: какова
whatsapp: whatsapp
ctrl: ctrl
appl: apple
telegram: telegram
twitter: twitter
killnet: killnet
wikimedia: wikimedia
tiktok: tiktok
comedi: comedy
club: club
time: times time
enter: enter
foundat: foundation
