ру: ру
говор: станут
рф: цб
велосипед: велосипед
понима: далекие
оттуд: аэропорт
зазвон: красновид
депортац: делам
значен: несомненном
стат: статьи метку
воен: подробностями армии каждой окончании
репарац: платить
оказа: базе беглецу минут
обычн: солдаты цене
стар: начнется
са: ездить
св: написанного
служ: христианин
памятник: демонтаж
перееха: косых
святител: православный
водк: развратом
упрос: позволит
пол: пол куликовском
сто: угощение листовки
человек: рабами оценили
лет: норильска
взрыв: минуты
то: той
арм: деньги
канон: погост
суд: коммунистов здраво никто
подел: поделиться список
человеческ: отречение
котор: затеяли
шах: роберт
цивилизац: уникальной
горбачев: кричала
изго: санкциями
секретн: утечка
ум: неокрепшим
свят: мишу
прав: вконтакте
оригинал: вместо госуслуг
обратн: колесников
дурак: пьяница
шампанск: сексапильные
вовс: увидел
уч: живи
связ: церковных
ушл: отказались
начнет: молиться
оторва: побредут
едеш: страны
дела: ценою сокрушались
трояк: действие
едет: россию
верн: свидетельствует еврокомиссия
пьянзин: куприков
роберт: переживем
наберет: дурного
прост: сотни патриотизм
нно: удал
вобл: егорова
позвол: документов
рубл: тся стоило
свободн: терпении
остервенеют: одичают
справедлив: считает
православн: шестах
карточк: нашей
разумеет: оказывается
мороз: лютые
иларион: митрополит русанов
современник: спрашиваю
нов: появится ленту
теракт: сроку
убежд: глубоко
внешн: отделом
приговор: галявиева
част: несчастью
черешн: дешевая
цб: активы
алекс: подробнее
устро: подросток
осво: юдин
дугин: дарьи
нну: обнаж
дворц: зимним годы
высокоценим: различные
водозабор: новый
сдела: неприятно сделали видали
судьб: моей
преподобн: сорта
обманут: толпу
совет: другим
пут: демократическим
терпен: разумеется
денис: денис
активн: россияне
вперед: дамы
русск: черешня
равнодуш: сердце
подключа: военкоматы
тизер: хозяевам
природ: буров
выход: португалии
кремл: афгана
алексе: виктор
предател: обвинили
летн: фото дерева эконома
чихач: друг
натал: судьбы
подросток: оппозиционеров
труд: мирного
весенков: лариса
сша: иначе
метод: убежден
машин: переписать
съезд: дворце
медицин: электричества
куприк: слава
хотел: хорошего
культур: едешь уважать
купц: заводчики
актуальн: пастырю
артур: артур
уркаин: согласен
господ: праздные
букв: сети
вып: решил
нрав: рейсы
купл: медицины
еврокомисс: одноклассников
помощ: подавился работают военной
заглуш: христианское
волнова: актуально
гугл: активно
приложен: приложение приложения
ереван: взрывы
подав: момент
разработчик: бизнеса
побрякушк: высокоценимые
попытк: арестовали
проповед: власти
отчаян: душе
христианск: правильно самое
уважен: приличия
центробанк: шрек
светла: светлана
будущ: готовить
наставлен: читать
светочек: светочек
куликовск: битву
разум: достоинства
фан: анастасия
задержа: необходимую
поперхнул: розыске
ожид: припасов
вкусн: бедность
роков: закона
патриотическ: какими
коммунист: фашисткой
шиз: харченко
летел: оаэ
закон: представителей
неокрепш: специально
толп: поведут
рухнет: предположить
росс: остров удивительное ценой
жалован: двойное
регистрац: регистрация
гусениц: резиновой
гам: маяк
битв: радонежский
зябнут: ходить
девк: пустой
посыпа: зароют
счита: отечества непредсказуем
свезут: подберут
христианств: л
причин: рухнет
румянцев: татьяна
цел: корыстных
цен: адекватная вспомним дорогою самол
лент: лента ленты подпишись
мирн: оторванные
кажд: обоснованы служить
человечеств: охристианение
наркотик: карлсона
российск: турцией петербурге
энтузиаст: умам
русла: уважения
двойн: получат получающие ожидая
португал: отпуска
политическ: накопившихся
вооруж: поле
золот: оденутся
перегна: случае
отодвинет: человечества
духовн: истинно
всяк: евгению барышей
раздава: ельциным
харченк: черный
юр: удалила
мультфильм: утерянный
начнут: долговолосые
сюд: сюда
список: человека
афганистан: нужны
квитк: сергей
ссср: освободить
езд: н пасху
след: рекомендуется марта
напомн: рпц
убит: раненых
гадалк: румынии
позволительн: размышлением
вячесла: луганский
событ: уркаина главные
хнык: санкции
баз: пробили
бал: депортировали
зажжен: устал
негр: волновало
брянчанин: игнатий
уведомлен: уведомления
подбира: некому
умерл: жену
игор: интересные
удивительн: гамов
вылет: пилотом
попа: костью кучами
добав: ес
просмотр: кошкой ним просмотров
подберут: кое
специальн: навязывают
барыш: двойных
охристианен: наступившее
бедност: путина
зна: тысячами
толст: проповедуется
пивк: выпить
анатол: анатолий
филиппенк: алексей
голода: зябнуть
друг: верю брянчанинов
помеша: поехать
правильн: монахи
крас: советую
наступ: любовь
норильск: водоснабжением
народ: морозы
подчинен: рабское
рассказыва: рассказываем
воображ: братья
донецк: обстрелы
выглядел: чтение
получа: неположено начальства
голодн: поттера
главн: донецка природа
действ: военных военные любое
демонтаж: крыму
воздух: подбирать
миронов: дарья
ларис: помощи
несчаст: собственному
ныт: начали
привет: хромова
стоя: народ
новокузнецк: пивка
отдел: руководства
раб: делайтесь
голуб: передаем евросоюз
созда: энтузиаст
ран: петербурга фан
помн: бедствия делают
исход: помнить
паспорт: электронный
деревн: заброшенных
энтузиазм: каким
разрешат: россиянам
игров: миру
включен: евросоюзу
припас: поставщики
надеющ: рационы
долговолос: мешки
официальн: официальная
бортпроводниц: вниманием
разврат: песнями
шуб: приветом
бел: красно
комментар: следующие следующий
праздн: звезды
сидевш: сидевшего
проч: мир
работа: нно са
эконом: обычного
подписчик: подписчиков подписчики
уменьш: озвереют
телефон: телефон
необходим: справедливой оказали говорить
подвел: вобла
проб: скорая
правител: иное
жрит: пошли
неисчислим: приносит
поджог: важно
рецидивист: полицейским
подсчита: рубля
вниман: насладиться
зароют: попало
демократическ: суверенным
вида: зная
подава: шампанское
чита: римскому
виде: видео
остр: покинуть
пережив: хнык
оаэ: авиакомпания
расписа: подробно
оста: рискует
быстр: быстро
вконтакт: записям
подорожа: насколько
эксперт: подсчитали
надоест: водить
бизнес: правила
тип: волгин
разреш: разрешить
подоспел: помощь
угощен: эксперты
цифровизац: доиграются
реш: водозабор роковой
бил: которым
олег: олег
гарр: сериала
общ: госуслугам
окончан: чихачев
пригожин: весенкова
честн: самых
недел: главное
ненавист: патриотизма
рек: обмеления
серг: оценивших преподобный
чувств: атмосфера патриотическими потерявшая
уста: робот
люб: квитка предваряет
можеш: шах
контакт: контакты
язык: русскийукра
проплачива: интересно
останов: начальству
пилот: пообщаться
обязательн: россии
фот: откровенные
выперл: федерации
голик: видели
несомнен: ясном
рейхстаг: поджоге
люд: честных вышли
огн: священного
год: помню
приравня: хотят
лют: сентября
предъявля: разрешат
парол: пароль
квадратн: квадратными
потеря: коза
совест: разума
вывод: веке
запис: предыдущим героиня
героин: мать
одн: обходится
ман: классическая
мат: звания
самол: пассажиром
обращен: клервоский
свидетельств: ничто
масс: смотря
уголовник: киева
продаш: дашь
сообществ: сообщества
веща: ссср
россиянк: развития исакович
уникальн: учись
беглец: итоге
электрон: предъявлять ах
придут: болезней
десятк: отодвинется
раду: газетчики
потрат: норникель
войн: исход вступление побеждала мировой вторых
смотрел: смотрел
сентябр: напомню
март: христианство
песн: отчаяние
войт: войти
еха: полицейские
предваря: судил
марк: подавали
сошлют: илариона
питьев: остаться
обвин: святой
посадк: выхода
крест: побрякушки красный монахов
убийств: людям ненависти орудиями
шрек: выглядел
подпиш: карточке
татья: минуту
корыстн: властолюбивых
подробн: миллиардов подорожало подробная пентагона
григор: вячеслав
бот: филиппенков
болезн: умирать
яйц: красить
украст: возможность
вполн: гр
красновид: андрей
новост: григорьев
перв: иларион победила
достижен: орудие
пьяниц: орали
достоинств: человеческого
христианин: действий родной
добр: простых
написа: часть
поиск: записи
рабск: совести
уилкинсон: летний
отечеств: каждого
шест: смыках
обнаж: запустила
наташк: турцию
зван: возвращение
пассажир: единственным
как: войне вступала
болет: голодать
детств: поколения
зимн: коленях
голос: танке
герман: объявить
матер: жен
оденут: колокола
тся: обойд
поттер: гарри
освобод: украине попытки
медвежат: голодные
атмосфер: посещению
род: всякого
обход: приказов
втор: жизней
депортирова: россиянку
риск: город
точк: христианской вкусно
дешев: моих
клип: клипы
разведк: представители
электричеств: деревнях
маныл: игорь
чартер: летел
продукт: готовый
одежд: брендом
рны: ч
рекоменд: рекомендую канонам
обрат: позволяет
готов: массы необходима крест
вступа: энтузиазмом
информацион: понимающие
занят: яйца
обоснова: действия
хромов: света
галявиев: ильназа
дорог: куплены
соглас: шуба
случа: любом
удал: соцсетей
появ: полярным
петербург: теракте школе
рейс: такиеипустые оттуда
свал: свезут
побредут: водкой
ильназ: четверга
принос: война
заморожен: верн
разыскива: вор
александр: александр
карлсон: создателей
властолюбив: достижения
санкц: мелитополя тюрьме
вообщ: покупать
рпц: связей
единствен: оказался
четверг: события
л: толстой
н: создал
неприятн: мясом
поезд: нужды
училищ: военного
дава: первых
тюльник: культура
ч: добавил
утеря: просмотр
показа: показать
звезд: галуны
ничт: ибо
квартир: машину
митропол: сошлют
мин: мини
вариант: продашь
пасхальн: ситов
мир: уменьшится точка геймерские
доигра: общей
миш: трогайте
идеальн: послушай
бур: находиться
затея: надоест
повезл: бортпроводниц
вагнер: чвк
христиан: верующие
гниющ: заразится
скор: ехала
егоров: наталья
классическ: шиза
патриотизм: видом развращая
ранен: больных
сообщен: сообщения сообщение
прилич: чувство
оправда: суд
получ: убивать училища ответа надеющиеся
власт: подчинение
крича: женщина
клервоск: бернард бернардом
важн: событие
город: лето
владисла: владислав
рук: брать убийства
час: комментарии игнатов
украин: операции
актив: замороженные
метк: голубую
детск: наркотики
погост: ездит
покинут: обязалипоказать
больн: столько
пушечн: гниющим
фотосесс: нную
дешевл: рублей
такиеипуст: проплачивает
сдал: прикуску
анастас: скулить
продуктов: белой
кстат: президент
миллиард: потратит
мест: священном придут выбрать
пожизнен: приговорили
андр: зрения
госуслуг: данные подключать
мелитопол: русского
предполож: войну
спрашива: полезно
офис: офис
игр: игры
геннад: прочее
полезн: подобающе
сопровожда: чувствами
накоп: решения
ясн: простом
ора: голос
вспомн: давайте
видел: букву гусеницы
исправ: реки
жизн: миллионы
суверен: цивилизации
сексапильн: девки
солдат: получается
филиновск: геннадий
чвк: рный
пыта: игровые
сотн: детей
отм: поиск
листовк: раздавал
мол: начнут
момент: сдала
пошл: куличи
апостол: человеков
пообща: удалось
бренд: работала
преступн: приказы выполнять
вышл: медвежата
скрыва: умело хотел
колесник: марк
почт: почта мфц
утечк: произошла
решен: метод
создател: мультфильм
нужн: войска
ужасн: известное
чиновник: рода
далек: дикие
нужд: бытовые
выбира: изгоем
верховн: наставления
сорт: третьего
послуша: ботов
выполня: необходимо
умира: болеть
восторга: предателя
даб: вещах
павел: апостол
ваканс: разработчикам
кулич: видел пасхальный
юдин: владимир
водоснабжен: проблемы
документ: электронные оригиналам
хозяев: спать
жен: квартиру труда
розыск: преступник
дам: господа
дан: приравнять
дар: убийство вагнер
отмоют: освоят
отречен: управляемых
войск: вещали
даш: пу
коз: тюльников
кол: кол
кос: луиза
пожалова: пожаловаться отмоют
кот: огня
деньг: получая
отказа: российской
брат: оружие мужья
прикуск: рыбой
дерев: снимки летнего
оцен: повезло нравится
колокол: зазвонят
зараз: воздух
рыб: новокузнецкой задержан
вмест: документы
заводчик: радостно
обыкновен: крадут
луиз: летняя
покупа: занятие
крадут: украсть
муж: перевязывать
увидел: никого
жив: век
мурашек: чувствуется
оппозиционер: российских
радонежск: сергий
уверен: выгодно
стара: духовный
начал: офицеров
начальств: обыкновенно сделается
мфц: посещение
многочислен: живут
возвращен: эстонии
поколен: будущие
руководств: освободили
танк: стоя
заброшен: многочисленных
путин: пригожин ныть
навязыва: преследования
офицер: погоны
маяк: час
произошл: кстати
итог: разыскиваемый
загадк: типа
минут: гадалка авг россиянка отмена
стольк: наберется
наслад: место
дел: ужасное едет подвела
вопрос: вопросы
внедря: пожаловались
ответ: жрите ответил варианте
никт: дабы
норникел: исправить
преступник: мослента
полност: мурашек
военкомат: пьянзин
срок: пожизненному
собствен: равнодушие
переписа: гуглят
подобающ: позволительно
изобретательниц: умерла
преследован: мания
избра: избранное
уда: переехала пустом
дет: матерей
фашистк: рейхстага
непредсказу: войны
снимк: никакой
монах: вооружил священникам ушли
арест: дугиной
трижд: оказалось
турц: начале можешь
стрельб: устроил
аэропорт: перегнать
куч: свалят
обязалипоказа: месте
церковн: внешний
ах: почты
записыв: вперед
месяц: проблем
сам: миронова воображая
возвраща: уилкинсон
дик: кидать
инач: афганистане
поведут: известкой
переда: голубой
школ: стрельбу
оказыва: идеально
уважа: румянцева
женщин: съездов
разжига: засуетятся
век: сша оправдал
никол: умоляя
одича: било
пасх: вообще
вступлен: сопровождалось
ройзма: евгения
вер: обычные ответов
вс: вс
румын: центробанку
неинтересн: переживали
мужчин: мужчина
соцсет: деревом
одноклассник: ранил
пентагон: секретных
сво: значении
авг: неделю
нача: алексеев
слав: затерялся
го: николая
оруж: монахам
истин: всякий
гр: продукт
оруд: правителей добрых
развра: детства
виктор: новые
вещ: судить
полярн: технологиях
рацион: жалованье
развит: путем
русскийукр: вакансии
афга: выводили
станут: уверенностью
комбинезон: детском
горбушк: цифровизацией
технолог: информационных
происход: происходит
проникнут: пытаются
различн: получить
поеха: наташкой
трет: христиане
засует: дело
ценност: культуру
пап: обращения
перевязыва: готовясь
зрен: точки
ход: погонят
ес: юбки
пробл: политических
ещ: ещ
сет: продуктовой
представител: скрывался проникнуть
вид: разжигающие
умел: рецидивист
чтен: минута
красн: записываясь цена
доход: двойной
кошк: комбинезоне
русан: полностью
ельцин: восторгались
волгин: выбирайте
хот: минцифры
позволя: свободного
пережива: януковича
священ: зажжение фотосессию
дом: возвращался
известн: старое
юбк: изобретательница
известк: посыпав
крым: ереване
смотр: филиновский
любов: мире
обстрел: ройзмана
тысяч: месту
резинов: помощью
глубок: причинам
сажа: людей
евросоюз: включает статье
родн: современников
обойд: кулич
хорош: рабство
иб: порабощает
пуст: чартером вовсе
ид: горбушке
предыдущ: новостей
наш: расписали
ин: своем
плат: получишь
робот: просмотра
арестова: германии
сит: дмитрий
здрав: старающейся
предвид: чиновники
мяс: пушечным
евген: папе арест
информац: информация
погон: получили руках
выгодн: десятки
судим: трижды
приказ: преступные преступных
замеч: скрывали
замет: заметил
неполож: руки
посещен: поезд обязательное
россиян: рф комментарий
дурн: сделать
исакович: юрий
объяв: го
км: голиков
ко: остановятся
сериа: тизер
черн: включение
спат: кот
смык: крестами
игнат: руслан святитель
живут: неинтересно
миров: первой
запуст: одежды
пастыр: верховному
обмелен: воды
вор: судимый
понятн: понятно
акт: акт
президент: заявил
убива: христианина
священник: одна
музык: музыка
сокруша: кремле
вод: обманутых питьевой
федерац: негры
галун: кресты
обветша: вернее
стран: ценности
радостн: доход
свет: тюрьмы
побед: считать
мо: рыба репараций
римск: клервоским
скурихин: дурак
включа: ранее
душ: заглушая
наскольк: дешевле
кост: поперхнулся
размышлен: трояким
проблем: решит
откровен: бали
поставщик: купцы
заяв: разведки
киев: выперли
газетчик: убийству
нек: убитых
об: обо
владимир: павел
управля: целей
озвереют: остервенеют
операц: месяц
интересн: манылов поделившихся
юрьич: рейс
побежда: россия
возможн: предвидя
рабств: обратить
кида: идеи
выбра: вылетом
скул: помешают
бернард: св дела
получат: радуясь
колен: стоял
сердц: обветшавшем
янукович: уголовника
умол: дворцом
мешк: золотые
дмитр: обратный
страниц: страница
адекватн: вполне
авиакомпан: юрьич
тюрьм: путин сажают
трога: горбачева
бедств: неисчислимые
порабоща: замечая
затеря: паспорт
пу: загадки
бытов: упросить
луганск: км
отпуск: домой
ник: посадку
ра: ра
миллион: войнах
эстон: памятника
полицейск: попался подоспели
наход: скурихина
геймерск: внедряются
никак: депортации
мослент: часа
пожелан: пожелания
минцифр: оригиналов
lenta: lenta
ru: ru
iii: iii
dolf: dolf
microsoft: microsoft
switch: switch
smm: smm
avak: avak
discord: discord
riafan: riafan
english: english
http: https
nash: nash
