ру: ру
оценк: оценки
говор: говорите говорят говоря говорится
рф: рф
понима: понимает понимают
фактическ: фактически
ущипнет: ущипнет
стат: статьи
воен: военные военно
обычн: обычную
оказа: оказать
европейск: европейского
стар: старом
стал: стала стали стало
си: си
объясн: объяснили
правот: правоту правоты
реализова: реализовать
гуля: гуляют
центр: центра центр
реагирова: реагировать
деска: дескать
сценар: сценарии
арх: архив
экономик: экономике экономика
впечатлен: впечатления
пол: полях поле
торговл: торговлю торговли
инфраструктур: инфраструктуру
сто: стоит
манхэттен: манхэттене
человек: человеком
вооружен: вооружений вооруженному вооруженным
торгова: торговать
макияж: макияжа
разговор: разговоры разговору разговор
морск: морских
структур: структуры
суд: суда судить
публикац: публикации публикациях
карт: карта
всемирн: всемирную
перспект: перспектив
сверхъестествен: сверхъестественного
благодар: благодаря
котор: которую котором
осозна: осознать
саммит: саммита
силов: силовые силового
осен: осенью
секретн: секретные
запад: западом западу запад
шаг: шаг шаги
прав: правом
угас: угас
визит: визитом визита
вовс: вовсе
связ: связей связи
вперв: впервые
весн: весной
отмен: отменил
обозрим: обозримом
дела: делать
очернен: очернению
сдерживан: сдерживания
едет: едет
дискусс: дискуссий
застря: застрял
рват: рвать
обеспоко: обеспокоены
позитивн: позитивное позитивной
подводн: подводные
тибетск: тибетский
союзник: союзников
лин: линии
россиянин: россиянин
взвешен: взвешенные
рубл: рублях
сосед: соседа
демонизац: демонизации
постро: построить
пересмотрел: пересмотрел
встреч: встрече
лиц: лица
ломан: ломанов
весен: весенняя
украинц: украинца
очевидн: очевидно
нов: новом нового новую новой новых
внешн: внешней внешняя внешних
выпад: выпадам
част: часть
партнерств: партнерства партнерств
должностн: должностные
слов: слова
недвижим: недвижимость
пятилетн: пятилетний
цк: цк
подгада: подгаданное
отказ: отказу
разительн: разительным
якоб: якобы
сдела: сделать
идеолог: идеологии
деактивирова: деактивирована
сложн: сложном сложно
цар: царила
зажиточн: зажиточной
камн: камней
пут: путь путем
пример: примером
лодк: лодки
терпет: терпеть
подверж: подвержены
кремл: кремле
должност: должность
пекин: пекин
прида: придает
летн: летней
пересматрива: пересматривать
торгов: торговую
трудн: трудно
путешеств: путешествия
облада: обладает
сша: сша
ресурс: ресурсы
миха: михаил
лидер: лидер
групп: группу
техник: техника
надолг: надолго
европ: европе
дальнобойн: дальнобойные
хотел: хотела хотел
размест: разместить
культур: культура
запугиван: запугивания
лнр: лнр
продолжа: продолжающегося
случайн: случайность
помога: помогал
рынк: рынках
помощ: помощь помощью помощи
современ: современных
врач: врач
вольфганг: вольфганга
заграничн: заграничной
выступ: выступить
попытк: попытку попытки
клинтон: клинтоне
уважен: уважении
жител: жители
оговорк: оговоркой
будущ: будущее будущем
желан: желания
узбекистан: узбекистане
серверн: серверный
заманчив: заманчивого
подвинут: подвинуть
нул: нулю
подчеркива: подчеркивает
интерес: интересов интерес
евр: евро
отключ: отключены
спецпроект: спецпроекты
плох: плохого
взаимн: взаимном
рост: ростом
росс: россии россия россией россию
найдет: найдет
фбр: фбр
мотор: мотор
убед: убедить
ситуац: ситуации ситуацию
имеет: имеете имеет
фирм: фирму
вовлеч: вовлечены
счита: считает считают
отсутств: отсутствии
тихоокеанск: тихоокеанском тихоокеанских
цел: целом
нейтралитет: нейтралитет
отлича: отличается
лент: ленте лента ленту
мирн: мирный мирному
руководител: руководитель руководителей
опечатк: опечатку
российск: российским российские российское российско
канал: каналы
всеполитикаобществопроисшествияконфликтыпреступн: всеполитикаобществопроисшествияконфликтыпреступность
внешнеполитическ: внешнеполитической
взаимодейств: взаимодействие
политическ: политическом политического политических политической политический политическое
создава: создавать
поездк: поездкой поездки
всяк: всяких
юг: юге
налич: наличие
использова: использовать
стратег: стратегии
достаточн: достаточно
ссср: ссср
прошедш: прошедших
след: следует
организац: организацию организации
концепц: концепцию концепций
так: такого таких таким
общен: общения
нормальн: нормально
недавн: недавнего недавнее
консолидирова: консолидирован
техническ: технический
условн: условно
мощн: мощные
досудебн: досудебная
атомн: атомные
транспортировк: транспортировки
блогерш: блогерши
назва: назвал назвала
товар: товаров
выходя: выходящие
провозглашен: провозглашенного
некотор: некоторое некоторых
противостоян: противостоянии противостояния
застав: заставить
потенциальн: потенциальном
антикитайск: антикитайской
болезнен: болезненным
церемон: церемония
служб: служба
диалог: диалогу диалога
оформлен: оформление
поним: понимая
спорт: спорт
содержат: содержатся
специальн: специально
содержан: содержанию
шос: шос
тво: твои
стро: строить
представля: представляется представляются
друг: друг другу
друж: дружить
автомобильн: автомобильным
ошибочн: ошибочные
поня: понять поняли
гуанчжо: гуанчжоу
железн: железным
проснет: проснется
ограничен: ограничениях ограниченными ограничений
джордж: джордже
программ: программе
главн: главное
действ: действия действий
внешнеэкономическ: внешнеэкономических
октябр: октября
вовлечен: вовлеченности
приезжа: приезжал
поможет: поможет
зарубежн: зарубежной
интерактивн: интерактивность
игрок: игроками
энергичн: энергично
поворот: поворот
созда: создает создать
байден: байдену
имеющ: имеющегося имеющиеся
ран: ран
исход: исходить
доброжелательн: доброжелательного
ограничител: ограничители
интернет: интернет
краеугольн: краеугольный краеугольных
вступ: вступит
тем: тему теме
официальн: официально официального
великобритан: великобритании
пришл: пришлось
полн: полной полный
столет: столетия
посредник: посреднике посредника
поставк: поставке
штат: штаты
комментар: комментарии
рамк: рамках
сотрудник: сотрудник
солидаризирова: солидаризировался
сильн: сильно
нанесен: нанесения
долж: должен
блок: блоков блока
десятилет: десятилетие
заинтересова: заинтересовались заинтересован заинтересованных заинтересованы
заслужива: заслуживают
необходим: необходимо необходимости
числ: число
бессмыслен: бессмысленно
произвел: произвела
постулат: постулату
нейтральн: нейтрального нейтральными
подозрева: подозреваемого
кризис: кризису кризисе кризиса
раскритикова: раскритиковали
сложност: сложностей
вниман: внимание
сотруднича: сотрудничают сотрудничать
автор: авторы
очеред: очередь
глобализац: глобализация
виде: видео
нигд: нигде
подход: подхода
нынешн: нынешнем
минувш: минувшее
расписа: расписался
быстр: быстро
понятийн: понятийный
принима: принимали
тип: типа
воспринима: воспринимал
несоздан: несоздания
реш: решится
генеральн: генеральный
международн: международный международного
общ: общего общие
пригожин: пригожин
обитан: обитания
состо: состоит
недел: недели
обе: обеих обеими
воздержива: воздерживалась
контактн: контактную
включ: включился
обм: обмен
культурн: культурных культурной
азиатск: азиатско
сред: среда
лхас: лхасе
устойчив: устойчивыми
урегулирован: урегулированию урегулирование
чувств: чувствует чувствуют
мног: многих многие
люб: любые
похуден: похудения
потреб: потребует
язык: язык
фон: фоне
фот: фото
ордер: ордер ордером
происходя: происходящее
фактор: факторов
соверш: совершить
инициативн: инициативного
гот: готов
образц: образца
соблазн: соблазн
тормоз: тормозиться
год: годами годы
сдержива: сдерживают
конкретн: конкретный конкретные конкретное
создан: создания
примаков: примакова
тибет: тибета
перспективн: перспективными
модернизиру: модернизируемся
продаж: продажу
широк: широких широко
неприемлем: неприемлемости
приб: прибыл
гаван: гавани
потребн: потребность
действова: действовать
расширя: расширять
инструмент: инструментов
выда: выдан выдала
кошмар: кошмар
нежел: нежели
врод: вроде
корабл: корабли
участ: участием
распростерт: распростертыми
голосован: голосования
регион: регионов регионе
поскольк: поскольку
войн: войны
сентябр: сентября
март: марта
испытан: испытании
нереалистичн: нереалистичным
необратим: необратима
войт: войти
глав: главы
динамик: динамику
глаз: глазами глазах
валентин: валентина
холодн: холодной
переизбран: переизбрания
зависет: зависеть
болезн: болезни
украинск: украинском украинскому украинский украинского
транслир: транслируются
ракет: ракеты
университет: университетов
новост: новости
перв: первой первую
чувствительн: чувствительны
непрост: непросто
создаст: создаст
посет: посетил
проведен: проведению
приня: принять
добр: добро добра
преодолет: преодолеть
равн: равна равны
франц: франции
прочн: прочными
параллел: параллель
как: какую каких какие какого каким
участник: участники
препятств: препятствует препятствия
герман: германии
напомина: напоминает
повлия: повлиять
рассматрива: рассматривать
каф: кафе
площадк: площадку
переговор: переговорах
встреча: встречается
прибега: прибегать
прошл: прошлого
род: рода
высок: высоким
реальн: реальных реальный
крылат: крылатые
точн: точно
рол: роль
риск: риск
сфер: сферах сфера сфере сферы
партнер: партнера
мер: мере мер
продукц: продукция
конференц: конференции
готов: готовиться готовы готового
найт: найти
антироссийск: антироссийским
движ: движемся
влиян: влияния влиянием влиянию влияние
студентк: студентке
образ: образом
независим: независимой
обоснова: обоснованному
ввод: вводятся
ремейк: ремейк
учет: учете учетом
конц: конце
дорог: дорогам
предлага: предлагать
успех: успех
случа: случае
удал: удалить
практическ: практические практически
вернут: вернуться
трехдневн: трехдневным
мид: мид
конфликт: конфликту конфликт конфликта
александр: александр
санкц: санкции
инвестирова: инвестировали
вектор: вектор
стремлен: стремление
преврат: превратилась
концептуальн: концептуальные
личност: личность
буш: буше
отправ: отправился
поэт: поэтому
ощущен: ощущение
мюнхенск: мюнхенской
мир: мир мире миру
укол: уколов
исследован: исследований
совершен: совершенно совершенного
обсужда: обсуждают
килун: килун
внешност: внешности
безопасн: безопасности
категоричн: категоричных
вагнер: вагнер
скор: скорее
нажм: нажмите
коллективн: коллективный
резк: резким
оон: оон
обед: обеда
гуандун: гуандун гуандуна
боев: боевых
получ: получит
ухудш: ухудшились
фронт: фронте
важн: важна важной
озвуч: озвучил
обыгрыва: обыгрывается
экономическ: экономической экономического экономическим
благожелательн: благожелательный
рук: руку
украин: украине украиной
гранат: гранатой
внутр: внутри
раскр: раскрыли
шанс: шансы
выстав: выставил
позиц: позиция позицию позиции
могл: могло
нарушен: нарушение
больш: большие большей большой большое большими
ответн: ответный ответных
китайск: китайский китайская китайскому китайские китайских китайской китайского китайско
инерц: инерцию инерция инерции
потенциа: потенциал
мест: место места
иде: идеей
счет: счет
вход: входим входа
направлен: направлении
удел: уделил
эффективн: эффективность эффективно
видет: видеть
быркин: быркин
расшир: расширена
подорва: подорвать
редакциярекламаконтактыпресс: редакциярекламаконтактыпресс
вспомн: вспомнить
экспортн: экспортный
жизн: жизни
суверен: суверенной
кит: китая
зашедш: зашедшей
чвк: чвк
тайваньск: тайваньскому
пыта: пытаться пытается
полноцен: полноценное
шварцма: шварцман
момент: момента
американц: американцами американцы американцам американцев
обсужден: обсуждения
отклик: откликах отклик
мор: морю
развива: развивать
принципиальн: принципиальная принципиально принципиальному
основн: основной
идейн: идейно
охарактеризова: охарактеризовать
блоков: блоковой блокового
привест: привести
потороп: поторопиться
утечк: утечке утечки
решен: решению решение решении решения решением
удив: удивились
всерьез: всерьез
средн: средней
живет: живет
личн: личные
нужн: нужна нужны
ишингер: ишингера
чиновник: чиновников чиновники
тайван: тайванем тайвань тайваня
вылож: выложившего
ущемлен: ущемления
востребова: востребована
рынок: рынок
павел: павел
сближен: сближение
дал: дали
хурэлсух: хурэлсуха
тасс: тасс
контекст: контексте
документ: документы документа документов документ
предложен: предложенных предложение
увер: уверен
реал: реалиях
кнр: кнр
имел: имела
дан: данных данные
весьм: весьма
имен: имени
состоя: состоявшийся
раскрыт: раскрыты
суров: сурового
народн: народной
гиперзвуков: гиперзвуковой
камен: камень
технологическ: технологические
пожалова: пожаловать
соединен: соединенные
надав: надавить
ухна: ухнаа
деньг: деньги
отказа: отказаться
брат: брат
поуч: поучиться
очк: очков
провинц: провинция провинции
предлож: предложил предложить
заран: заранее
дипломат: дипломаты дипломатия
мус: мус
галер: галереи
границ: границу
оцен: оценили оценил
дво: двое
политик: политика политики политикой политике
восток: восток
рассчита: рассчитанное
вмест: вместе
финансов: финансового
решат: решатся
интеллектуальн: интеллектуальным
смир: смириться
принужден: принуждению
тупик: тупик
обнов: обновила
резолюц: резолюциям
жил: жилья
уверен: уверенность
направл: направлено
руководств: руководство
маловероятн: маловероятным
наступлен: наступлении
путин: путина путин
медиа: медианная
танг: танго
сближа: сближаться
важност: важностью
дел: делились
ближайш: ближайшие
рассказа: рассказал
сохраня: сохраняются
переход: переход
ответ: ответ ответит
москв: москву москвой москва
полност: полностью
усил: усилия
пространств: пространство
срок: срок сроки
сталкива: сталкивается
собствен: собственной
синьцзя: синьцзяна
измен: изменит
джо: джо
держа: держав
избра: избран
уда: удалась удалось
август: августа
этническ: этнических
расширен: расширения расширению
грановит: грановитой
материал: материалы
отношен: отношений отношения отношении отношению
восточн: восточную
пахотн: пахотная
куп: купить
угод: угоду
обща: общаться
арест: арест
аз: азии
окраин: окраинных
кита: китаю китае китаем китай
посмотрет: посмотреть
район: район
ряд: ряда
последн: последнего последние
заявлен: заявление
месяц: месяцы
сам: самое самые
альянс: альянсов
захотел: захотел
жми: жми
бо: боя
подобн: подобный подобном подобные
абсолютн: абсолютно
называ: называется
вероятн: вероятности
давлен: давления
предприня: предприняла предпринять
ира: иран
присказк: присказка
нашл: нашли
допуска: допускаю
билл: билле
пресс: пресс
век: века веке
западн: западных западными западные западного
вес: веса
вет: вето
популярн: популярных популярные
заведом: заведомо
сотрудничеств: сотрудничества
приоритетн: приоритетного
смертельн: смертельной
пентагон: пентагона
предшествова: предшествовал
кампан: кампании
сво: своему
взаимодействова: взаимодействовать
нача: начался начали
профессор: профессор
станов: становится
перспектив: перспективы
имэм: имэмо
значительн: значительной значительную
сформир: сформируется
шантаж: шантажа
парт: партии
тесн: теснее
рекорд: рекорд
явля: являются
вслед: вслед
вещ: вещи
груз: грузов
развит: развития развитию
уголовн: уголовного
настаива: настаивают
представ: представить
воплощ: воплощено
уничтожен: уничтоженных
предсто: предстоит
технолог: технологий технологиями
происход: происходит
зеленск: зеленского
общеевропейск: общеевропейского
конструктивн: конструктивный
щедр: щедро
ценност: ценности
перейт: перейти
виз: визит
треб: требуют
исток: истоки
истор: история
союзничеств: союзничество
двум: двумя
факт: факт
призыва: призывают
вид: видим видите видом виду
представител: представителей
сет: сети
односторон: односторонних
внов: вновь
красн: красные красную
объят: объятиями
юан: юанях
реальност: реальность
обеща: обещать
упадк: упадка
наук: наука
хот: хотите
дол: долей
дом: дома
известн: известно
сторон: стороне сторонами сторон стороны сторона сторонам
поток: потоки
поддержк: поддержку
предостав: предоставит
остальн: остальных
угодн: угодно
дня: дня
хорош: хорошего хорошие
стоимост: стоимость
ид: идеи идее
поддержив: поддерживая
ин: иного
шантажирова: шантажировать
республик: республики
сыгра: сыграть
выгод: выгод
сил: сил
умн: умные умных
план: плану планы планов план
доллар: доллара
арестова: арестовало
элит: элитам
держав: державами
нат: нато
информац: информация
основыва: основывались
поставля: поставлять
отлож: отложил
ровн: ровно
спуст: спустя
замен: заменит
автономн: автономный
нарушат: нарушат
отвергнут: отвергнуты
соперник: соперника
младш: младшем
черт: черту
прячут: прячутся
моральн: моральным моральную моральной
миров: мировых
забот: забота
издержек: издержек
понятн: понятно
забор: забором
секретар: секретарь
президент: президент президента президенту
председател: председателем председатель председателя
приеха: приехал
акц: акции
сми: сми
надеет: надеется
музык: музыки
ответствен: ответственности
австрал: австралии
цзиньпин: цзиньпина цзиньпин
союз: союзов союз союза союзы
развалива: разваливаться
стран: странами странам страны стран страной
аренд: аренды
январ: января
отлич: отличие
уровн: уровне
четк: четко
громк: громкой
местн: местные
дух: духе
япон: японии
ухудшен: ухудшением
отобра: отобрать
продиктова: продиктовано
качеств: качества качестве
наскольк: насколько
откровен: откровением
заяв: заявить заявили
коммунистическ: коммунистической
выражен: выражениях
угроз: угрозы
цивилизацион: цивилизационно
нек: некую
владимир: владимир владимира
переизбра: переизбран
дума: думаю
разворачива: разворачивается
оо: ооо
возможн: возможности возможное возможным возможно
всу: всу
американск: американские американских американскому
выбра: выбрал
открыт: открытых
высокотехнологичн: высокотехнологичная
брос: бросил
буквальн: буквально
шанхайск: шанхайской
дает: дается
палат: палата палате
хочет: хочет
крупн: крупными
меша: мешает
монгол: монголии
взгляд: взгляд
сюжет: сюжету
рассужден: рассуждения
бойц: бойцов
выпуск: выпуска
прежд: прежде
бывш: бывшего бывший
адресова: адресована
метцел: метцель
выступа: выступает
пекинск: пекинском
откр: открыть
никак: никакие никаких
вто: вто
непонятн: непонятного
new: news
annabel: annabelle
ctrl: ctrl
appl: apple
xxi: xxi
gongga: gongga
chih: chih
guan: guan
tingshu: tingshu
laisong: laisong
ap: ap
getti: getty
reuter: reuters
huawei: huawei
servic: service
killnet: killnet
wang: wang
han: han
china: china
ng: ng
imag: images
vcg: vcg
enter: enter
