париж: париже
ру: ру
говор: говорится говорить
рф: рф
компромисс: компромиссом
энергетическ: энергетический
влиян: влияние
студентк: студентке
парламент: парламент парламента парламенте
коронавирус: коронавируса
лев: левые
стат: статье статьи
обычн: обычную
оказа: оказался
рискова: рисковать
конц: конца
стал: стали стало
мнен: мнение
правоохранител: правоохранителей
гарант: гарантиям
призва: призвали призвала
случа: случае
раскол: раскол
удал: удалить
удар: ударила
вернут: вернуться
арх: архив
экономик: экономику экономике экономика
подчеркнул: подчеркнул подчеркнула
пандем: пандемия
недовер: недоверия
манхэттен: манхэттене
послед: последуют
схем: схему
разговор: разговоре
макрон: макрон макрона
личност: личность
присутств: присутствующих
должн: должны должна
структур: структуры
высказыван: высказывания
дижон: дижоне
сообщ: сообщил
показа: показало показали
поэт: поэтому
благодар: благодаря
слезоточив: слезоточивый
денег: денег
провест: провести
мир: мир
укол: уколов
силов: силовые
секретн: секретные секретных
прав: правой
безопасн: безопасность
спецслужб: спецслужбы
отмет: отметил
нажм: нажмите
ушл: ушла
феврал: февраля
власт: власти
спбгу: спбгу
французск: французской французские французских французский французского
фронт: фронте
позитивн: позитивное
провел: провел
город: городах
национальн: национальное
экономическ: экономическую
неопределен: неопределенные
час: часов
профсоюз: профсоюзов
украин: украине
внутр: внутри
раскр: раскрыли
млн: млн
выстав: выставил
позвол: позволит
грузовик: грузовике
площад: площади
свободн: свободно
позиц: позиций
встреч: встречу
пенсион: пенсионной пенсионную пенсионный пенсионная
республиканц: республиканцы
нов: новых новой
парламентар: парламентарии
выделя: выделяется
больш: большой
част: часть
пожил: пожилых
слов: слова слово
направлен: направлении
жеральд: жеральда
эффективн: эффективность
видет: видеть
деактивирова: деактивирована
редакциярекламаконтактыпресс: редакциярекламаконтактыпресс
сюжетпенсион: сюжетпенсионная
жизн: жизни
ноч: ночь
систем: системы системе
процедур: процедуры
выход: выходили
индивидуальн: индивидуального
берж: берже
мож: можем
момент: момент
заседан: заседании
исполня: исполняли
имитиру: имитируя
митинг: митинге
путешеств: путешествия
марсельез: марсельезу
вышл: вышли
сторонник: сторонников
сша: сша
лидер: лидер лидера
машин: машины
процесс: процесс
групп: группы
техник: техника
повыш: повышен
ослаблен: ослаблении
неудач: неудача
утечк: утечке утечки
решен: решение
культур: культура
личн: личные личную
продолжа: продолжаются
нужн: нужном
удачн: удачных
вылож: выложившего
марсел: марселе
врач: врач
вызыва: вызывают
дав: давая
введ: введен
попытк: попытки
агресс: агрессии
витрин: витрины
промышлен: промышленности
крик: крики
документ: документы документов
будущ: будущем
самовыражен: самовыражения
задержа: задержаны
агрессивн: агрессивных агрессивно
дан: данный данные
потребова: потребовали
фаб: фабьен
отключ: отключены
дат: дать
спецпроект: спецпроекты
протяжен: протяжении
состоя: состояться
раскрыт: раскрыты
француз: французы
закон: закон закону закона
негодован: негодования
гимн: гимн
толп: толпы
росс: россия
фбр: фбр
сократ: сократить
опрос: опроса
процент: процента процент
гиперзвуков: гиперзвуковой
медицинск: медицинские
газ: газ
мотор: мотор
ситуац: ситуацию ситуация
пожалова: пожаловать
счита: считают
привяза: привязаны
очк: очков
лент: ленту ленты лентой лента
руководител: руководитель
возраст: возраст
опечатк: опечатку
галер: галереи
оцен: оценили оценил
сохран: сохранит
политик: политики политик политиков
всеполитикаобществопроисшествияконфликтыпреступн: всеполитикаобществопроисшествияконфликтыпреступность
полиц: полицией полицию
пощечин: пощечиной
обнов: обновила
правительств: правительство правительству правительства
жил: жилья
поджига: поджигают
кафедр: кафедры
уверен: уверенностью
контейнер: контейнеры
стимул: стимул
кукл: куклы куклу
медиа: медианная
уличн: уличные
пост: посту пост
ссср: ссср
ориентирова: ориентированной ориентированным
работник: работники
итог: итогам
масштабн: масштабные
вопрос: вопросу
ближайш: ближайшие
конституц: конституции
рассказа: рассказал
регламентир: регламентирует
активист: активисты
проход: проходит
так: таким
обществ: общество
срок: сроки
измен: измениться изменить
кабмин: кабмина кабмину
отказыва: отказываюсь
назва: назвала
смес: смесями
некотор: некоторые
отношен: отношении отношений
болезнен: болезненно
игор: игорь
изобража: изображающие изображающую
протестн: протестные
сожгл: сожгли
остава: оставаться
кита: китаем
спорт: спорт
ряд: ряд
транспорт: транспорта
последн: последние
поддержат: поддержат
разгон: разгона
водомет: водометы
представля: представляю
жми: жми
переда: передает
бо: боятся
спорн: спорный
останет: останется
постигнет: постигнет
подобн: подобную
вероятн: вероятностью
программ: программы
главн: главное
принят: принятие принятия принятии
действ: действия действующего действиями
аврор: аврора
нашл: нашли
демонтаж: демонтажа
голосова: голосовать
привел: привело
низк: низком
достигл: достигло
заключа: заключать
зажигательн: зажигательными
вел: вели
популярн: популярных
соцсет: соцсетях соцсеть
смертельн: смертельной
магазин: магазинов
пентагон: пентагона пентагон
сво: своим свой
нижн: нижней
эммануэл: эммануэль эммануэля
протест: протесты протестов протестует протестующих протестующие
станов: становится
перспектив: перспективы
интернет: интернет
парт: партии
учител: учителя
рекорд: рекорд
мобилизова: мобилизовать
выступлен: выступления
официальн: официально
применя: применяются
госдолг: госдолг
пришл: пришлось
реформ: реформы реформу реформ реформе реформа
демократ: демократии
прерыва: прерывали
факультет: факультета
происход: происходят
комментар: комментарии
запрещ: запрещена
трех: трех
сильн: сильно сильный
достигнут: достигнутым
преднамерен: преднамеренной
дарман: дарманена
ценност: ценности
репресс: репрессий
долж: должен
пар: пари
десятилет: десятилетий
заинтересова: заинтересованы
необходим: необходима необходимой необходимость
высказа: высказалась
числ: число числе
парламентск: парламентскими
гражда: граждан
ход: ходе
подвес: подвесили
прова: провал
модел: модель модели
подозрева: подозреваемого
кризис: кризис
призыва: призывали
уйт: уйти
представител: представители представителей
виде: видео
защит: защитить защиты
всплеск: всплеск
сесс: сессии
депутат: депутаты депутатов
наук: наука
влия: влияет
объединен: объединение
дни: дни
коктейл: коктейлями
рейтинг: рейтинг
реш: решили
отрасл: отраслей
поддержа: поддержать
международн: международных
известн: известно
сторон: стороны
поддержк: поддержки поддержку
обитан: обитания
высказыва: высказывать
марин: марин
пройдет: пройдет
хорош: хорошие
стоимост: стоимость
повод: поводом
сред: среда
продвига: продвигают
социальн: социально социальным
наш: нашей
наблюда: наблюдать
люб: любые любой
успешн: успешный
похуден: похудения
борн: борн
язык: язык
умн: умных
план: плану
фот: фото
арестова: арестовало
нат: нато
взят: взять
информац: информация
выгодн: выгодным
гот: готов
разн: разные
негативн: негативно
столкновен: столкновения
воспольз: воспользуются
люд: людей
мусорн: мусорные
пен: пен
объяв: объявила
перестро: перестроить
министр: министра министрами министр
элизабет: элизабет
беспоко: беспокоиться
переста: перестало
комитет: комитетами
бержефранцузск: бержефранцузский
удовлетвор: удовлетворены
черн: чернов
скандирова: скандировали
граждан: граждане
вотум: вотума вотуме вотум
продаж: продажу
ле: ле
прим: прим
согласн: согласно
миров: мировой
забот: забота
запуст: запустить
страх: страха
обращен: обращения
ведут: ведут
президент: президент президента
акц: акции
сми: сми
правоцентрист: правоцентристов
мвд: мвд
ведущ: ведущих
рассмотрен: рассмотрения
стран: стране страны
аренд: аренды
десятк: десятки
январ: января
уровн: уровне
мо: моей
голосован: голосование голосования
поскольк: поскольку
март: марта
испытан: испытании
войт: войти
глав: главу главы
бутылк: бутылками
выбор: выборах
государств: государства государством
порядк: порядка
проблем: проблема
забрасыва: забрасывают
намерен: намерении
заяв: заявил заявили
болезн: болезни
коммунистическ: коммунистической
ракет: ракеты
виселиц: виселицу
угроз: угрозы
вынесен: вынесении
республиканск: республиканской
новост: новости
существ: существует
близк: близких
проведен: проведенного
приня: принять
добр: добро добра
демонстрант: демонстрантов
оо: ооо
изменен: изменений
возможн: возможным
уйдет: уйдет
восьмисот: восьмисот
хештег: хештег
энергетик: энергетики
франц: франции франция
привыкл: привыкли
шест: шести
обещан: обещаниям
отставк: отставку отставке
демонстрац: демонстрации
палат: палаты
боя: бояться
крупн: крупнейших
все: всей
ярост: ярость
премьер: премьера премьер
выпуск: выпуска
высок: высокий
респондент: респондентов
бывш: бывший
реальн: реальный
выступа: выступающих
руссел: руссель
способ: способом
доцент: доцент
reuter: reuters
tv: tv
mahe: mahe
twitter: twitter
killnet: killnet
ctrl: ctrl
appl: apple
bfm: bfm
stephan: stephane
enter: enter
revolut: revolution
