встал: встал
говор: говорят говорилось говорю
ру: ру
понима: понимают
фактическ: фактический
лев: левый
оттуд: оттуда
стат: стать статьи
воен: коренным военная военной
обычн: обычную
оказа: оказалась
рабоч: рабочую
стал: фронте стала стали
мнен: минченкополиттехнолог
правоохранител: правоохранители
си: си
объясн: лнр
раскол: раскол межконфессиональных пропаганды
работ: работы работу работе
центр: количество центрами
сценар: психологическое
мероприят: мероприятия
арх: архив
экономик: экономика
правов: правовых
мирянин: мирянином
пол: пола поле
сто: стоит
манхэттен: жилья
основан: оснований основания
плотник: дмитрий
вооружен: вооруженные вооруженных
макияж: нанесения
встат: встать
разговор: телефонных
арм: мова
просветительск: просветительского
банальн: банального банальных
должн: должны должна
перейдет: постепенно
структур: структуры
суд: суд решения
готовн: готовности
мужск: мужского
означа: означали
жестк: жестко
благодар: благодаря
котор: котором
чьем: чьем
провест: провести
здан: зданиям
изготовлен: изготовленные
расторга: расторгает
присоедин: присоединиться
унижа: унижал
силов: политолог решится силовые силовых
секретн: выложившего утечке
свят: святых святого
прав: права правом
спецслужб: зачастую
либ: либо
связ: связь связи
епифан: епифаний
каноническ: канонической каноническая ясны канонического
капл: капли
дела: ним
гонен: гонения
жестч: жестче
киевск: киевского
прост: простит
высел: выселить силой
прилуцк: прилуцкий
лин: интегральной
позвол: позволим демократичность позволить
рубл: рублей
заявля: заявляют заявлял
лиц: получит лица
православн: православного православных православные православной православную православная
пророссийск: пророссийскую пророссийских
покоя: покоящиеся
украинц: украинцев
нов: китаем
ног: ноги
внешн: аппарата
част: часть частью большей
корен: ближайшее
настоятел: настоятель
законопроект: законопроект
традицион: окончательный
алекс: алексей
опубликова: шанса
литератур: литература литературу
слов: слов
радикализац: вероятностью
якоб: якобы
сдела: сделаны
кольц: кольцо
идеолог: идеологии
деактивирова: нажмите
министерств: министерства министерство министерству
совет: совета
пут: пути
нос: обязали
обыск: обыски обысков прошел
активн: активным лице
синод: синод синода
русск: русской русская русским
пример: примеру
инвентаризац: инвентаризацию
предвыборн: афтокефалии
подач: подачу
пропаганд: продвижения
государствен: государственная государственным
летн: внешности
конкретизирова: конкретизировал
путешеств: путешествия
бесед: беседе
конформизм: конформизма
облада: забывать
сша: сша
миха: михаил
лидер: ракеты
процесс: процесса
аппарат: репрессивного
групп: группу группой
техник: техника
доказательств: доказательства
требован: требование
постепен: части
хотел: хотели
автокефал: автокефалии
культур: культура культуры
лнр: популярные
продолжа: храмах продолжалось продолжают собирать
господ: господь
продвижен: среду
врач: нато
филарет: филарет
выступ: выступил
попытк: попытка
враг: агрессора
ведомств: ведомства ведомстве
пцу: пцу
агресс: агрессию агрессии
умерен: умеренную
жител: местные
желан: останавливают
клирик: клириком
банков: банковую
свобод: свободе
подсанкцион: подсанкционные
отключ: комментарии
спецпроект: спецпроекты
закон: закону
осуществля: захваты
положительн: разговоров
росс: россии россия россию сотрудничать
помогл: помогло
лебед: лебедь
фбр: документов
очищ: очищена
мотор: мотор
разорва: разорвала разорвать
ситуац: изменил ситуация
счита: считать считает
насильствен: насильственного
лент: ленту ленты лентой лента
руководител: руководителя руководитель
опечатк: нашли
российск: российские российских российскую российской
неизбеж: предрешен
политическ: политическое религиозному военно
коммерческ: коммерческими
директор: директора директор
духовн: духовном духовная духовную
веден: ведении
завершен: завершения
частност: частности
налич: наличие
прихожа: прихожан
использова: пытается
монастырск: монастырский монастырского монастырском
достаточн: достаточно
пройт: пройти
поруч: поручил
небес: небеса
светлогорск: светлогорской
общин: общины
сказа: сказано
ссср: ссср
комисс: комиссия комиссии
слез: слезы
след: следующий
напомн: напомнил напомнили
организац: организаций организациями организации
невозможн: невозможности сектой
неотложн: неотложную
общен: общение
публикова: публиковались
недавн: недавнего
гэсс: гэсс
событ: событий события
сниз: снизился
храм: храма ряд захваченных
назнач: назначил
поворотн: поворотным
митрополит: митрополиту митрополита
добива: добивается
блогерш: летней
назва: назвал
внест: внести
собира: собираются собираться дольше
некотор: некоторое
оккупант: оккупантами
противостоян: эскалацию столкновений
отрицан: отрицании
служб: службы службе служба
количеств: массовости силовое
попа: попал
остава: оставаться
логичн: политика
добав: добавил
штурм: штурма
спорт: спорт
специальн: специальной
самопровозглашен: самопровозглашенных
услов: условий условия
евхаристическ: евхаристическое
стро: строить
приход: приходить приходов приходам ситуацию
предпринима: предпринимали
сбор: сбора
тайн: молиться
останет: секта
епифанийпредстоятел: епифанийпредстоятель
разжиган: разжигании
гнойник: гнойником
тюренк: тюренков
программ: россией
ревизор: ревизоров
главн: главное главным
действ: действия действий
покида: покидать покидающие
церков: церковью церковь
автокефальн: автокефальной
октябр: октябре
религиоведческ: религиоведческой
подтверд: подтвердил
карасьлидер: карасьлидер
инициатив: инициатива
стоя: стоящие
отдел: отдела
рад: рады раде
созда: создана создало
патриарх: патриарха патриарх
кирилл: кирилла кирилл
имеющ: имеющими
ран: раннего
паспорт: паспорта
выполн: выполнено
интернет: интернет
московск: московского московский московским
межконфессиональн: внутриконфессиональных
предельн: центра
херсон: переходе
тем: теме
официальн: официально
пришл: студентке
фотограф: фотографией
бес: бесов
агрессор: отрицающие
комментар: плотников
поставл: поставлены
малюк: малюк
сотрудник: сотрудники
работа: работать
запрет: запрет запрета
нанесен: блогерши
останавлива: внутреннего
безболезнен: безболезненно
телефон: перехваченных
высказа: высказался
необходим: необходимо необходимость
числ: пригожин числе
успенск: успенском
осуд: осудили
устав: устава
приостанавлива: приостанавливать
подозрева: подозревают подозреваемыми арестовало
прогоня: прогоняли
сотруднича: захотел
катехизац: катехизацию
очеред: очередь
виде: видео
вражеск: вражеской
нигд: нигде
положен: перейдет сравнимое
верност: верности
порошенк: порошенко
явн: явно
сепаратист: сепаратиста
нынешн: евгения
оста: остается осталась
заключен: заключенный
быстр: быстро
эксперт: эксперт
предмет: предмет
реч: речи
реш: невозможно решили решить
консалтинг: минченко
генеральн: генерального
общ: общего
предыстор: предыстория
шевченковск: допрос
поконч: покончить
пригожин: политике
защища: защищать
обитан: обитания
реж: режим
обе: радикализации
сравним: положение
пропуст: пропустили
демократичн: играть
повод: поводу
культурн: культурного
этнополитик: этнополитике
сред: церковную среда
может: можете
чувств: чувства
мног: многие
уста: устав
буковинск: буковинской
можеш: можешь
люб: любая любой
похуден: уколов
язык: армия
резидентур: резидентуры
заместител: заместитель
фот: фото
происходя: происходящие происходящее
разр: разрыв
письм: письмо
взял: взяли
инспектирова: инспектировать
неканоническ: неканонические неканонической
люд: людей
расколол: расколол
огн: огня
год: х
принадлежн: этническую афишируя
экспертиз: экспертизу экспертизы
ревиз: ревизию
министр: министра министр
подпол: подполье
зачаст: группировок
физическ: физически
применен: применения
разгора: разгорающегося
создан: создание
отрица: оправдывающие
совест: совести
вывод: выводов
принадлежа: принадлежала
запис: опубликовала
антон: антоний
волн: каноническую
одн: одна одним
продаж: выставил
улик: уликами
намекнул: намекнул
повлечет: повлечет
приб: прибыли
всеприбалтикаукраинабелоруссиямолдавиязакавказьесредн: всеприбалтикаукраинабелоруссиямолдавиязакавказьесредняя
обращен: обращении обращением
пода: подало
улиц: улицу
столиц: столица
потребн: объяснили
петр: предыдущем петра
афиширу: тайно
стычк: стычки
команд: возможностей
объединя: принадлежит
апрел: апреля
стен: стенам стены
продавлива: направления
опир: опираясь
новомиргородск: новомиргородской
участ: участием
электрон: носить
наличн: наличные
козыр: козырей
историк: историко
март: марта
испытан: известно
войт: войти
массов: массового реальной
глав: главы глава
богоявлен: богоявление
лингвистическ: лингвистической
деятельн: деятельности
духовенств: духовенству
войд: войдя
поступа: поступать
присяга: присягать
сект: приведут останется
прихожанин: прихожанина
болезн: смертельной
украинск: украинских украинские украинской украинская раскола
ракет: гиперзвуковой
минченкополиттехнолог: переходить
новост: новости
константинопольск: константинопольским
перв: первую первого
посет: посетили
полуноч: полуночи
мариан: марианна
добр: деактивирована добра
прихожан: прихожане прихожанами
изменен: изменения
уйдет: значительная
предреш: захват
возл: возле
патов: патовой
исполнен: исполнения
повер: поверили
национализм: линии
голов: голову
определ: определить определиться
как: уверен какие каким
участник: участников
повлия: повлиять
рассматрива: рассматривать
заполуч: удастся
обход: противники
реальн: катакомбах признаку пожаловать
коммуникацион: суда
вынужда: уничтожать
точк: точки
сфер: программе контроля
мер: избрал
признак: политическому
подоляк: подоляк
репрессивн: поддержкой
готов: команда
провер: проверить
затиш: затишье
влиян: влияния оценили
студентк: похудения
информацион: информационно
парламент: парламент
кгб: кгб
независим: независимость независимой
образ: образом
епарх: епархиях епархии
учет: учетом
ждет: ждет
советник: советник
обезглав: обезглавить
случа: случае
появ: возможности появились
призва: призвав призвал призвали
даниловсекретар: даниловсекретарь
удал: пришлось
вернут: вернуться
павл: павлу
предел: вышло
подчеркнул: стране
конфликт: реальных конфликт конфликта
александр: александр александра
константинопол: константинополя
санкц: санкции
оперативник: оперативники
вообщ: вообще
рпц: рпц
упадут: упадут
ожида: ожидает
личност: раскрыли
самоуправля: самоуправляемая
слиян: слияние
х: положением
показа: показавшей
сообщ: контроль сообщила
поэт: поэтому
иерарх: иерархи
структурн: структурным
ткаченк: ткаченко
сочл: сочла
митропол: митрополит
вариант: варианты
мир: мир
укол: популярных
прописк: месту
идеальн: идеальное
знают: знают
внешност: удивились
безопасн: безопасности
орга: органы
аудиенц: аудиенции
вагнер: чвк
соблюден: соблюдение
нажм: опечатку
феврал: февраля
удаст: консолидации
варфоломе: варфоломея
скол: сколь
классическ: классических
боев: сторонника
власт: власти властей продавливаются власть
получ: получившая получил заполучить
блокир: блокирующих
распечатк: распечатку
фронт: утечки
важн: важнейших
резюмирова: традиционного
враждебн: враждебные
декабр: декабре декабря
национальн: национального национальной
кров: крови
рук: руки
украин: украине украины
националист: националисты
внутр: внутри
метр: метро
раскр: отключены
рус: руси
подлин: подлинность
личинк: личинка
шанс: шансом дадим
издан: издания
выстав: лидер
покинут: покинут покинуть
нежинск: нежинский
позиц: позицию
погас: погасила
перехвачен: записи
яростн: активных
нарушен: нарушении
вынест: вынести
больш: большая мнению политическая
мест: место ареста
начин: начиная
офис: офис офиса
вход: входа вход
направлен: собственной направленные направление
беззакон: беззаконную беззаконные
лозунг: предвыборным
автомоб: автомобили
принудительн: принудительном
ясн: предельно
эффективн: оценил
видет: видеть
насильн: всей
синодальн: синодальные синодального
смогл: смогла
редакциярекламаконтактыпресс: всу
департамент: департамента
продолжат: продолжат
жизн: жизни
импер: империю
идт: дальнейшем
украинизац: милитаризацию
деятел: деятелей
зашедш: сфера
сформирова: сформировать
чвк: уничтоженных
мов: лозунгом
климент: климент
пыта: пытался враг
расцен: расценив
мол: женщина молятся катакомбы
момент: момент моментом
исполня: исполняющий
заседан: заседания заседание
принципиальн: принципиально
основн: основном
вышл: противостояние
константин: константин
сторонник: приходят яростного
внутриконфессиональн: почва
психологическ: продолжаться
привест: привести
малюкпредседател: малюкпредседатель
своеобразн: своеобразная
утечк: преднамеренной влияние
решен: решение развязки
витк: очередному
градус: градус
допрос: увезли
удив: сети
антиукраинск: антиукраинские
милитаризац: национализма
провод: проводить проводила проводите
личн: продажу
васил: василий
домашн: браслет круглосуточного
поздн: позднее противостояния
чиновник: чиновник чиновники
почв: сторон
дольш: насельникам
мощ: мощи
нецерковн: осуществляют
вылож: личность
зеленскийпрезидент: зеленскийпрезидент
верховн: верховной
ввел: ввел
выполня: выполнять
результат: результате результатам результат результаты
дад: общества
павел: павел
оскорбля: оскорблял
увезл: обыск
обнаруж: обнаружено обнаружили
дал: далее дало
браслет: электронный
функционирован: функционирования
документ: секретные секретных документе
рождественск: рождественской
увер: неизбежен
оправдыва: делал
сопротивлен: сопротивление
захвачен: продолжать
музейн: музейный
зачист: зачистить
агент: агентов
предписа: предписал
дан: данные
указа: указана
состоя: состоялось
раскрыт: рекорд
поручен: поручения
заповедник: заповедника
гиперзвуков: новой
группировок: различных
ставленник: ставленник
пожалова: добро
деньг: деньги
отказа: отказался
очк: умных
предлож: предложила
эскалац: идти
предстоятел: предстоятель
галер: галереи
оцен: очков врач
незакон: незаконным незаконных
политик: тупик политик нынешняя
начат: продолжение
уход: уходе
окончательн: вмешательства
полиц: полиция
лавр: лавра лавры лавру лавре
тупик: зашедшей
обнов: манхэттене
правительств: правительство правительству правительства
объект: объектах
настроен: настроения радикально
круглосуточн: виде
фрагмент: фрагмент
жил: стоимость
имуществ: имуществом имущества
кировоградск: кировоградской
направл: направлена
продолжен: продолжения логичное
пособник: пособниками
отход: отходите
заня: заняли
поколен: поколениях
руководств: руководством
наступлен: потребность
медиа: подозреваемого
таска: таскать
произошл: произошла произошло
итог: итогам
обеспеч: обеспечим
патриархат: патриархата патриархатом патриархат
постройк: постройками
масштабн: обходится
дел: дело делами дела
вопрос: вопросом вопрос
ближайш: спецслужб
сохраня: сохраняется
игра: какое
внутрен: угроза
вскор: вскоре
переход: отзывался вынуждать
ваш: вашей
ответ: ответ
интегральн: начатой
москв: москвы
никт: никто
обществ: украинского
контрразведывательн: контрразведывательные
полност: полностью
богослужен: богослужения
несмотр: несмотря
развязк: перешел
срок: раскрыты
евромайда: евромайдана
собствен: украинизацию
москал: москалем
измен: захватом изменится арест
преследован: преследований
территор: территорию территории
уда: удалось
избра: шевченковский
этническ: учитывая
материал: материалы материале
монах: монахи монахов монахам
корректировщик: корректировщиков
выезд: выезде
уничтожа: выселят
смен: изменить
ряс: рясах
отношен: отношению
расторжен: расторжении
аз: азия
арест: домашнего домашний
подоляксоветник: подоляксоветник
вселенск: вселенского
кита: испытании
церковн: использовать церковных церковным церковно
хозяйствен: хозяйственном хозяйственный хозяйственными
ряд: пределы
последн: последнее последним последней последние
заявлен: заявлениям заявления
раздораб: раздорабывший
качествен: качественно
захотел: иран
жми: жми
сбу: сбу
священнослужител: священнослужителя священнослужители
потасовк: потасовка
онуфр: онуфрия
би: би
организова: организован
называ: называли
вероятн: большой
давлен: давление волна
управлен: управления
ира: макияжа
препятствован: препятствование
нашл: ооо
глубин: глубинной
женщин: принадлежности
представл: представлено
иск: иска иске
недолг: недолго
очередн: готовится
обязан: обязанности
вер: верующими верующим верующих верующие
популярн: эффективность болезни
вмешательств: внешнего
смертельн: удалить
административн: административно
научн: научной
экспонат: экспонат
церкв: церквей церкви церквях
пентагон: документы пентагона
спин: спинах
уеха: уехала
нача: начались начать начал начав начался
невида: давления
забыва: принадлежность
академ: академия
оруж: оружие
го: го
значительн: годов
шантаж: шантажом
свор: своре своры
пообеща: пообещали
рекорд: обновила
явля: является являешься являются
виктор: викторе
вещ: вещи
уголовн: уголовных уголовную
святын: святынь
представ: представила
препятствова: препятствовавших
александрийск: александрийской
контрол: херсона желании
строен: строений
уничтожен: число
продолж: продолжится
священноначал: священноначалия
зеленск: зеленского зеленскому зеленский
различн: боевики
отвергнет: отвергнет
преднамерен: пентагон
ценност: ценности
розн: розни
подразделен: подразделением
отрабатыва: отрабатываем
рейдерск: количества
истор: истории
зрен: зрения
конфесс: конфессий
снбо: снбо
сем: семье
уйт: уйти
томос: томос
представител: представители представителей
служен: служение
вид: пресечения
сет: наступлении
распоряжен: распоряжение
защит: защитило защиту
внов: вновь
ноябр: ноября
боевик: настроенные
договор: договора договор
наук: наука
хот: хотят
дне: дней
отзыва: положительно
сумм: сумму
предоставлен: предоставленный
неоднократн: неоднократно
дом: сообщили
известн: стало
сторон: обеих стороны сторону
наместник: наместник
поддержк: поддержке обладает
угодн: угодно
афтокефал: добившемся
призна: признают
черновицк: черновицко
доб: добиться петре
хорош: хорошие
стоимост: медианная
опира: опирается
пребыва: пребывающим
предыдущ: невиданная
прокремлевск: прокремлевская
наш: наших
оборон: обороны
консолидац: витку
религиозн: религиозных религиозными религиозные объединяет религиозной
паств: паству
большинств: подчеркнул
сил: поздно
умн: выпуска
обяза: прописки
план: плане
доллар: долларов
арестова: фбр
царьград: царьград
печерск: печерской печерскую печерский печерская печерского
регулярн: регулярно
холдинг: коммуникационного
евген: евгений язык
нат: личные
информац: редакциярекламаконтактыпресс информации
блокпост: блокпост
насил: насилия
земл: землю
тюренковруководител: тюренковруководитель
столкновен: масштабных
распоряд: распорядился
разгр: разгром
противник: сторонники
берег: берег
православ: православие православия
автономн: автономной
объяв: объявило объявить
бессрочн: бессрочной
телекана: телеканала
минченк: холдинга
ки: киев
катакомб: уйдет иконой
отбива: отбивается
идет: идет
подготовл: подготовлен
правил: правилам
западенц: западенцем
забот: забота
президент: президент президенте президенту президента
сми: сми
священник: священников священника
осужда: осуждать
примирительн: примирительным
ответствен: ответственность
рассмотрен: рассмотрения рассмотрение
федерац: федерации
упц: упц
томин: томин
аренд: аренде аренды
стран: смена страны
крайник: крайник
январ: января январе
мп: мп
перешел: насильно
местн: нецерковные
душ: души
прошел: доме
комплекс: комплексе комплекс комплекса
собор: собор соборе
государств: государства
соверша: совершать
националистическ: националистической
намерен: намеренно
заяв: заявить заявил заявили заявила
досматрива: досматривают
киев: киеве киево киева
бород: бороды
пользован: пользование пользования
насельник: позволят
угроз: боевые угрозами
владимир: владимир владимира владимиру
управля: управляющий
дума: думаете
икон: молится
операц: операция операции
оо: информация
возможн: властью появилось
дальн: консалтинг
политолог: резюмировал
всу: бойцов
учитыв: расколов
направ: направились направили
внес: внес
утр: утром утра
крупн: крупнейших
янукович: януковиче
все: всея храмов
дмитр: сферами
судебн: судебного
сюжетспециальн: сюжетспециальная
грив: гривен
взгляд: взгляды
принадлеж: большинство
аффилирова: аффилированных
бойц: вагнер
выпуск: сроки
риторик: риторики
бывш: бывший
отстран: отстранилась
монастыр: монастырей монастырь монастыре монастыря
выступа: выступает
радикальн: радикальные жители
ник: никому
откр: открыла
полицейск: полицейские полицейских
июн: июня
выселен: выселение выселением выселении выселения
захват: силовой конфликтов сценарий
наход: находили находятся находиться находится
приведут: рейдерские
никак: никаких никак
источник: источник
пресечен: меру
garanich: garanich
vladyslav: vladyslav
mstyslav: mstyslav
musiienko: musiienko
ctrl: ctrl
efrem: efrem
appl: apple
roman: roman
lukatski: lukatsky
ogirenko: ogirenko
valentyn: valentyn
cole: cole
chenov: chenov
andrew: andrew
ap: ap
getti: getty
daniel: daniel
reuter: reuters
gleb: gleb
killnet: killnet
pilipei: pilipey
imag: images
kravchenko: kravchenko
enter: enter
