париж: париж
леонид: леонид
ру: ру
фактическ: фактический
грабеж: грабежом
стат: статье статьи
воен: военных военные военной
обычн: обычную
европейск: европейские европейских
рабоч: рабочую
стал: стала стали стало
мнен: мнение мнению
слуг: слуги
вуз: вузов вузах вузы
объясн: объяснили
оплот: оплотах
северн: северной
работ: работы работах
абориген: аборигенов
завис: зависит
показыва: показывает
чужеземц: чужеземцы
арх: архив
экономик: экономика экономики экономикой экономике
буркиниец: буркиниец
обира: обирала
получен: полученное
торговл: торговли
сто: стоит
размеща: размещают
манхэттен: манхэттене
человек: человека
некоммерческ: некоммерческой
лес: леса
торгова: торговала
вооружен: вооруженный
макияж: макияжа
империализм: империализма
должн: должны
структур: структурами структуры структуру
студент: студентов студентам
запас: запасов
жестк: жесткому
благодар: благодаря
котор: которую которое которому
уб: убили
денег: денег
времен: временем
законодательн: законодательного
силов: силовые
благ: благ
секретн: секретные
запад: запад запада
вест: вести
связа: связаны
прав: правах
природн: природными
статистик: статистика
отмет: отметить отметил
связ: связи
отмен: отменили
заб: забыли
сут: сути
дискусс: дискуссии
вывез: вывезены
член: член
некогд: некогда
союзник: союзников союзниками
россиянин: россиянин
сосед: соседа
лит: литий
равенств: равенства равенство
справедлив: справедливости справедливость
лиш: лишится
тантал: танталит
транснациональн: транснациональные
праведник: праведники
международник: международник
эксплуатац: эксплуатации эксплуатацию
очевидн: очевидное
уровен: уровень
нов: новый нового новой новые новое
сильванус: сильванус
убежд: убеждена
дья: дьяо
част: часть частях
корен: коренным
воспротив: воспротивиться
слож: сложившуюся
алекс: алексей
слов: слова словам
журна: журнала
пострада: пострадает
дворц: дворцов
якоб: якобы
буркин: буркина
хищническ: хищнический хищнически
нарочницк: нарочницкая
идеолог: идеологии
деактивирова: деактивирована
судьб: судьбах
нацбанк: нацбанке
совет: совета
пут: путь пути
активн: активно
вперед: впереди
пример: примеру примера
истреблен: истреблению
колониальн: колониальные колониальных
выход: выходить выхода
кобальт: кобальт
кооперац: кооперация
журналист: журналист
государствен: государственной
летн: летней
отмеча: отмечает
натал: наталия
труд: труде труда трудом
путешеств: путешествия
исчез: исчез
облада: обладающее
ресурс: ресурсами ресурсов ресурсах ресурсом
сша: сша
лидер: лидер лидером
процесс: процессы процесс
свойств: свойство
техник: техника
европ: европа европе европы
постепен: постепенно
достойн: достойный
культур: культура культуру
дружб: дружба
лнр: лнр
продолжа: продолжает продолжают
помога: помогает помогаем
рынк: рынки
резерв: резервов
помощ: помощью помощи
врач: врач
климат: климате
малик: малик
астапкович: астапкович
промышлен: промышленный
рекордсм: рекордсмен
жител: жители жителям жителей
показател: показатели
будущ: будущее
запрещен: запрещенная
укреп: укрепить
влавон: влавону
фас: фасо
интерес: интерес
агрессивн: агрессивным
отключ: отключены
борьб: борьбе борьбу борьбы борьба
минимальн: минимально минимальной
спецпроект: спецпроекты
протяжен: протяжении
осуществля: осуществляли
француз: французы
закон: законным
легендарн: легендарный
росс: россии россия россией
помог: помогая
фбр: фбр
неоколониалистск: неоколониалистских неоколониалистскому
процент: процентами
четырех: четырех
вашингтон: вашингтон
мотор: мотор
абрамов: абрамова
равноправ: равноправии
ситуац: ситуацию ситуация
водопровод: водопровода
счита: считает считают
отсутств: отсутствует
насильствен: насильственно
тасманийц: тасманийцев
цел: целый целей
спецоперац: спецоперации
лент: ленте лента ленту
отменя: отменяет
нечестив: нечестивые
опечатк: опечатку
российск: российскими российских российской
всеполитикаобществопроисшествияконфликтыпреступн: всеполитикаобществопроисшествияконфликтыпреступность
взаимодейств: взаимодействии
португал: португалии
политическ: политической
золот: золото
директор: директор
кабальн: кабальный кабальную
серьезн: серьезную
алмаз: алмазы
использова: использовали
прибыл: прибыль
прекрасн: прекрасная
общеизвестн: общеизвестную
африк: африке африку африки африка
безвыходн: безвыходным
достаточн: достаточно
сюд: сюда
настоя: настоящим
список: список
сказа: сказанные
ссср: ссср
напомн: напомнил
институт: института
организац: организации организация
луидж: луиджи
убит: убиты
коротк: короткой
недр: недра
против: противятся
так: таких таким
трансатлантическ: трансатлантической трансатлантическом
тропическ: тропические
хран: хранить
добива: добиваются
блогерш: блогерши
назва: назвал
товар: товаром
утверд: утвердила
неповинова: неповиновавшихся
некотор: некоторыми некоторых некоторые
океан: океане
обуча: обучается
количеств: количество
древн: древнюю
остава: оставаться
богатств: богатства
спорт: спорт
муденд: муденда
специальн: специальные
скат: скатилась
бедност: бедность
услов: условиях
друг: другом
приход: приходилось
рудаков: рудакова
устремлен: устремлений
народ: народов народом
железн: железная
компан: компании
рассказыва: рассказывает
степен: степени
джордж: джордж
программ: программе
коммуникац: коммуникациям
получа: получает
главн: главное главного главными
делов: деловым
сверхприб: сверхприбыли
велик: великой
привел: привел
низк: низкий низкие
бледнолиц: бледнолицые
стратегическ: стратегическим стратегических
раб: рабами раба рабом рабов
усма: усман
бенин: бенин
использ: использует
бедн: бедных
раз: раза
созда: создает
атлантическ: атлантической атлантического атлантическом
ран: ран
нижн: нижней
англосаксонск: англосаксонские
интернет: интернет
московск: московского
побереж: побережья
наименьш: наименьшими
невел: невелев
делишк: делишках
колоссальн: колоссальными
препода: преподают
основател: основатели
официальн: официальный
великобритан: великобритания
пришл: пришлось
полн: полному
столет: столетия
зимбабв: зимбабве
определя: определять
кошельк: кошельке
узакон: узаконили
штат: штатах
комментар: комментарии
колонизац: колонизации колонизация
джефферсон: джефферсон
запрет: запретили
нанесен: нанесения
африканск: африканским африканской африканском африканского африканская африканских африканские африканский
вызва: вызвал
необходим: необходимости
числ: число числе
период: периода
подозрева: подозреваемого
сотруднича: сотрудничать
демократическ: демократических демократические
комнат: комнате
маршрут: маршрутов
шут: шутов
автор: автор
очеред: очередь
цивилизова: цивилизованные
виде: видео
ликвидац: ликвидацию
возник: возник
положен: положением
подход: подходу
историческ: исторической исторически
нынешн: нынешняя
счастлив: счастливое
оста: остаются
фрукт: фрукты
пользу: пользуясь
эксперт: эксперта
спрос: спрос
депутат: депутаты
тип: типа
разреш: разрешили
воспринима: воспринимать
объединен: объединения
международн: международным международный международная международной
прозяба: прозябает
окончан: окончания
третьекурсниц: третьекурсница
подтвержден: подтверждение
пригожин: пригожин
сиюминутн: сиюминутных
обитан: обитания
поддержива: поддерживала поддерживаться поддерживаемым
рхту: рхту
сред: среда
плеханов: плеханова
социальн: социальной
редактор: редактора
устойчив: устойчивого
мног: многом многими многие многих
люб: любит любят любая
зависим: зависимость
похуден: похудения
язык: язык
фот: фото
менделеев: менделеева
фактор: фактором
колонист: колонистами
хронист: хронист
разн: разного
планет: планеты планете
социоэкономическ: социоэкономические
люд: людей
разв: развил развить
год: годах годов
министр: министр
зачаст: зачастили
комитет: комитета
особ: особо
производств: производств
май: майо
знает: знает
одн: одна одно
мал: мали
продаж: продажу
исламск: исламского
редуцирова: редуцированной
согласн: согласно
неприемлем: неприемлемым
приб: прибывшего прибыли
потребн: потребность
глубж: глубже
выпускник: выпускник выпускников
инструмент: инструментами
объединя: объединяться
чеснок: чесноков
находя: находящихся
десятк: десятков
регион: регионе
поскольк: поскольку
историк: историк историки историков
март: марта
испытан: испытании
необратим: необратимы
войт: войти
богател: богатели
батыр: батыр
испан: испании
фонд: фонд
динамик: динамику
состав: составил
сраз: сразу
благодарн: благодарность благодарны
порядк: порядка
возобновля: возобновляет
поступа: поступает
болезн: болезни
повин: повинных
задействова: задействована
ракет: ракеты
жела: желавших
новост: новости
перв: первых
бог: богу
подвод: подводя
фабрик: фабрики
листвен: лиственные
добр: добро добра
рабск: рабским рабском рабскую
франц: франции франция францией
основ: основа
голод: голод голоде
топлив: топливо
гаит: гаити
площадк: площадке
последова: последовала
прошл: прошлого прошла
господин: господина
род: рода родился
оппонент: оппоненты
реальн: реальный
тяжел: тяжелых
втор: вторая
нефт: нефть
рол: роль
дешев: дешевую
точк: точки
сфер: сфера сфере
способ: способ
форм: форма форме формой
завоевыва: завоевывать
правнук: правнуков
долгосрочн: долгосрочно долгосрочную
избав: избавиться
неоколониализм: неоколониализм неоколониализма
конференц: конференции конференция
залеж: залежами
жертв: жертв
индуцирова: индуцировать
терроризм: терроризма
студентк: студентка студентке
влиян: влияния влияние
парламент: парламента
америк: америки америку
независим: независимость независимости
образ: образом
учен: ученого
конц: конца
маленьк: маленькой
появ: появилась
удал: удалить
практическ: практически
работорговц: работорговцах
вернут: вернуться
возмут: возмутился
подчеркнул: подчеркнул
конфликт: конфликт
франсу: франсуа
александр: александр
обновлен: обновленной
утвержда: утверждал
слуцк: слуцкий
й: й
стремлен: стремлении стремлений
потреблен: потребления
макрон: макрон
подчеркнув: подчеркнув
личност: личность
х: х
поэт: поэтому
колониализм: колониализма колониализм
памят: памяти
мир: мир мире мириться
укол: уколов
работорговл: работорговли работорговлю работорговле
внешност: внешности
безопасн: безопасности
привива: прививают
дестабилизир: дестабилизируют
вагнер: вагнер
скор: скоро
многообразн: многообразного
нажм: нажмите
коллективн: коллективный
выраз: выразил
оон: оон
получ: получили
власт: власти властям
французск: французском французским французского
фронт: фронте
важн: важнейшее важна важным
провел: провел
озвуч: озвучил
руд: руда
газет: газете
экономическ: экономическую экономического экономическим экономически экономические экономических
национальн: национального национальной
декабр: декабре
украин: украине
гранат: гранатой
раскр: раскрыли
традиц: традиций
выстав: выставил
позиц: позиции
покинул: покинул
ярк: ярких яркое
переворот: переворот переворотов
больш: большая
ответн: ответный
потенциа: потенциал
мест: местах
начин: начиная
комсомольск: комсомольской
борец: борец
борет: борется
вход: входит
неправительствен: неправительственные
эффективн: эффективности эффективность
запреща: запрещать запрещает
видет: видеть
англ: англии англия
смогл: смогли
извлечен: извлечения
мягк: мягкая
угнетен: угнетения
редакциярекламаконтактыпресс: редакциярекламаконтактыпресс
вспомн: вспомнить вспомнили
жак: жаком жак
жизн: жизни
импер: империя
граб: грабя
солдат: солдаты
зашедш: зашедшей
чвк: чвк
пыта: пытаются
полноцен: полноценного
сотн: сотни
отм: отмены
плантац: плантаций
американц: американцы
приглас: пригласили
авторитет: авторитет
пошл: пошли
развива: развивала развиваться
митинг: митинги
основн: основном
боксит: бокситы
средневеков: средневековую
утечк: утечке утечки
решен: решения
многополярн: многополярном многополярной
ширак: ширак шираком
удив: удивились
просвещен: просвещения
любя: любящие
провод: проводить
личн: личные
нужн: нужны
отц: отцы
советск: советских советские
секрет: секрет
нигер: нигер
вылож: выложившего
олимп: олимпио
перепад: перепадами
аналитическ: аналитической
результат: результате
даб: даби
доминирован: доминирования
гуманизм: гуманизма
сближен: сближения
вышедш: вышедшей
бенджамин: бенджамин
богат: богатого богатый
документ: документы документов
увер: уверен
прислуг: прислуги
бугум: бугума
голланд: голландии
прозападн: прозападными
дан: данные дании
имен: имени
раскрыт: раскрыты
библейск: библейски
народн: народного
гиперзвуков: гиперзвуковой
коп: копией
пожалова: пожаловать
формирован: формирования
наказыва: наказывать
отказа: отказалось
диабет: диабете
очк: очков
порассужда: порассуждать
шахт: шахт
возника: возникают
галер: галереи
оцен: оценили оценил
тасман: тасмании
сохран: сохранила сохранившемуся
глобальн: глобальной глобальных
политик: политики политику политиков политике
вмест: вместо вместе
минимум: минимум
финансов: финансовых
тупик: тупик
обнов: обновила
правительств: правительство правительствам
жил: жилья
нещадн: нещадно
начал: начале
возвращен: возвращения
санкар: санкара
наступлен: наступлении
медиа: медианная
учитыва: учитывает
высш: высшей
религ: религии
итог: итоги
обеспеч: обеспечить
обедневш: обедневших
ассамбл: ассамблеи
дел: делам делах
европейц: европейцами
рассказа: рассказал
жит: жить
сохраня: сохраняют
игра: играть
требу: требуя
ответ: ответ
изучен: изучения
москв: москвы москву москве
срок: сроки
собствен: собственных
измен: изменить
британск: британские британскими
территор: территориях
дет: детей
ирин: ирина
смен: смены
колумб: колумбит
отношен: отношения
продолжительн: продолжительность
аз: азии
обща: общается
жесток: жестоко
умерш: умерших
кита: китаем китае
мысл: мысль
собран: собрания
ряд: ряд
последн: последние
многовеков: многовековой
искрен: искренне
внук: внуков
шлейф: шлейф
сам: самый
поддержан: поддержании
экстремист: экстремистами
захотел: захотел
жми: жми
вырос: вырос
преувеличен: преувеличения
школ: школы
самм: саммит
образован: образование
называ: называемом
ира: иран
принят: принято
переходн: переходного
приграничн: приграничных
нашл: нашла нашли
записа: записал
уважа: уважающие
минерал: минералов
заключа: заключается
век: века веков веками веке
начина: начинают
очередн: очередной
формир: формирующемся
вер: вере
западн: западных западными западного
популярн: популярных популярные
сотрудничеств: сотрудничества сотрудничество
диктат: диктатом
соцсет: соцсетях
смертельн: смертельной
спикер: спикер
минеральн: минеральных
пентагон: пентагона
сво: своем свой своим
нача: начало начали
эммануэл: эммануэль
слав: слава
специалист: специалистов
профессор: профессор
станов: становятся
замеча: замечать
перспектив: перспективы
академ: академии
значительн: значительной
истин: истинный
хижин: хижин
рекорд: рекорд
треугольник: треугольнике
явля: является являются
извлеч: извлечь
выступлен: выступлении
мудрост: мудрость
развит: развитии развития развитой
ди: ди
нестабильн: нестабильностью
станут: станут
обеспечен: обеспечения обеспечении
атлантик: атлантики
демократ: демократии
контрол: контроль контролю
уничтожен: уничтоженных
технолог: технологии
нищет: нищету нищете
придержива: придерживается
зеленск: зеленского
трех: трех
различн: различных
трет: третьего
континент: континенту континент континента континентом континенте
ценност: ценностях ценности
неоколониальн: неоколониального
океа: океана
истор: истории история
парламентск: парламентской парламентская парламентские
ход: ходе
зрен: зрения
ес: ес
рабовладельц: рабовладельцем рабовладельцев
пробл: проблем
флаг: флагами
репутац: репутацию
противовес: противовеса
представител: представителей
сет: сети
метропол: метрополий метрополией
заокеанск: заокеанских
прекраща: прекращалась
доход: доход
боевик: боевиков
естествен: естественными
абдулла: абдуллаев
договор: договор
наук: наука наук
памя: память
позволя: позволяют позволяет
спонсируем: спонсируемых
эпох: эпохи
предоставлен: предоставлением
упоминан: упоминаний
забыв: забывая
поддержа: поддержанных
быстрорастущ: быстрорастущие
известн: известно
оконч: окончившими
сторон: стороне
предостав: предоставили
поддержк: поддержку
любов: любовь
ассамбле: ассамблея
принцип: принципах принципов
хорош: хорошие хороший
стоимост: стоимости стоимость
колон: колониями колониях колонии колоний
плантатор: плантатором
ид: идеи
азурар: азурара
ин: иной
наш: нашему нашей наших нашу нашего нашем
днем: днем
геноцид: геноциду
республик: республики республика
оборон: обороны оборонный
бандформирован: бандформированиям
полюб: полюбили
итальянск: итальянский
успешн: успешную
франклин: франклин
эксплуатирова: эксплуатировать
большинств: большинство
сил: силу сила
умн: умных
несметн: несметные
затрат: затратами
публичн: публичные
арестова: арестовало
держав: державы
нат: нато
составля: составляла
информац: информацию информация
описа: описал
выгодн: выгодным
группировк: группировками
ключев: ключевую
хозяйств: хозяйства
чернокож: чернокожими
колонизатор: колонизаторы колонизаторов
португальск: португальский
английск: английской
противостоя: противостоять
переста: перестали перестало
эдвард: эдвард
максимум: максимум
ко: коих
поговор: поговорить
черн: черного черный
например: например
отправля: отправлять
равноправн: равноправных равноправный
миров: мировой мирового мировую
забот: заботятся забота
африканц: африканцам африканцами африканцев
ура: уран урана
надежд: надежды
лу: луи
президент: президентом президент
общежит: общежития
председател: председатель
приеха: приехали
сми: сми
огромн: огромный
нидерланд: нидерланды
музык: музыки
австрал: австралии
доктор: доктор
стран: странами странах страны стране странам страна страну стран
миттера: миттерана
аренд: аренды
вол: воли
уровн: уровне уровня
отлич: отличие
громк: громкой
южн: южных
включа: включается
местн: местных
сист: систему
качеств: качестве
корреспондент: корреспондент
хачатур: хачатуров
выживан: выживание
государств: государства государств государство государствах государстве
дум: думы
османск: османская
западноевропейск: западноевропейские
заяв: заявил заявили
латинск: латинскую
радова: радовался
угроз: угрозой
причерномор: причерноморье
владимир: владимир владимира
управля: управляющим
относ: относится
безжалостн: безжалостно
оо: ооо
рабств: рабство рабства рабством
всу: всу
американск: американских американского
брос: бросил
увелич: увеличилось
евраз: евразии
палат: палаты
крупн: крупными крупным
правопреемник: правопреемника
золотовалютн: золотовалютных
террористическ: террористические
бойц: бойцов
растет: растет
выпуск: выпуска
прежд: прежде
восстан: восстания
бывш: бывшими бывших бывшие бывшей бывший
стабильн: стабильность
архитектур: архитектуре
обрек: обрекая
выступа: выступала выступает выступать
демон: демонами
уничтож: уничтожить уничтоживший
прежн: прежнему
радикальн: радикальными
гегемон: гегемона
миллион: миллионы
джекоб: джекоб
захват: захватили
ри: риа
наход: находятся находится
nation: national
ctrl: ctrl
xvii: xvii
xix: xix
appl: apple
xxi: xxi
screen: screen
xvi: xvi
ivan: ivan
andrew: andrews
michael: michael
getti: getty
reuter: reuters
killnet: killnet
och: ochs
peter: peter
archiv: archive
xviii: xviii
le: le
silver: silver
imag: images
enter: enter
dmitri: dmitri
collect: collection
