жертв: жертвами куклу
нейрон: нейронов
лапш: лапшой
слух: слухи
ру: русфонд
пенс: пенсии пенсий
влиян: влияние
студентк: студентке
лев: левый
коронавирус: вариант октября
лед: лед
стат: статьи
воен: военного
самокат: самоката
обычн: обычную
отдыха: отдыхать
ввод: воробьев
рабоч: рабочих
окн: окно
ждет: ждет
стал: стала стало
кадыр: кадыров
марафон: марафон
предлага: смерть
объясн: объяснили мчс
ахмат: командир
удал: удалить
появ: лицом
отверг: отверг
намертв: намертво
работ: работу
петербург: петербурга петербурге
удар: ударах
север: квартире
вернут: вернуться
сверхзвук: сверхзвук
арх: архив
экономик: экономика
конфликт: конфликте
манхэттен: манхэттене
выряд: республику
человек: скелет
слома: сломал
перенес: малыш
взрыв: взрыва звуки
арм: армия службе армию
личност: личность
просветительск: просветительский
хасбик: хасбик
структур: структуры
суд: суда
вишн: зимней
карт: карта
х: х
сообщ: кремль
жестк: готовящемся
черномырдин: черномырдин
квартир: главы квартиру
профилактик: вакцинация
вариант: новый
мир: мир
мальчик: мальчика
укол: уколов опасен
силов: силовые
секретн: секретные
клиническ: перенес
назначен: назначения
поджег: поджег
прав: правый
визит: перенесла
девушк: девушке
скор: скорую
нажм: опечатку
уш: ушах
вперв: защититься
опас: кракен
оон: думы
дела: ревакцинация
сообщен: прокомментировали
боев: боевых
получ: получили
власт: калужские
причастн: причастность
фронт: фронте
клиник: частную
член: обществе
защ: защите
травм: детских
беремен: беременности
декабр: декабря
национальн: упоминании
малинов: русские
рук: руку
ревакцинац: укол
ужаснул: ужаснул
украин: украине
гранат: гранатой
столкнул: талантливая
прост: простых
раскр: ахмата раскрыли
традиц: традиции
детск: педофилов
выстав: выставил
прям: доминанту
лин: прямой
россиянин: избили россиянин
больн: смертельно
сосед: соседа
позиц: позиции
лих: лихих
лиц: ним
подписк: подписки
алкоголизм: алкоголизме
подруг: подругу
весен: весенний
очевидц: очевидцев
украинц: закитайщина
нов: обнаружен новой появились новых знать
обошл: елизавета
госдум: госдума госдуму госдуме
мест: месте
убежа: убежала
доминант: смысловую
ммм: ммм
андр: российской
устро: устроил устроившем
опубликова: опубликована
направлен: потери
пятилетн: пятилетняя
готовя: августа
скелет: москвы
сдела: сделать
эффективн: эффективность
видет: видеть
деактивирова: нажмите
судьб: судьбу
редк: редким
терап: терапия
переселя: украинцы
охранник: приезжают
редакциярекламаконтактыпресс: реке
лайк: лайки
денис: денис
жизн: жизни
русск: новые
чертов: вырядились
девятилетн: девятилетний
солдат: пропавших
пропа: родственниках
населен: населения
чвк: чвк
кремл: человека омикроне
самолет: самолета
несовершеннолетн: вейпов
пыта: тяжелобольным села
провал: провалилась провалился
невероятн: невероятная
летн: летнюю летнего сельхозназначения
приглас: крыма
обсужден: путин
частн: визита
проезд: проезда
подросток: подросток
вулканическ: вулканического
путешеств: путешествия
неоплат: неоплаты
сша: сша
лидер: лидеры лидер
машин: машине
молодеж: молодежи
техник: техника
изб: избил толпой
утечк: утечки
решен: решений ак
культур: культура
боеприпас: склада
русфонд: следует
почк: армии
лнр: лнр
личн: личные
нужн: нужна
букв: последняя
смерт: клиническую
помоч: помочь
подряд: подряд
помога: ру
вылож: выложившего
помощ: помощь
генсек: генсеков
земел: оборот
врач: врачей врач
протон: протонная
результат: результат
скандал: скандалу
крошк: крошку
умира: минут
экскурс: экскурсий
склад: уничтожении
выигра: выиграет
отчаян: продать
христианск: христианского
опасн: опасности
обнаруж: впервые
ловушк: ловушке
документ: документы документов
летчик: летчик
будущ: будущих
маврод: мавроди
нежелан: нежелании
отнима: отнимают
елизавет: дети
повестк: повестки
грустн: отвлечься
жен: жене
штраф: штрафах увеличении
средств: нехватка
дан: данные
вейп: штрафов
пожар: пожар
спецпроект: спецпроекты
вэф: участия
раскрыт: раскрыты
закон: закон законов
толп: клуба
рост: росте
казн: казни
росс: изменили россии россия
донбасс: донбасса
обследован: обследования
таксист: таксист
гиперзвуков: гиперзвуковой
мотор: мотор
убед: болгарии
кот: котами
ситуац: оон ситуацию
числен: увеличить
пожалова: добро
пассажирк: пассажирку
цикл: цикла
счита: считал
отсутств: убедиться
миноборон: минобороны
мужик: мужики
очк: очков
лент: лента ленту
предлож: заэс
спасет: спасет
звук: власти звука
опечатк: ооо
галер: галереи
диван: сон
оцен: оценили оценил
мух: муху
выходн: выходные
сельхозназначен: земель
российск: российский российском численность
дво: двоих
восток: дальний
вмест: вместо
алфавит: буква
соцреклам: соцрекламе
увидел: увидели
обнов: обновила
настроен: преобладающее
серьезн: столкнулась
разработа: вины
жил: жилья
ворва: ворвался
продолжен: громкие
пушилин: пушилин
прыга: прыгать
отчита: отчиталось
путин: путина несовершеннолетним
медиа: медианная
кукл: тряпичную
офицер: офицера
спрята: спрятаться
повернул: повернулась
изнасилова: изнасиловать
ссср: ссср
ввест: предлагала
рэп: запретить
посылк: прислали
минут: обошлись
педофил: жертвы
след: продолжение
дел: деле
ночн: охранники
мишустин: мишустин
афоризм: афоризмы
рассказа: рассказали рассказал
снежн: снежной
концепц: целостную
кавказ: кавказе
попыта: попытался
параллельмо: параллельмоя
переход: перехода
ответ: спч
гадалк: мошенники
москв: москвой москве севере
обществ: настроение общество
преступник: национальности
срок: сроки
электричк: электрички
концерт: рэп
белгород: белгороде
бак: баке
измен: изменится пиджаках
держа: держала
дверьм: дверьми
перенесл: солдат
изнасилован: изнасилования
дет: детей чертовы детям
август: вэф
назва: сгорели названо назвал
материал: материалы
слыша: слышали
конкурс: конкурса
внесл: внесли
целостн: разработали
заложник: заложниках
лечен: лечения
мчс: диване
стрельб: стрельбу
употреблен: употребления
служб: подготовке
ак: вити
кита: китаем
навальн: состояния
спорт: спорт
выпа: выпал
зажат: зажаты
мысл: грустных
сад: садятся
кредит: кредита
последн: последние выбрать
заявлен: жестком
зна: знаем
месяц: месяца
услов: условиях
стро: восток
захотел: захотели
жми: жми
штамм: коронавирус новом
вруча: вручать
голода: голодали
закр: закрыли
крак: коронавируса
школ: школе
бо: ходе
рассказыва: рассказывают
тяжелобольн: помогают
главн: главное главного
действ: действий
полет: полета
нашл: нашли
женщин: женщин
привел: привели
взросл: травмах
октябр: украинской
афер: аферу
приезжа: беженцы
насмерт: насмерть
пасх: пасха
втянул: втянула
состоян: ухудшении
вер: верили
арматур: арматурой
популярн: популярных
коллектор: коллектор
соцсет: соцсетях
мужчин: мужчин
смертельн: смертельной средств
стака: стакан
област: области
тряпичн: похожа
одноклассник: одноклассники
созда: пытались
пентагон: пентагона
сво: сво
преоблада: песков
пациент: пациенты
фортун: фортуна
посольств: преступников
станов: становятся
лежа: захар
интернет: интернет
россия: россиян
прода: остается
скинул: скинули
рекорд: рекорд
виктор: виктор
появлен: появлении
всеобществополитикапроисшествиярегионымоскв: всеобществополитикапроисшествиярегионымосква
уклонист: уклонистам
тел: глаза
воева: воевать
применя: применять
пришл: пришлось
полн: полной
знат: алфавита
утонул: утонул
бел: белого белый
знан: знание
уничтожен: артемовске
происход: происходит
задач: задачу
беженц: больные
запрет: кадырову предложили
ценност: ценности
долж: должен
подразделен: подразделениям
вызва: вызвала
норм: нормы
харьковск: харьковской
вин: чувством чьей
истор: история
зажа: зажало
довер: доверия
ход: направлениях
трасс: трассе
вит: концерта
праздник: праздника
клуб: ночного
петербуржец: петербуржец
шут: шут
сел: строили
сем: рождаемости
кондуктор: кондуктор
сер: серию
выпаден: выпадение
мечет: мечети
вид: видом
представител: представителей
мошенник: транс
виде: видео
захар: маше
защит: профилактика
днр: днр
ноябр: аннексии
ищут: ищут
оста: остался почку
эксперт: клинику эксперты
депутат: депутата
наук: наука
виновн: виновных
дне: дней
крыш: крыше
рождаем: поддержки
поправк: поправки
упоминан: запрет
реш: решил решили
известн: известно
международн: международных
нажива: гадалки
крым: глава
сбил: сбил
пригожин: пригожин
сид: сидим
перечисл: перечислили
поддержк: мер
зада: задал
обитан: обитания
недел: неделю
пройдет: пройдет
тысяч: тысячи
рек: сплава
родственник: наживаются
хорош: хорошая хорошие
стоимост: стоимость
ид: идеи
чуш: чушью
защищ: защищаясь
сред: среда
оборот: вводе
обвинен: обвинения
погиба: погибают
улучш: улучшили
республик: создать
чувств: взрослой
мног: многие
школьник: школьников школьникам летний
люб: любил
калужск: семей
закат: лежал
похуден: похудения
язык: язык
умн: умных
умр: умру
возрожден: возрождения
автобус: автобуса
фармацевт: фармацевтов
гроз: грозит
нат: нато
насил: насилия
информац: редакциярекламаконтактыпресс
призыв: призыва
кадыров: ответила
транс: ввести
письм: письма
дожд: дождь дождя
прокомментирова: кремле
мусорн: мусорном
россиян: россияне россиянам
пиджак: малиновых
ижевск: ижевском
вороб: андрей
вакцин: какую
девочк: девочка
упа: упавшего
маш: болезнью
малыш: холодным
дожда: дождавшись
подготовк: концепцию
россиянок: россиянок
продаж: продажу
отвлеч: пытаюсь
правил: правилах
омикрон: штамме
живут: живут
приз: призыв
увеличен: боеприпасами
забот: забота
пив: пива
президент: пригласил
сми: сми
убива: убивают
огромн: огромной
аннекс: отсутствии
сплав: школьник
ма: мая
музык: музыки
апрел: апреля
россиянк: россиянку россиянка россиянки
смыслов: эксперт
ми: ми
стран: страна страну
аренд: аренды
участ: сообщил
отлич: отличие
сгорел: вишне
финалист: финалисты
регион: регионе
громк: объяснило громкой
пьян: пьяный
ухудшен: сообщения
испытан: испытании
март: марта
песн: песни
войт: войти
песк: ноября
патруш: патрушев
глав: линии навального
глаз: глазами закатив
кост: посылку
испытател: испытатель
нехватк: отчаяние
дум: заявлении
холодн: тело
лимфом: лимфомы
заяв: заявил
четвероклассник: четвероклассник
болезн: серьезной болезни
скажут: скажут
украинск: раскрыл украинского
похож: взрывов
подростк: подростке
маркировк: маркировка
ракет: ракеты
издева: издеваться
вакцинац: штаммы
шариат: шариата
хлеб: хлеба
новост: новости
корол: король
анархист: анархистами
перв: первые
орган: органов
командир: костями
присла: франции
приня: приняла
добр: деактивирована добра
талантлив: мыслей
оо: информация
возможн: возможность
индексац: индексация
дальн: переселялись
всу: всу
франц: посольство
запомн: запомнила
брос: бросил
выбра: вакцину
увелич: решение
пепл: пепла
сон: россиянина
болгар: президента
участник: участникам
как: какие делать
отставн: отставного
сот: сотен
заэс: ситуации
зимн: вине
пораз: поразила
чье: умираем
тюрьм: тюрьму
выпуск: выпуска
закитайщин: россию
род: родившие родился
бывш: бывший бывшей
реальн: пожаловать
ребенк: ребенка
артемовск: боев
алкогол: алкоголя
откр: открыли
миллион: миллионы миллионам
кпрф: кпрф
июл: июля
мер: обсуждении
спч: член
потер: назвало
погиб: погиб
слуша: слушавшего
ii: ii
covid: covid
killnet: killnet
ctrl: ctrl
appl: apple
enter: enter
