ру: ру
стат: стать статьи
воен: военным военно военными военного военные военных военный военной
обычн: обычную
оказа: оказался
европейск: европейских
стал: стала стало
мнен: мнению
составлен: составления
метеорологическ: метеорологический метеорологические
указан: указанию
объясн: объяснили
последств: последствиях
завис: завис
реагирова: реагировать реагировала
проблематик: проблематики
дополнительн: дополнительного
арх: архив
экономик: экономика
килограмм: килограммов
пол: полях
сто: стоит
манхэттен: манхэттене
основан: основания
аэростат: аэростатом аэростаты аэростат аэростата аэростатов аэростате аэростатами
индонезийск: индонезийском
лет: летия
неспособн: неспособность
ветр: ветра
вооружен: вооруженных
макияж: макияжа
разговор: разговоре
то: той
самодостаточн: самодостаточный
должн: должна
структур: структуры
готовн: готовность
карт: карт
шар: шаров шары шарами шар шаром шара шаре
беспокойств: беспокойство
жестк: жестко
котор: которую
денег: денег
провест: провести
дискуссион: дискуссионного
силов: силовые
осен: осени
секретн: секретные
шаг: шагом
прав: право
связа: связанных связанные
кассет: кассете
визит: визита
отмет: отметил
внезапн: внезапно
связ: связь связи
совместн: совместно
отмен: отмену
заб: забыть
нло: нло
располож: расположился
член: член
фу: фу
байд: байден байдена
уоллесминистр: уоллесминистр
беремен: беременная
комментиру: комментируя
прост: простых
врем: времена
позвол: позволить
россиянин: россиянин
обвиня: обвиняли
сосед: соседа
проверк: проверке
справ: справа
вред: вред
занима: занимался
разгром: разгромили
встреч: встречи встрече
родин: родины
встрет: встретился
уровен: уровень
нов: новой
конгресс: конгресса
внешн: внешне
част: частью
алекс: алексей
слов: словам
цк: цк
одновремен: одновременно
якоб: якобы
предположительн: предположительно
сдела: сделать сделаны сделанный
феном: феномена
внимательн: внимательнее
определен: определения
деактивирова: деактивирована
министерств: министерстве министерство
пут: путем
активн: активность активности
терпет: терпеть
систем: система системы системой
самолет: самолетом
пленк: пленки
пекин: пекин
государствен: государственного государственный
летн: летней
пересматрива: пересматривать
торгов: торговые
путешеств: путешествия
лета: летающим летающих летающими
обрабатыва: обрабатывают
курс: курса
бесед: беседе
текущ: текущий
пролета: пролетали пролетает
облада: обладающей
сша: сша
лидер: лидеров лидер
метод: методы
групп: группу группы
техник: техника
доказательств: доказательств
вэньбин: вэньбинь
хотел: хотели хотел
культур: культура
лнр: лнр
продолжа: продолжать
марджор: марджори
помощ: помощью
врач: врач
напряжен: напряженности
попытк: попытка
ведомств: ведомство
выигра: выиграть
усомн: усомнились
макроэкономическ: макроэкономический макроэкономическом
будущ: будущее
желан: желания
прекрат: прекратить прекратились
экзам: экзамен
зонд: зондов зондах зонда зонд зондом зонды
опасен: опасения
нус: нуса
фугасн: фугасную
потребова: потребовалось
отключ: отключены
спецпроект: спецпроекты
протяжен: протяжении
генера: генерал
плох: плохо
взаимн: взаимно
росс: россии россия россией
фбр: фбр
четырех: четырех
энтон: энтони
мотор: мотор
допуст: допустили допустил
убед: убедили
ситуац: ситуацию ситуация
счита: считают
отсутств: отсутствует
тума: туманное
причин: причиной причинах
конкурент: конкурентам
рычаг: рычагом
утвержден: утверждения
возмущен: возмущение
цел: целый целей целых цели
лент: ленту ленты лентой лента
середин: середины
мирн: мирным
очерня: очернять
финансирован: финансирования
опечатк: опечатку
канад: канадой канады
эл: элит
всеполитикаобществопроисшествияконфликтыпреступн: всеполитикаобществопроисшествияконфликтыпреступность
взаимодейств: взаимодействие взаимодействии
политическ: политических
директор: директор
администрац: администрацию
иностра: иностранным иностранных иностранного
поездк: поездка
завершен: завершенной
пятер: пятеро
частност: частности
серьезн: серьезно
использова: использовали
африк: африки
желез: железа
разведывательн: разведывательной разведывательный
установл: установлено
закономерн: закономерно
завер: заверили
ссср: ссср
комисс: комиссию комиссии
напомн: напомнив
институт: института
разведда: разведданных
подстрека: подстрекать
отслежива: отслеживали отслеживать
так: таких таки
воздушн: воздушного воздушных воздушные воздушном воздушный воздушным воздушное
нормальн: нормальной
досягаем: досягаемости
уязвим: уязвимы
событ: событий
ломоносов: ломоносова
баз: баз
бал: бали
усилен: усиление
блогерш: блогерши
назва: назвать назвали назвал
товар: товары
собира: собирают
некотор: некоторые
диаметр: диаметром
застав: заставили заставил
океан: океане океаном
отряд: отряда
сложносочинен: сложносочиненной
попа: попавших
каролин: каролина каролиной каролины
остава: оставаться
спорт: спорт
специальн: специальные специальной
услов: условиях
друг: другими друг друга
зон: зоне
приход: приходится
восстанов: восстановить
водород: водородом
сбор: сбору
окрест: окрестили
запущ: запущен
компан: компаний
программ: программе
главн: главное главным
полет: полетах
действ: действиях
пят: пятью
аляск: аляской
низк: низкими
наруша: нарушали
зажигательн: зажигательных
октябр: октября
обострен: обострение
блинкенгосударствен: блинкенгосударственный
стратегическ: стратегическим
инициатив: инициативу
запланирова: запланированного
использ: используют
изуч: изучить
созда: создали создала создать
улад: уладить
атлантическ: атлантическим атлантическом
ран: ранее
нараст: нарастить
протест: протест
передач: передачи
блинк: блинкена блинкен
интернет: интернет
промедлен: промедление
пониз: понизил
урегулирова: урегулировать
побереж: побережья
наращиван: наращивании
официальн: официальный
великобритан: великобритании
пришл: пришлось
взглянут: взглянуть
бел: белом белого белый
десят: десяти
бен: бен
выстраива: выстраивает
конспирологическ: конспирологических
штат: штаты штатом штате штатов
комментар: комментарии
рамк: рамках
запущен: запущенных
адрес: адрес
нанесен: нанесения
репресс: репрессий
долж: должен
вызва: вызвала вызвали вызвало
оставля: оставляет
гурон: гурон
числ: число
гражда: граждан
период: период
подозрева: подозреваемого
клуб: клуба
вниман: внимания
сотруднича: сотрудничать
очеред: очередь
виде: видео
положен: положение
президентск: президентских
быстр: быстро
эксперт: эксперт
осложня: осложняло
уточн: уточнив
инцидент: инциденты инцидента инцидент инцидентом
тих: тихого
моряк: моряки
реш: решили решить
лаборатор: лабораторий
сбит: сбить сбитый сбитого сбит сбитых
международн: международные международной
видеооборудован: видеооборудованием
общ: общей
гражданск: гражданскими гражданским
глен: глен
сбил: сбили
пригожин: пригожин
обитан: обитания
недел: недели
обе: обеих обеим
масловдиректор: масловдиректор
обм: обмен
осколочн: осколочно
удобн: удобным
сред: среда
налаживан: налаживанию
погибл: погибли
мног: многих
люб: любые
бич: бич
похуден: похудения
контакт: контактов
язык: язык
фон: фоне
обеспокоен: обеспокоенность
пилот: пилот
фот: фото
управляем: управляемы
разн: разные
соседн: соседние
люд: людей
акватор: акваторией
неконструктивн: неконструктивность
топографическ: топографических
огн: огни
год: годы
конкретн: конкретные
министр: министров министр
комитет: комитета
применен: применением
удовлетвор: удовлетворило
обостр: обострились обострила
трамп: трамп
вывод: выводы
волн: волну волнующий
постара: постарается
одн: одним одно
продаж: продажу
широк: широкой
пляж: пляже
наблюден: наблюдения
потребн: потребность
свидетельств: свидетельство
масл: маслов
апрел: апрель апреля
находя: находящиеся
десятк: десятки
использован: использование
снаруж: снаружи
регион: регион регионе
подозрительн: подозрительные
войн: войны
март: марта
испытан: испытании
войт: войти
спровоцирова: спровоцировал
глав: главой
сраз: сразу
производ: производит
уоллес: уоллес
холодн: холодной
болезн: болезни
канцеляр: канцелярии
половин: половине
двусторон: двустороннем двусторонним двусторонних
сидзуок: сидзуоко
ракет: ракеты
пишет: пишет
комер: комер
вполн: вполне
отклон: отклонился
республиканск: республиканской
университет: университетов
новост: новости
существ: существуют
перв: первого
извиня: извиняться
упрекнул: упрекнули
шпионск: шпионский шпионские шпионских шпионском шпионской шпионским
мгу: мгу
добр: добро добра
джеймс: джеймс
раскручиван: раскручивание
мед: медиа
шест: шести
префектур: префектуре
противореч: противоречий
вылетевш: вылетевший
повлия: повлияли
переговор: переговоры
высок: высоком высокого высоких
критик: критики критикуют
реальн: реальный
рекордн: рекордно
рол: роль
высот: высоте
риск: риска
точк: точки
партнер: партнерам
сфер: сфера сферу
любительск: любительский
шпион: шпионов
разведк: разведки
мер: меры
конференц: конференции
бюджетн: бюджетных
инопланетян: инопланетянами
защищен: защищенности
влиян: влияние
студентк: студентке
коронавирус: коронавируса
независим: независимая
вызов: вызовом
предлага: предлагал
электроник: электронику
призва: призвало призвал призвали
случа: случаю
удал: удалить
удар: ударили
вернут: вернуться
мид: мид
подчеркнул: подчеркнул подчеркнула
спекуляц: спекуляции
послед: последующие
санкц: санкции
личност: личность
шаров: шаровой
показа: показать
екатерин: екатерина
ничт: ничто
счит: считая
тейлор: тейлор
мюнхенск: мюнхенской
мир: мир мире
укол: уколов
писа: писало
недопустим: недопустимая
внешност: внешности
безопасн: безопасности
вагнер: вагнер
скор: скорее
нажм: нажмите
резк: резко
феврал: февраля феврале
выраз: выразило выразили выразил
сообщен: сообщения сообщений
власт: власти властей
получ: получил получить
происхожден: происхождении происхождение
фронт: фронте
важн: важную
провел: провел
дистанц: дистанцию
резюмирова: резюмировал
экономическ: экономические
украин: украине украины
гранат: гранатой
метр: метра метров
внутр: внутри
уникал: уникален
раскр: раскрыли
издан: издание
выстав: выставил
континентальн: континентальной
позиц: позиции
могл: могли
республиканц: республиканцев
истребител: истребитель истребителем
повышен: повышенного
кстат: кстати
больш: большим большого
ответн: ответной
китайск: китайский китайском китайская китайских китайской китайскую китайского китайское китайским
потенциа: потенциала
послан: послание
предполож: предположил
инженер: инженеров
вход: входят
фестивал: фестивале
дональд: дональд
эффективн: эффективности эффективность эффективные
видет: видеть
смогл: смогли
редк: редко
испытыва: испытывали
извлечен: извлеченные
редакциярекламаконтактыпресс: редакциярекламаконтактыпресс
вспомн: вспомнить
представлен: представлениям
жизн: жизни
жан: жан
кит: китая
зашедш: зашедшей
формальн: формально
чвк: чвк
тайваньск: тайваньскую
мог: могу
пыта: пытается
провал: провалились
отм: отмена
поссор: поссорили
американц: американцы американцам американцев
момент: момент момента
обсужден: обсуждении
развива: развиваются
патрик: патрик
вэньбиньофициальн: вэньбиньофициальный
утечк: утечке утечки
решен: решение решения решением
боеприпас: боеприпасов
удив: удивились удивил
провод: проводить
личн: личные
неопозна: неопознанных неопознанные
нужн: нужна
устаревш: устаревшая
советск: советским советское
тайван: тайваня
меня: меняется
мощ: мощь
вылож: выложившего
разведдеятельн: разведдеятельностью разведдеятельности
ввел: ввели
результат: результате
вызыва: вызывать
объективн: объективно
банковск: банковская
продвинут: продвинутые
красив: красиво
обнаруж: обнаружили
дрейф: дрейфующим
дал: дало
документ: документы документов
преддвер: преддверии
агент: агенты
расследован: расследованию
кнр: кнр
дан: данные
андреев: андреева
имен: имени
состоя: состоялся
хубэ: хубэй
раскрыт: раскрыты
народн: народной
раздуван: раздувание
гиперзвуков: гиперзвуковой
пожалова: пожаловать
соединен: соединенных соединенные
устранен: устранения устранение
канадск: канадской
камер: камеру
отказа: отказался
очк: очков
провинц: провинция
кпк: кпк
неуправля: неуправляемый
дипломат: дипломат
галер: галереи
границ: границе
оцен: оценили оценил
проявля: проявляют
незакон: незаконно
сохран: сохранить
глобальн: глобальной глобальными
остров: островов острове
политик: политики политике политику
финансов: финансовая финансовой
ошибк: ошибке
извинен: извинений
тупик: тупик
обнов: обновила
правительств: правительство
объект: объекта объектах объектов объект объектом объектами объекты
паден: падения
жил: жилья
солиру: солируя
ван: ван
спутник: спутники
худш: худшую
наступлен: наступлении
незначительн: незначительным
медиа: медианная
итог: итоге итоги
таинствен: таинственный
стольк: столько
карин: карин
дел: делам дела
вопрос: вопросу вопросы вопрос вопросов
игра: играет
внутрен: внутренние
отреагир: отреагирует
озер: озером
ваш: вашей
ответ: ответ
обществ: общества
пространств: пространство пространства пространстве
несмотр: несмотря
срок: сроки
собствен: собственности собственных
джо: джо
следств: следствием
японск: японской
держа: держать
территор: территорию территорией территории
валда: валдай
уда: удалось
дет: детей
неотъемлем: неотъемлемой
снимк: снимков
материал: материалы материале
поднима: поднимают
подчиня: подчиняться
передов: передовым
отношен: отношений отношения отношениям отношениях отношении
отреагирова: отреагировал
аз: азии
турц: турции
кита: китаю китае китаем китай
услыша: услышал
ввс: ввс
реабилитирова: реабилитироваться
ряд: ряд
последн: последнего последние
манер: манере
заявлен: заявлений
охотн: охотно
поддержан: поддержании
разведтехнолог: разведтехнологий
захотел: захотел
жми: жми
японц: японцы
оснаст: оснастили
бо: боимся
подобн: подобные подобное
называ: называли
алеутск: алеутских
вероятн: вероятно
давлен: давления
ира: иран
нашл: нашли
женщин: женщина
пресс: пресс прессе
достигл: достигли
век: века веке
предполага: предполагалось
стандарт: стандартам
очередн: очередной
вес: весом
популярн: популярнее популярных популярные
вмешательств: вмешательстве
сотрудничеств: сотрудничеству
смертельн: смертельной
усугуб: усугубили
иса: исаа
пентагон: пентагоне пентагона пентагон
нача: начали
оруж: оружие
го: го
парт: партии
пообеща: пообещал
пошатнут: пошатнуть
рекорд: рекорд
возникл: возникло
явля: являются
груз: груза
помер: померились
развит: развитием развитие
первичн: первичное
представ: представить
нанес: нанесен
резонанс: резонанс
херк: херк
уничтожен: уничтоженных уничтожение
технолог: технологиями технологий технология технологии
ду: дуа
зеленск: зеленского
трех: трех
орегон: орегон
хвата: хватало
прилетел: прилетел
континент: континентами
ценност: ценности
пар: парит
виз: визит
задума: задумались задуматься
пьер: пьер
океа: океана
зрен: зрения
клевета: клеветать
двум: двумя
праздник: праздника
гонк: гонка
летательн: летательные
пробл: проблему проблем
факт: факт
голливудск: голливудской
биологическ: биологическое
представител: представителем представитель представителей
вид: видит видим
сет: сетью сети
защит: защиты
межведомствен: межведомственную
теор: теорий
нескольк: нескольких
повтор: повторил
наук: наука
пережива: переживают
пво: пво
миртл: миртл
дне: дней
урон: урон
избыточн: избыточным
эпох: эпоху
неоднократн: неоднократно
рейтинг: рейтинги
дом: доме дом дома
способн: способности
известн: известно
сторон: стороны сторону сторона сторонам
указыва: указывает
смотр: смотрит
предостав: предоставили
поддержк: поддержки поддержку
обезвреживан: обезвреживанию
призна: признать
раздува: раздувать
тысяч: тысячи
претенз: претензиях
доб: добилась добиться добился
хорош: хорошую хорошие
стоимост: стоимостью стоимость
защищ: защищены
наш: нашей нашу
обвинен: обвинения обвинений
оборон: обороны
слабост: слабости слабость
республик: республики
выгод: выгоден
нашеств: нашествии
сил: силы сила сил силам
умн: умных
план: плане
доллар: долларов
арестова: арестовало
понижен: понижение
держав: державой
эпизод: эпизодом
нат: нато
информац: информация
выгодн: выгодный
поставля: поставлять поставляет
негативн: негативное
анализ: анализа анализ
замет: заметили
противник: противником
паник: панику
граждан: граждане
посетова: посетовал
идет: идет
например: например
коллег: коллеги
миров: мировых мировую мировой
забот: забота
райдер: райдер
запуст: запустили
секретар: секретарь секретаря
президент: президент президента
председател: председатель
сми: сми
огромн: огромный
америка: американо
музык: музыки
ответствен: ответственность
пролетевш: пролетевший
стран: странами странах страны стран странно страной
аренд: аренды
январ: января
отлич: отличие
уровн: уровне
громк: громкой
южн: южной южная
сист: систем
неб: небо небе
углублен: углубленного
япон: японии япония
внеземн: внеземным внеземное внеземную
сбива: сбивать
качеств: качества качестве
выбор: выборов
исходя: исходящих
государств: государства государствами
бомб: бомбу бомбы
утрат: утратили
проблем: проблемы
обнаружен: обнаружении обнаруженный обнаруженные
исключ: исключил
заяв: заявило заявил заявили заявила
намн: намного
угроз: угрозы угрозу угрозами угроз
лучш: лучшие
истер: истерии
нанест: нанести
небольш: небольшую
операц: операцией операции
монта: монтана
оо: ооо
возможн: возможность возможно
политолог: политолог
всу: всу
американск: американскими американскую американской американском американские американских американская американский американским американского
брос: бросил
грин: грин
учитыв: учитывая
направ: направили
палат: палаты
перенос: переносить переносили
крупн: крупнейшей
взгляд: взгляд
бойц: бойцов
выпуск: выпуска
отрицательн: отрицательный
прежд: прежде
бывш: бывший
бытов: бытовые
стабильн: стабильности
круг: кругах
надзор: надзору
ухан: ухане уханя
уничтож: уничтожили
уругва: уругвае
гегемон: гегемонию
июл: июля
наход: находиться находились
озвучива: озвучивали
никак: никак
влеза: влезать
вто: вто
xx: xx
ryan: ryan
dick: dick
ctrl: ctrl
appl: apple
stefani: stefani
forc: force
american: american
air: air
navi: navy
xviii: xviii
mobi: moby
enter: enter
depart: department
guardian: guardian
vice: vice
reynold: reynolds
defens: defense
chad: chad
seelbach: seelbach
pool: pool
photo: photo
fbi: fbi
ap: ap
reuter: reuters
killnet: killnet
fish: fish
