обрат: обратилась
нейрон: нейронов
максимальн: максимально
косторн: косторная
говор: говорили
ру: ру
влиян: влияние
студентк: студентке
занят: занятия занятий
стат: статьи
рпл: рпл
лез: лез
обычн: обычную
европейск: европейский
оказа: оказался
окн: окна
стал: стали стала стало
марафон: марафон
удал: удалить
став: ставила
двалишв: двалишвили
работ: работу
вернут: вернуться
йорк: йорк
возглав: возглавить
арх: архив
конг: конга
экономик: экономика
утрен: утренними
четверт: четвертой
принос: приносит
александр: александр александра
купальник: купальники
лет: летом
й: й
фигурн: фигурному фигурном
дыхательн: дыхательной
преврат: превратили
о: ои
личност: личность
хасбик: хасбик
ошибок: ошибок
структур: структуры
четвертьфинал: четвертьфинале
одиночн: одиночной
сезон: сезона
звезд: звезда звездой
валиев: валиева валиевой
карл: карло
звездн: звездный
мир: мир
укол: уколов
гашек: гашек
силов: силовые
секретн: секретные
эксперимент: эксперимент
напада: нападающего
хабиб: хабиб
организатор: организаторы
нажм: нажмите
лиг: лигу лиге лига лиги
дебютн: дебютного
конец: конец
вперв: впервые
феврал: февраля
пекл: пекло
всефутболанглийск: всефутболанглийский
драк: драку
получ: получил получить
фронт: фронте
киевск: киевского
озвуч: озвучены
травм: травм травмы
псж: псж
беремен: беременности
рук: рук
час: часов
украин: украине
гранат: гранатой
махач: махачев
раскр: раскрыли раскрыт
шанс: шанс
выстав: выставил
россиянин: россиянин
рубл: рублев рубл
зал: зале
сосед: соседа
чешск: чешский
занима: заниматься
отек: отеками
разгром: разгромил
американк: американка
повышен: повышения
мма: мма
нов: новый новой
раздевалк: раздевалке
ног: ног
месс: месси
счет: счетом
рфс: рфс
андр: андрей
кин: кино
опубликова: опубликован
футболбокс: футболбокс
карьер: карьеру карьеры
журна: журнал
слов: словом
гонщик: гонщик
расизм: расизме
полезн: полезными
босик: босиком
сдела: сделать
выдава: выдавал
эффективн: эффективность эффективное эффективных эффективные
видет: видеть
гран: гран
калгар: калгари
деактивирова: деактивирована
плющенк: плющенко
редакциярекламаконтактыпресс: редакциярекламаконтактыпресс
любител: любителям
вырез: вырезов
кардиотренировк: кардиотренировки
нос: носить
жизн: жизни
футболист: футболиста футболист футболисту
воспитанник: воспитанник
волкановск: волкановски
коламбус: коламбус
нокаутирова: нокаутировал
выход: выход
юнайтед: юнайтед
мод: мода
лиценз: лицензию
уингз: уингз
провал: провалился
летн: летняя
спортивн: спортивный спортивные
накача: накачать
приглас: пригласил
основн: основные
раунд: раунде
путешеств: путешествия
рейнджерс: рейнджерс
шо: шоу
сможет: сможет
сша: сша
лидер: лидер
плюющ: плюющих
техник: техника
утечк: утечки
европ: европе европы
фина: финала финал
культур: культура
прощальн: прощальном
удив: удивившую
личн: личные личной
зен: зените
домашн: домашних
советск: советского
мэйпл: мэйпл
секрет: секрет
меня: менялась менять
вылож: выложившего
нрав: нравится
молдавск: молдавского
убира: убирайся
врач: врач
чемпионк: чемпионкам
выполня: выполнять
результат: результата
здоров: здоровье
командн: командном
опасн: опасностях
офф: офф
дал: дали
мышц: мышцы
фанат: фаната
упражнен: упражнения упражнениях упражнение
зенит: зенита
документ: документы документов
будущ: будущее будущих будущем
тарасов: тарасовой тарасова
желан: желании
чек: чек
нежелан: нежелании
глуп: глупом
нурмагомед: нурмагомедов
мск: мск
экстрема: экстремала
олимпиад: олимпиада олимпиады
агент: агент
жен: женился
дан: даниил данные
джекетс: джекетс
евр: евро
поветкин: поветкин
борьб: борьбы
установ: установил
дат: дата
въезд: въезд
спецпроект: спецпроекты
раскрыт: раскрыты
сустав: суставов
триатлон: триатлона
видылетн: видылетние
росс: россии россия россию
американец: американец
прыжок: прыжок
спортсмен: спортсменов
лифс: лифс
гиперзвуков: гиперзвуковой
мотор: мотор
зим: зимой
ситуац: ситуацию
пожалова: пожаловался пожаловать
тренер: тренера тренером тренер
пенальт: пенальти
скупа: скупать
роналд: роналду
вегас: вегасе
брат: брата
очк: очков
лент: лента ленту
нхл: нхл
ягудин: ягудина
турнир: турнир турнира турнирах турнире
каприз: капризов
опечатк: опечатку
канад: канады
пройд: пройдя
галер: галереи
оцен: оценили оценил оценила
питтсбург: питтсбург
российск: российских российского российские российский российскому
дво: двоим
крем: крем
сохран: сохранить
костомаров: костомарову костомарова
уход: уходе
развяза: развязавшего
ошибк: ошибках
фигуристк: фигуристка
пощечин: пощечин
иностра: иностранных
хет: хет
всяк: всякий
завершен: завершении
жил: жилье
возвращен: возвращении
руководств: руководство
адреналин: адреналин
путин: путине
защитник: защитником
легкоатлет: легкоатлет
фигурист: фигуристов фигуристы фигуристом
минск: минском
список: список
кричалк: кричалки
отстранен: отстранение
ссср: ссср
слез: слезы
произошл: произошла
яд: яд
след: следующего
шаманк: шаманка
вопрос: вопрос
рассказа: рассказал
тамп: тампа
ян: ян
игра: играли
емельяненк: емельяненко
заверш: завершен
мбапп: мбаппе
проигра: проигравшего проиграл
простуд: простуды
ответ: ответил ответ
москв: москве
титул: титул
усик: усика
срок: сроки
собствен: собственных
третьяк: третьяк
переписк: переписки
завидова: завидовать
мощн: мощные
британск: британский
лыжник: лыжников
дет: детей
назва: названо назвал назвала назвали
суицид: суициде
смен: сменился
лионел: лионель
отреагирова: отреагировал
хачан: хачанов
ал: аль алена
аэропорт: аэропорту
жесток: жестокий
попа: попался
кита: китаем
бар: бара
спорт: спортом спорт
выпа: выпала
четвертьфина: четвертьфинал четвертьфинала
мысл: мысли
последн: последние
услов: условиях
сам: самое самая самых
стереотип: стереотип стереотипе
жми: жми
бегун: бегуньи
правильн: правильно
ошибочн: ошибочным
барселон: барселоны
бо: бою боя
уайт: уайт
главн: главным главных главное главного главный
фьюр: фьюри
нашл: нашли
бэ: бэй
женщин: женщину
трик: трик
пресс: пресс
кхл: кхл
фиф: фифа
фитнес: фитнес
вяльб: вяльбе
насмерт: насмерть
бавар: баварии баварию
очередн: очередной
ирландск: ирландский
увол: уволил уволить
состоян: состояние
игрок: игрок игрока
обтягива: обтягивающее
популярн: популярных популярной
поражен: поражения
поединк: поединка
величайш: величайших
смертельн: смертельной
мужчин: мужчина
бразильск: бразильский
отозва: отозвал
волейболистк: волейболистка
чемпионат: чемпионат чемпионатом
ждавш: ждавшего
созда: создал создать
авиакатастроф: авиакатастрофа
мучительн: мучительная
пентагон: пентагона
спин: спину спины
сво: свой
уеха: уехать
реша: решающий
кипр: кипре
слаб: слабые
станов: становятся
интернет: интернет
россия: россиян
тест: теста
парт: партии
нью: нью
сибир: сибирь
аргентинец: аргентинец
рекорд: рекорд рекорды
олимпийск: олимпийским
захаря: захарян
вещ: вещь
выступлен: выступление
законч: закончил
физиолог: физиолог
пришл: пришлось
легенд: легенду
переж: пережившему
дэйн: дэйна
гражданств: гражданство
груд: груди
ценз: ценза
детройт: детройт
продолж: продолжить
происход: происходит
трет: третьей
призов: призовых
работа: работать
запрет: запретили запрет
алкоголик: алкоголиками
ценност: ценности
влиятельн: влиятельных
дзюб: дзюбы
гимнастик: гимнастики
бег: бег
задума: задумал
высказа: высказался
кинг: кинг
истор: истории история
абаскал: абаскаль
манчестер: манчестер
гагарин: гагарина
модел: модель
нейтральн: нейтральным
клуб: клуба клуб
челс: челси
тренировк: тренировках
флаг: флагом
курортн: курортной
уйт: уйти
сет: сет
представител: представителей
виде: видео
заставля: заставляет
защит: защитил
наимен: наименее
посоветова: посоветовали
реа: реал
кубк: кубка
ред: ред
нескольк: нескольких
краснодар: краснодара
наук: наука
вышел: вышел
совмеща: совмещать
малкин: малкина
инцидент: инцидентом
поднят: поднятие
альтернативн: альтернативную
дом: домой
поддержа: поддержала поддержали
известн: известна известно известны
международн: международный международном международной
сторон: стороны
тренажерн: тренажерном
видыхоккейавтоолимпиадазож: видыхоккейавтоолимпиадазож
хорон: хоронили
смотр: смотрите
обитан: обитания
призна: признал
федор: федор
включ: включил включили
хорош: хорошие
лайтнинг: лайтнинг
повод: поводы
медведев: медведева
азиатск: азиатские
сред: среда
вынослив: выносливости
соста: состав
жажд: жажда
бегств: бегство
обвинен: обвинения
улучш: улучшили
пингвинз: пингвинз
погибл: погибли
просьб: просьбах
сыгра: сыграл
итальянск: итальянская
наср: насра наср
стройн: стройных
похуден: похудения
принес: принес
язык: язык
избежа: избежать
умн: умных
обяза: обязала
снял: снял
спартак: спартака
кержаков: кержаковым
тройн: тройной
сит: сити
регулярн: регулярный
нат: нато
гроз: грозят
информац: информацию информация
насил: насилие
ротенберг: ротенберг
флеймс: флеймс
ска: ска
обыгра: обыграл
завтр: завтра
цска: цска
люд: людей
прокомментирова: прокомментировали
динам: динамо
разб: разбилась
россиян: россияне россиянам
сканда: скандал
подра: подрались
отвеча: отвечают
объяв: объявила
звер: зверев
шахматист: шахматист
сборн: сборную сборной
побега: побегать
матч: матч матча матче
младш: младшего
волк: волков
лидс: лидс
одн: одним
монр: монро
продаж: продажу
семак: семак
монт: монте
вне: вне
ампутац: ампутаций
самостоятельн: самостоятельно
широк: широкую
катан: катании катанию
забот: забота
закончен: законченными
внич: вничью
крысин: крысиный
рекомендац: рекомендации
страх: страхах
непомня: непомнящий
попрос: попросил
пив: пива
лч: лч
сми: сми
загитов: загитова загитовой
убива: убивать
лад: ладу
кокорин: кокорина
команд: команды команд
блю: блю
музык: музыки
польз: польза
апрел: апреля
ммазимн: ммазимние
федерац: федерацию федерации
союз: союз
стран: странах страны стран стране
участ: участие
январ: января
побед: победу победил победить
финалист: финалистом
громк: громкой
зашкалива: зашкаливал
прикрыт: прикрытых
март: марта
испытан: испытании
песн: песни
войт: войти
медвед: медведев
топ: топ
эмоц: эмоции
глав: глава
хокке: хоккея
состав: состава
махачев: махачева махачевым
торонт: торонто
дета: детали
обвин: обвинили
лас: лас
проблем: проблемы
подробн: подробности
откровен: откровенных
намерен: намерении намерение
заяв: заявил заявили
жрат: жрать
болезн: болезни
ракет: ракеты
жела: желанного
новост: новости
владимир: владимир
лучш: лучшим лучшие
перв: первом
мистическ: мистическая
возрастн: возрастного
пошут: пошутил
проведен: проведения
борол: боролись
добр: добро добра
оо: ооо
возможн: возможности возможное возможный возможном возможные
изменен: изменении
чемпион: чемпиона чемпионов чемпионами
жулин: жулин
запомн: запомнился
пле: плей
американск: американский
разминк: разминка
севил: севилья
выбра: выбрать
брос: бросились бросил
привыкл: привыкли
шест: шести
фхр: фхр
отставк: отставку
колен: коленей
хочет: хочется
как: какие
участник: участников
препарат: препараты
крут: крутов
кар: карен
бойц: бойцов бойцом
выпуск: выпуска
хоккеист: хоккеисты хоккеиста
бывш: бывшему бывший
критик: критикуют
реальн: реальный
втор: вторым
выступа: выступавший выступать
улучша: улучшаться
алкогол: алкоголь
способ: способы
выплат: выплатить
июл: июля
оскорблен: оскорбления
одежд: одежда
погиб: погиб
ufc: ufc
killnet: killnet
ctrl: ctrl
appl: apple
iba: iba
time: time
enter: enter
atp: atp
live: live
