жертв: электорат совершал
обвинительн: января добиться
готов: срока брэгга
случ: указывает могло
ру: преследования
слух: впоследствии
впоследств: домработницы
проработк: быстро
влиян: оценили
студентк: похудения
пикантн: замалчиванию
стат: статьи
обычн: обычную
федеральн: тысячи срок соответствии
конц: прошедшего
стан: деятели
стал: фронте предпринимателем
мнен: общественного опасаются
объясн: лнр
случа: данном
успех: дальнейшие
раскол: штурмом
появ: выборам
удал: пришлось
последств: справилась серьезные
завис: успехи
вернут: вернуться
йорк: штат нью прибывает
арх: архив
экономик: экономика
возмут: ранее
манхэттен: жилья
охот: жертва
пункт: содержится обвинение каждому
единствен: последствиями
макияж: нанесения
давн: возмутило
личност: раскрыли
выкуп: таблоида
должн: законом
мотивирова: политически
структур: структуры
суд: поскольку суд зал предстал критикой
публикац: негативные
экс: предъявления
баллотирова: повестки
пальц: отпечатки
разгар: угрозы
сообщ: должны
дэвид: президенты
поэт: подустали
котор: поэтому
здан: прибыл находящийся напротив
мир: мир
укол: популярных
силов: силовые
секретн: нашлись
манхэтт: офисе
гарланд: меррик
совершен: распространенная
прав: эксклюзивные
внешност: удивились
вебер: вина
отмет: судебным
вагнер: чвк
скор: старте
нажм: опечатку
уш: притянутым
телепередач: ведущая
вперв: спустя
удаст: зависят
относительн: расследование
столкнут: преследованием
документац: финансовой
ричард: сделал
публик: внимание дела
верс: пекер
отчетн: финансовую
фронт: ситуацию
подлог: платежи
дистанц: короткой
байд: гараже
разобра: ру
декабр: запланировано
укра: выстраивал
украин: очков
гранат: соседа
внутр: критиков
свидетел: станем
союзник: друг
раскр: последние
компенсац: выплата
увенча: скандалами
выстав: лидер
россиянин: болезни
зал: здании
сосед: бросил
справ: генеральный обеспокоенность
занима: отличие
могл: ноября
предупред: преследуют
справедлив: лишили
удержа: удастся
отбыва: отправляется
лиш: словам
республиканц: повредила согласны
полномоч: прокурором
подписа: деньги
нов: китаем свидетелями отреагирует
нарушен: штрафа случае
убежд: предъявленных
приговор: предстали обвинительного
част: значительную
сокрыт: мошенничества
подделк: обвинения
порноактрис: выплаты бывшая жене
токсичн: теме
алекс: рсмд
опубликова: история
предполож: политолог
карьер: продвижения
офис: невиновный
слов: судью
дональд: переспала президент дональду кортеж
сопровожда: колумбия
якоб: швейцару
предположительн: этики
сдела: футболок расходах
резиденц: вернувшись
эффективн: оценил
видет: видеть
макдуга: карен
деактивирова: нажмите
министерств: вэнс
прецедент: опасный
наумовполитолог: ходе
редакциярекламаконтактыпресс: всу
мелан: супруга
совет: российского
окружен: годах
жизн: жизни
надел: наручники
фигурир: деле
деятел: политические
стефан: настоящее
интрижк: месяцев
зашедш: заявили
формальн: обязательная пунктов президенту
предвыборн: первого месяц
систем: американской
чвк: уничтоженных
выход: сторонник
переспа: журналистам
должност: непригоден
пыта: поможет
шварцма: валентина
майкл: адвокат
футболок: продажу
журналист: рассказала
сотн: собрались
узна: публика
конгрессм: веберлоббист
летн: романе
мошенничеств: использовался
отмеча: конфиденциальных
американц: многих
выдвига: собирается
отр: десантиса
заседан: следующее
митинг: полиции
путешеств: путешествия
сторонник: правосудия людей
текущ: обвинений
сможет: вопрос
противозакон: настаивает
сша: угрожает
машин: американская
лидер: ракеты
развернул: окружение
процесс: судебных
элвин: йорка заняв
произошедш: общественности
пекер: дэвид
техник: техника
напрот: йорке
повлекш: скандале
утечк: подозреваемого влияние
эксклюзивн: выкупила
сторм: порноактрисе
культур: культура
улисс: оказывался
удив: сети
изм: практика
провод: юстиции
лнр: популярные
личн: выставил подробностей
продолжа: уголовные
чиновник: давлении
опаса: системы
продвижен: ради
вылож: личность
баллотирует: противоречат
врач: нато
сайрус: предшественник
беспорядк: масштабные
скандал: многочисленными заключения
вызыва: обстановке
фальсификац: идет
республиканец: конце
опасн: создает
дал: делу
документ: подписала выложившего деловых
подуста: республиканцы
митт: сенатор
спокойн: пройдут
сын: родила
веберлоббист: вин
опасен: несмотря
пройдут: вряд
повестк: политической
расследован: проводили паранормальных
штраф: многомиллионного выплатить
жен: измены судья
дан: личные преступления
этик: вопросам
отключ: комментарии
дат: попыталась
спецпроект: спецпроекты
зачита: суда
раскрыт: полное рекорд
состоя: познакомилась
закон: интрижки нарушил федеральным
осуществля: доказать
станет: судимости
суров: пост
росс: россия сотрудничать
фбр: пентагона
опрос: сити
четырех: сроком
гиперзвуков: новой
повред: поддержка
домработниц: бизнесмена
угрожа: ним
вашингтон: сенате
мотор: мотор
вряд: очередные
ситуац: похожей утечки
пожалова: добро
счита: мотивированное совпадение
прибыва: залог
правосуд: систему
деньг: взяла
конкурент: главного
окружн: зданию
пошел: прокурор
цел: документации развернули
выдвинут: новые
понадоб: прокуратуре
старт: выходит
муз: речью
возбужден: повлекшем поведения
очк: умных
лент: лента ленту
середин: заявил
предлож: коэн
наруш: числе
кажд: вину
финансирован: закон
опечатк: нашли
галер: галереи
оцен: украине врач
российск: эксперт
политик: тупик судом йорк дело
всеполитикаобществопроисшествияконфликтыпреступн: всеполитикаобществопроисшествияконфликтыпреступность
начат: некоторые
финансов: подделке фальсифицировала
политическ: жертвой прецедент явно бывшие обернуться преступлении
полиц: опасения
сенатор: партии
тупик: зашедшей
обнов: манхэттене
преступлен: уголовным другого тяжком
налич: разбирательства
серьезн: перспективе
использова: преступлением
жил: аренды
обруш: флориде
многочислен: сопровождались
заня: дали
наступлен: зеленского
медиа: утечке
клиффорд: стефани
высш: избрания
настоя: порноактриса
обернет: секретные
пост: президентский
ссср: ссср
вернувш: электората
трампб: происходит
езд: верховой
итог: чиновников
масштабн: переросли
след: выборы следствия
прошедш: ралли
совпаден: скорее
возобнов: брэгг
дел: международным уголовного ход уголовном уголовное
дэниелс: нарушение
вопрос: плюс дома
ближайш: выдвинуты
рассказа: расследованиях решила
юрист: предположил главный
яр: семья
тяжк: пошел
попыта: впервые юристы
размер: штраф
коротк: хайп
отреагир: зависеть
мемуар: презентации
преслед: уголовному
сокр: целью
губернатор: невиновен конкурента
обществ: веру
американист: считает
несмотр: оппонентов
срок: президентского трехлетний заключение раскрыты
отпечатк: сняли
мощн: сша
измен: республиканцам
десантис: рона рон
следств: версии личной
преследован: политического пользу вебера
держа: сможет
бизнесм: ребенке
блогерш: внешности
назва: трампоненавистники
приближен: эпизодов
материал: избирательного
фотографирова: аресте
собира: политику
прокуратур: приговора
противоречат: законодательству
ромн: митт
некотор: процессов
колумб: округ
отношен: президентом состояла
ад: ад
потенциальн: условиях
арест: формальный сделанных
обернут: намерен президента
соглашен: предложил
кита: испытании
штурм: действия американцев
спорт: спорт
практик: совершенно
любовниц: двум
последн: отключены
месяц: пару проработке ближайшие
услов: страны
сам: настаивал
захотел: иран
жми: жми
арестант: высокопоставленный
предъявл: выборах
друг: руководил сокрытия
тюремн: наказание предусматривает
коэн: майкл
возбужд: отношении высший
оказыва: ситуации
наручник: пальцев
флорид: лаго губернатор
компан: материнская
степен: первой
давлен: подозревают
джордж: штате
программ: россией
выглядел: происходящее
внебрачн: знал
получа: стала
ира: макияжа
главн: пейнтербывший главное обходит потенциального
делов: фальсификации
характер: должности
действ: расследует
нашл: байдена ооо
женщин: неразглашении
замалчиван: кампанию
руковод: опубликована
октябр: раскрытие
подтверд: слухи
горьк: очередным
очередн: готовится кандидатов
поможет: репутации
вер: демократам подрывает
популярн: эффективность музыки
вмешательств: назвал
смертельн: язык
рад: заслуженно
запланирова: заседание
созда: полномочий
предшественник: октября
пентагон: документы
сво: интервью убеждая прикованным
кампан: целую президентской предвыборная
ран: неделями
непригод: ромни
исход: отмечает
нача: кампания
станов: штата
перспектив: долгосрочной
интернет: интернет
значительн: мнения ведьм
го: январе
парт: республиканской
нью: прокурора
рекорд: обновила
извлеч: пытается
платеж: скрыть
тем: материалы
штаб: избирательный
сопровод: надели
пришл: студентке
полн: мемуаров
уголовн: становится возбуждение предстоящему возбуждены возбуждено текущем
возбуд: готовятся
коллинсон: стивен
настаива: политик марта
лоббист: мнению
десят: отношениях
бел: юрист
выстраива: прежде
демократ: симпатизирующие
многомиллион: риск
знал: якобы
уничтожен: число
превышен: арестовали
штат: манхэттена заплатили законодательством
происход: верю
обществен: рассказать опросам
этическ: морально
комментар: шварцман
округ: вашингтоне
зеленск: потребность
невиновн: самый
юстиц: министерство
сомнительн: моделями
ведьм: охоты
нанесен: блогерши
трем: приговорен
ценност: ценности
предста: подтвердились взятым трамп
пар: июле
кандидат: двумя главных союзник выдвигать
невинов: подписью
вин: отрицает лоббиста прокуроров
мрачн: одна
истор: права первым десяти
числ: пригожин годам
посвят: республиканец
ход: любом выплатах
зрен: точки
двум: заплатив отрыв
ралл: предвыборного
швейцар: заплатила
модел: историю порноактрисами
подозрева: арестовало джорджия
фальсифицирова: предположительно
кризис: мощнейшим
трехлетн: отбывать
вниман: держать
сотруднича: захотел
сем: жена
репутац: навредит
предъявлен: добился выгоду
решетк: сумме
конфиденциальн: доме
представител: данные
сет: наступлении
виде: видео
верхов: скорости
подрыва: политических
намер: разобралась
обстановк: спокойной
рсмд: делам
симпатизир: написали
вэнс: сайрус
президентск: занимал разгар единственного прошлые кандидату
ноябр: американскую
явн: возбужденное
заключен: тюремного обвинительном тюремное
нескольк: участии
наум: алексей
быстр: мелет
эксперт: американист
наук: наука
сумм: четырех
скорост: превышение
распространен: компенсации
дом: обнаружение белого
реч: пункта выступает
реш: документ
прикова: публики
международн: совета
генеральн: гарланд
известн: стало
резонансн: обернуть
просоч: следил
сторон: фигурируют
гард: авиации
залог: выпустили
указыва: следствие
пригожин: политике
поддержк: токсичный
обитан: обитания
хайп: удержать
недел: несколькими
тысяч: размере
переросл: митинги
меррик: конгрессмен
доб: возобновил пункту
хорош: хорошие
обм: дэниэлс
стоимост: медианная
предусматрива: степени
сред: среда
затянут: попытаются
разбирательств: судебные резонансное
обвинен: зачитали формальных предъявлены
наш: общества
днем: арестант
рассеян: обернется
мног: шокировавшим
абсурдн: выглядело
люб: началась
высокопоставлен: политическим
похуден: уколов
выгод: извлечь
язык: удалить
обеспокоен: вызывает
умн: выпуска
обяза: таблоид
снял: формальность
фот: кризисом
обязательн: стражу
доллар: езде
электорат: декабря свой
арестова: грант фбр
сит: гарден
происходя: беспорядки
гроз: грозит
эпизод: продолжается
нат: представителей
взят: трампбывший
составля: кандидатами
информац: редакциярекламаконтактыпресс
судим: наличие
стив: обозреватель
правд: долларов
негативн: просочились
трагическ: мрачная
взял: политика женщина
избирательн: финансировании предупредил местного
выгляд: глазах
адвокат: кампании
скрыт: отчетность
люд: сотни
спуст: сына
год: сторона трем
наказан: суровое
интерв: дать
таблоид: любовницам компания
законодательств: проступок федерального американскому
кортеж: днем
супруг: законная
притянут: выглядит
трамп: дональдом публикации трампу дональда дональд
собра: здания
отрица: решеткой
расход: сообщить
идет: речь
предстоя: посвятил вмешательством
моральн: сомнительность
одн: появиться
отправля: проведении
продаж: запустил
мар: резиденцию
согласн: президентские
забот: забота
запуст: штаб
презентац: дэниелс
грант: улисс
приб: трампа
потребн: объяснили
соответств: баллотируетесь
президент: кандидата бывшим экс бывшего фото
роман: молчание
сми: сми
лаг: мар
ведущ: клиффорд
плюс: дистанции
молчан: обмен
трампоненавистник: ярые
польз: разбирательство
страж: взяли
ма: тюрьме
музык: громкой
апрел: апреля
познаком: макдугал
незадолг: случая
заслужен: начаты
находя: сопроводили
заплат: приближенные трампе избирательной
материнск: выборов
стран: страна расколом
участ: предстоящие
аренд: стоимость
январ: рассеянность капитолия
отлич: правда
голосован: итоги
поскольк: судебное
громк: гранатой
местн: нарушения
сист: нашу
март: середине
испытан: известно
войт: войти
сенат: слушаний
глав: трагическая
глаз: которое
подпис: фотографировали
предпринимател: своем
выбор: незадолго повлиять президентских горьким
валентин: коллинсон
давност: летней
соверша: противозаконного
подробн: пикантных
обнаружен: го
капитол: штурма
обозревател: глава
заяв: сфера возбудить
зависет: исход
слушан: справа
болезн: смертельной
похож: представшим
мелет: машина
ракет: гиперзвуковой
угроз: получать
республиканск: внутри
расслед: голосования
новост: новости
избран: препятствием
перв: часть давности документов
проведен: законодательства
добр: деактивирована добра
написа: абсурдно
оо: информация
дальн: составлял
политолог: отметил
всу: бойцов
американск: зрения изменит наумов последствия
пейнтерб: ричард
брос: россиянин
брэгг: элвина элвин
квалифицир: подлог
дэниэлс: сторми
политизирова: новых
препятств: станет
кар: модели
содерж: заключении
судебн: справедливое политизированных своим затянуть
повлия: осуществлял
кат: катится
тюрьм: тюрьмы федеральной
бойц: вагнер
прокурор: считаю баллотировался окружного карьеры
прошл: украли
выпуск: сроки
род: мелания
прежд: наумовполитолог
оппонент: сторонников
поведен: характера
бывш: преследование столкнуться узнала бывший истории
критик: обрушился давних
обход: значительно
реальн: пожаловать
паранормальн: телепередачу
выпуст: арест
рол: относительно
гараж: случиться
выступа: десантис
риск: произошедшем
ребенк: внебрачном
рон: губернатора флориды
точк: этической
сфер: программе
выплат: обязали мая роли сокрыть
июл: трампом
навред: уши
шокирова: увенчались
авиац: музее
долгосрочн: месяцы
проступок: квалифицируется
доказа: понадобится
неразглашен: соглашение
organ: organization
trump: trump
nation: national
ctrl: ctrl
appl: apple
howard: howard
american: american
media: media
getti: getty
kent: kent
atilgan: atilgan
nathan: nathan
bello: bello
olson: olson
enter: enter
playboi: playboy
scott: scott
tower: tower
anadolu: anadolu
invis: invision
cnn: cnn
bloomberg: bloomberg
marco: marco
ozdil: ozdil
nda: nda
enquir: enquirer
corbi: corbis
andrew: andrew
ap: ap
reuter: reuters
alex: alex
agenc: agency
killnet: killnet
charl: charles
syke: sykes
imag: images
ami: ami
lichtenstein: lichtenstein
