быва: бывают
обрат: обратить
ру: ру
говор: говоря
заболевш: заболевший заболевших
влиян: влияние
студентк: студентке
коронавирус: коронавируса коронавирус
насморк: насморк
значен: значение
стат: стать статьи
учен: учеными ученых
обычн: обычную
повторн: повторным
стал: стала стало
объясн: объяснили
ношен: ношение
превыша: превышала
появ: появились появился
случа: случае случаи случаях
призва: призвал
удал: удалить
произойт: произойти
работ: работы
центр: центра
вернут: вернуться
арх: архив
живот: животе
экономик: экономика
пандем: пандемия пандемии
александр: александр
манхэттен: манхэттене
обновлен: обновленных
единствен: единственной
дыхательн: дыхательные
макияж: макияжа
н: н
личност: личность
снижен: снижение
структур: структуры
исследовательск: исследовательском
ф: ф
макс: максим
всемирн: всемирная
мутир: мутирует
сезон: сезонных
показа: показала
назван: названием
благодар: благодаря
котор: которое
профилактик: профилактики профилактика
вариант: вариантов варианта вариант варианты
высыпан: высыпания
мир: мир
укол: укол уколов уколами
силов: силовые
секретн: секретные
клиническ: клинические
исследован: исследованию
дезинфекц: дезинфекция
прав: правило
внешност: внешности
отмет: отметил
вагнер: вагнер
скор: скорее
соблюден: соблюдение
нажм: нажмите
вперв: впервые
совместн: совместной
появля: появляться
опас: опасен
отмеч: отмечены
дела: делать
провед: проведено
сух: сухой
тошнот: тошнота
верс: версия
фронт: фронте
важн: важнейшее
кашел: кашель
дистанц: дистанции
декабр: декабря
рук: рук
поездок: поездок
ревакцинац: ревакцинация
украин: украине
гранат: гранатой
метр: метра
выпущен: выпущенных
раскр: раскрыли
врем: времен
выстав: выставил
больн: больным
россиянин: россиянин
сосед: соседа
могл: могли
симптом: симптомов симптомы симптомах
сдат: сдать
повышен: повышение
орв: орви
нов: нового новым новом новый новой новые новых
нарушен: нарушения
больш: большей большую
мест: местах
част: частое
инфекц: инфекции инфекцию
алекс: алексей
слов: словами
постоя: постоянно
эффективн: эффективности эффективность эффективно
особен: особенности
видет: видеть
спалланцан: спалланцани
лайт: лайт
деактивирова: деактивирована
редк: редких
дают: дают
редакциярекламаконтактыпресс: редакциярекламаконтактыпресс
возбудител: возбудителя
совет: советует
пут: пути
нос: носа
активн: активность активнее
жизн: жизни
контагиозн: контагиозностью
зашедш: зашедшей
природ: природы
систем: системы системе
чвк: чвк
сокращен: сокращения
чихан: чихание
прида: придала
летн: летней
отмеча: отмечают отмечается
торгов: торговым
отступа: отступать
основн: основные
путешеств: путешествия
богодвид: богодвид
курс: курса
константин: константин
облада: обладает
сша: сша
метод: методы
немедлен: немедленно
миха: михаил
лидер: лидер
выявл: выявлены
свойств: свойства
сознан: сознания
техник: техника
окружа: окружающих
утечк: утечке утечки
антител: антител
культур: культура
градус: градусов
удив: удивились
лнр: лнр
средн: среднем
продолжа: продолжают
личн: личные
кишечн: кишечного
букв: буква
смерт: смерти
подхват: подхвативший
перенест: перенести
вылож: выложившего
помощ: помощь
врач: врач врачи
выш: выше
напряжен: напряжении
результат: результате
вызыва: вызывает
пцр: пцр
ведомств: ведомства
опасн: опасность
обнаруж: обнаружен
мышц: мышцах
альф: альфа
осмыслен: осмысленным
коронавирусн: коронавирусной
документ: документы документов
сухорук: сухоруков
инфекцион: инфекционных
жел: желая
средств: средств
сравнен: сравнению сравнении
дан: данные
отключ: отключены
имен: имени
указа: указаны
спецпроект: спецпроекты
мутац: мутаций мутация мутации
раскрыт: раскрыты
сустав: суставах
вкус: вкуса
бессимптомн: бессимптомной
рост: росту
росс: россии россия россией
иммун: иммунной
фбр: фбр
вируснейтрализ: вируснейтрализующих
осложнен: осложнения
объяснен: объяснением
гиперзвуков: гиперзвуковой
мотор: мотор
варьирова: варьироваться
ситуац: ситуацию
пожалова: пожаловать
цикл: цикла
счита: считается
причин: причиной
цел: целом
отлича: отличается
очк: очков
вирус: вируса
глюкокортикостероид: глюкокортикостероиды
лент: лента ленту ленты
опечатк: опечатку
лекарств: лекарств лекарствами
галер: галереи
оцен: оценили оценил
российск: российского российской
продемонстрирова: продемонстрировал
зараз: заразен заразиться
политик: политике
алфавит: алфавита
циркулирова: циркулировавшим
отличн: отличные
искусствен: искусственной
инфицирован: инфицирования
самоизоляц: самоизоляцию
перчаток: перчаток
тупик: тупик
обнов: обновила
налич: наличие
жил: жилья
першен: першение
начал: начале
спутник: спутник
наступлен: наступлении
медиа: медианная
настоя: настоящее
смертност: смертности
заражен: заражения
ссср: ссср
антисептическ: антисептических
след: следующие
минимизац: минимизация
институт: институте
ночн: ночную
вопрос: вопросов
организац: организации организация
сохраня: сохраняется
цельс: цельсия
параллельмо: параллельмоя
так: таких
дельт: дельта
срок: срок сроки
течен: течение течения
измен: изменились
британск: британский
жкт: жкт
август: августа
дет: детей
блогерш: блогерши
назва: назвал
материал: материалы материале
головн: головные
потлив: потливость
рецептор: рецепторов
здравоохранен: здравоохранения
смен: смене
проника: проникать
некотор: некоторых
лечен: лечение лечению лечения лечении
отношен: отношении
продолжительн: продолжительность
служб: службы
кита: китаем
интерлейкин: интерлейкину
спорт: спорт
инфицирова: инфицированных
диаре: диарея
транспорт: транспорте
последн: последняя последние
разновидн: разновидностей разновидность
синтетическ: синтетическая
месяц: месяца
представля: представляет
захотел: захотел
жми: жми
штамм: штамм штаммами штаммы штаммов штамме штамму штаммом штамма
друг: другими другим
сутк: сутки
рибонуклеинов: рибонуклеиновая
михальчевск: михальчевский
длит: длится
правильн: правильности
переда: передается
крак: кракен
оказыва: оказывать
вероятн: вероятностью
иммунитет: иммунитета
программ: программе
вздут: вздутие
наименован: наименование
ира: иран
главн: главное
нашл: нашли
обонян: обоняния
геном: геноме
заболеван: заболевания заболеваний заболевание
пят: пяти
аппетит: аппетита
состоян: состояния
перенесет: перенесете
прогноз: прогноз
популярн: популярных популярные
кислот: кислота
смертельн: смертельной
раз: раза
предшественник: предшественники
проявлен: проявления
пентагон: пентагона
спин: спине
имеющ: имеющиеся
профилактическ: профилактические
ран: ран ранее
помн: помнить
горл: горле
изжог: изжога
специалист: специалисты специалист специалистов
профессор: профессор
академ: академии
интернет: интернет
значительн: значительно
тест: тест
рекорд: рекорд
сопутств: сопутствующих
явля: является
появлен: появления
всеобществополитикапроисшествиярегионымоскв: всеобществополитикапроисшествиярегионымосква
ощутим: ощутимо
применя: применять применяемые
пришл: пришлось
знат: знать
мыт: мытье
сайт: сайте
уничтожен: уничтоженных
бет: бета
обществен: общественном
комментар: комментарии
зеленск: зеленского
нанесен: нанесения
ценност: ценности
африканск: африканской
вызва: вызванной вызвать
заложен: заложенность
числ: число
верхн: верхние
двум: двумя
цифр: цифра
период: период
подозрева: подозреваемого
вниман: внимание
сотруднича: сотрудничать
многолюдн: многолюдных
уйт: уйти
легк: легкие легкой легкое
представител: представителей
сет: сети
виде: видео
блокатор: блокаторы
защит: защитой защититься
рвот: рвота
температур: температуры
ноябр: ноябре
юар: юар
оста: остается
быстр: быстрому быстрее
тим: тим
наук: наука наук
бронх: бронхи
позволя: позволяют позволяющей позволяет
дне: дней
скорост: скорость
распространен: распространения распространению
способн: способно
известн: известно
возросш: возросшей
спектор: спектор
указыва: указывает указывают указывается
амнез: амнезия
пригожин: пригожин
защища: защищать
перечисл: перечислил
гамал: гамалеи
заболеваем: заболеваемости
обитан: обитания
реж: реже
хорош: хорошие
стоимост: стоимость
болеют: болеют
сред: среда среди
предыдущ: предыдущего предыдущими предыдущих
социальн: социальной
ин: иными
республик: республике
слабост: слабость
интерферир: интерферирующая
титр: титр
наблюда: наблюдаться
итальянск: итальянском
зависим: зависимости
перегрузк: перегрузку
похуден: похудения
заразн: заразность заразностью заразным
избежа: избежать
язык: язык
большинств: большинство
умн: умных
фот: фото
арестова: арестовало
нат: нато
составля: составляет
информац: информация информации
описа: описал
желудочн: желудочно
воспален: воспаленные
ломот: ломота
способств: способствуют способствует
высокоэффективн: высокоэффективные
скрыт: скрытых
люд: людей
выявлен: выявленный
минздрав: минздравом
мурашк: мурашко
вакцин: вакцина вакцин вакцины вакцину вакцине вакцинами
министр: министр
применен: применение
мирнк: мирнк
волн: волны
мал: малая
продаж: продажу
омикронециклкоронавирус: омикронециклкоронавирус
омикрон: омикрона омикрон
согласн: согласно
забот: забота
гамм: гамма
рекомендац: рекомендациях
ритонавир: ритонавир
потребн: потребность
президент: президент
распространя: распространяемая
сравнительн: сравнительному
сми: сми
ведущ: ведущем
команд: командой
обстоятельств: обстоятельство
маск: маски
плюс: плюс
музык: музыки
молнупиравир: молнупиравир
воз: воз
стран: страна страны
аренд: аренды
отлич: отличие отличия
поскольк: поскольку
тракт: тракта
громк: громкой
южн: южно
включа: включают
испытан: испытании испытания
войт: войти
своевремен: своевременности
глаз: глаза
роспотребнадзор: роспотребнадзор роспотребнадзоре
протокол: протоколов
ни: нии
прививк: прививки
обнаружен: обнаружения
поража: поражает поражать
респиратор: респиратора
заяв: заявил заявили
болезн: болезни
ракет: ракеты
вакцинац: вакцинации вакцинация
благоприятн: благоприятный
новост: новости
существ: существующих
перв: первой первые
бол: боли боль
добр: добро добра
оо: ооо
возможн: возможны
всу: всу
короч: короче
нирматрелвир: нирматрелвир
выбра: выбрать
брос: бросил
шест: шести
учитыв: учитывая
держ: держит
перенос: переносят
как: какую
подтвержд: подтверждена
инкубацион: инкубационный
препарат: препараты препаратов препаратах препарат
напомина: напоминают
содерж: содержится
встреча: встречаются
серге: сергеев
бойц: бойцов
выпуск: выпуска
высок: высокая высокой высокий
прежд: прежде
бывш: бывший
реальн: реальный
спутан: спутанность
тяжел: тяжелой тяжелого
риск: риск
сфер: сфера сфере
форм: форме формами
мер: меры
ри: риа
признак: признаки признаков
потер: потеря потерю
zoe: zoe
covid: covid
symptom: symptom
studi: study
killnet: killnet
sar: sars
ctrl: ctrl
appl: apple
pfizer: pfizer
cov: cov
enter: enter
