готов: готовы
говор: говорится говорить
слух: слух
понима: понимают
стас: стасом стас стаса
дорог: дорогую
предлага: предлагает
втюха: втюхать
геро: героем
маленьк: маленький
появ: появилась
успех: успех успеха
случа: случае
гуля: гуляет гулять
центр: центре центр
заход: заходит
работ: работу
рекламн: рекламном
частичн: частичное
стилист: стилист
арт: артем арта
концентрат: концентрат
бесконечн: бесконечно
сетев: сетевые
налажива: налаживали
правов: правовая
привлеч: привлечены
пол: полом
сто: стоит
тус: тусим тусить тусуется
человек: человека
послед: последующий
прийт: прийти
накида: накидали
вообщ: вообще
разговор: разговора
суд: судя
дава: давай
макс: максим
человеческ: человеческого
назван: название
котор: котором
времен: временем
мин: мин
тимур: тимур
ум: ум
угора: угорали
вывеск: вывеску
прав: права
уч: училась
соблюден: соблюдением
скор: скорейшего
девушк: девушку
нажм: нажмите
проект: проекты проектов проектами
связ: связи
лид: лидия
обита: обитают
мегаполис: мегаполиса
дела: делала делать
ребят: ребятам
получ: получился получилось получить
модн: модным
важн: важно
город: город города городе
новостроевск: новостроевский
полден: полдень
чат: чат чате
потеплеет: потеплеет
внутр: внутри
метр: метрах
прост: простите
позвол: позволил
лип: липа
индустр: индустрии
постро: построить
свободн: свободное
лиц: лицо лица
встреч: встречи
подруж: подружились
коммуналк: коммуналке
нов: новые новую
ног: ногами
нарушен: нарушений
кстат: кстати
надп: надпись
больш: большой большом
пазух: пазуха
почувствова: почувствовать
мест: место места
предоставл: предоставлено
девяткин: девяткином
устро: устроить
слов: слова
журна: журнал
геодакя: геодакян
воюет: воюет
кана: канала канал
попаст: попасть
кофейн: кофейня
сдела: сделала
внимательн: внимательные
тусовочн: тусовочный тусовочном
телегр: телеграм
вспомн: вспомнить вспомнила вспомним
поработа: поработать
любител: любители
журфак: журфаке
активн: активные
жизн: жизни
подар: подарил
кремл: кремля
мог: могу
персонаж: персонаж
проводник: проводник
мож: можем
пыта: пытаются
бездушн: бездушные
кооперат: кооператив
тусовк: тусовки тусовку
адск: адского
особняк: особняк
пообща: пообщаться
патрик: патрик
читател: читателей
осколк: осколков
мослентыподписа: мослентыподписаться
халат: халатах
окрестн: окрестности окрестностям
прослуша: прослушал
сосн: сосна
хотел: хотела хотелось
владельц: владельца владельцев
провож: провожу
невкусн: невкусно
доказыва: доказывает
хоппинг: хоппинг
комментирова: комментировать
живет: живет
личн: личного
спуска: спускал
помога: помогают помогать
меня: менять
вып: выпить
материа: материала материал
помощ: помощью
современ: современные
опыт: опыта
чувак: чувак
здоров: здорового
общепит: общепита общепитом
жизнен: жизненного
любв: любви
душевн: душевная душевнее
одноимен: одноименном
бизнесов: бизнесовым
уныл: унылые
прячет: прячется
вклад: вклад
витрин: витрине
лялин: лялином
волшебств: волшебство
явлен: явление
тасс: тасс
текст: текст
забавн: забавные
жител: жители житель жителей
запрещен: запрещенной
тарасов: тарасова
локдаун: локдауна
расслыша: расслышал
рисунк: рисунка
самовыражен: самовыражения
выросл: выросло
заведен: заведений заведения
жен: женя
дружествен: дружественная
свобод: свободы
дам: даму
отключ: отключить
закон: закона
легендарн: легендарные
вкус: вкус
рост: роста
одолж: одолжив
найдет: найдется
кот: кот
гипотез: гипотеза гипотезу
каза: казалось
счита: считает
выжива: выживают
наткнул: наткнулась
пошел: пошел
авит: авито
цел: целом целях
брал: брала
кажд: каждую каждого
опечатк: опечатку
коф: кофе
российск: российской
сохран: сохранить
канал: канале каналу
политик: политика
множеств: множеством
вмест: вместе
коммерческ: коммерческих
искусствен: искусственность
отличн: отлично
параллельн: параллельно
спор: спор
жив: живое живем
идут: идут
всяк: всякие
увиден: увиденного
сюр: сюра сюр
основательниц: основательницей
питейн: питейный
прекрасн: прекрасной прекрасное прекрасные
жил: жилье
юр: юрия
сюд: сюда
покровск: покровских
животн: животных
пост: постили
мастерск: мастерскую
знаком: знакомились знакомятся
энерг: энергией
выдел: выделите
итог: итоге
след: следят следит
стольк: столько
разброд: разброд
разрос: разросся
завест: завести
дел: дело делах
рассказа: рассказала
студ: студии
невозможн: невозможно
неформальн: неформальное неформальность
сохраня: сохраняется
жит: жить
цитат: цитата
покровк: покровку покровка покровки покровке
попробова: попробовали
активист: активистами
зинзивер: зинзивер
проход: проходят
так: таком таки
письмен: письменного
москв: москвы москва москве
пространств: пространство
семейн: семейную
букет: букет букета
собствен: собственно
копирован: копирование
редакц: редакции редакция
бульвар: бульваре
наносн: наносное
измен: изменившуюся
уда: удалось удается
стойк: стойки
переулк: переулке переулкам
скрепк: скрепка
рюмк: рюмка
материал: материалы материалов
превращен: превращение
смен: смены
отверга: отвергается
ценципер: ценципер
балкон: балконе
плева: плевать
подума: подумала
обща: общаться
кварта: квартал
удивительн: удивительное удивительно
количеств: количество
палок: палок
угол: угол
услыша: услышанными
кита: китай
бар: бар барами барах бара
район: район районов районе районные району районных района
акул: акул
искрен: искренность
услов: условия
сам: самую самый самая самых
тво: твои твоих
возвра: возвращаясь
качествен: качественное
флористическ: флористическую
друг: другом другим друг друга другую другу
лифчик: лифчик
жанр: жанре
ходасевич: ходасевич ходасевиче
поня: понял
называ: называется
рассказыва: рассказывать
гост: гости
извин: извините
наслед: наследия
выглядел: выглядело
зайт: зайти
понт: понты понтов
неожида: неожиданно
действ: действующим
нашл: нашли
страничк: страничку
лакшер: лакшери
рат: ратует
елк: елка
смысл: смысле
приезжа: приезжает
популярн: популярного популярность
соцсет: соцсетями соцсети
имеют: имеются
ресторатор: рестораторов
простот: простоту
устанеш: устанешь
цвет: цвет
созда: создан создала создали создают создать
магазин: магазин
агентств: агентстве
проявлен: проявление
небезразличн: небезразличные
сво: своими своя свой
скольк: скольких
вника: вникать
влюблен: влюбленная
нача: началась начали
монолог: монолог
реализ: реализует
сохранен: сохранением
деревн: деревню
замеча: замечали
выполн: выполнен
необычн: необычное
мелька: мелькают
реализац: реализации
чистеньк: чистенький
комьюнит: комьюнити
старожил: старожилы
тем: тему
основател: основателя основателями основателем основатель
социализирова: социализироваться
полн: полное
развит: развитием
легенд: легенды
фотограф: фотографии фотографа
выпива: выпивающем
спаст: спасти
сайт: сайта
выстро: выстроить
знал: знали
задач: задача
прощ: проще
работа: работала
детал: деталь
отошел: отошел
сегодняшн: сегодняшней
спасл: спасла
телефон: телефон
мирок: мирок
блог: блога
истор: историй история
числ: числе
ход: ходили ходить ходят
зацеп: зацепил
внос: вносят
прогремет: прогреметь
автор: автор
вырул: вырулила
легк: легко
вид: виду виде
конфиденциальн: конфиденциальности
разрешен: разрешения
навсегд: навсегда
чуд: чудо чуда
неместн: неместных
подкопаевск: подкопаевском
историческ: исторического
оста: осталась
потихоньк: потихоньку
алкобуфет: алкобуфет
быстр: быстро
бизнес: бизнесы бизнес
виновн: виновные
разреш: разрешено
прибав: прибавился
городск: городской городского
альтернативн: альтернативной альтернативному
дор: дорого
общ: общим
фриланс: фрилансила
влит: влиться
залог: залог
первопроходц: первопроходцы
скрипуч: скрипучим
остальн: остальные
перечисля: перечислять
поддержива: поддерживают
расскажут: расскажут
хорош: хорошему
ид: идеи идей
защищ: защищены
любим: любимых любимый
сред: среди
ил: илья
редактор: редактор
чувств: чувствуют чувствуется
мног: многом
люб: любим любят любили любому любит любой любила
можеш: можешь
авторск: авторскими
большинств: большинство
обязательн: обязательно
фот: фото
товарищ: товарищем
повернеш: повернешь
регулярн: регулярно
хулиганск: хулиганской
коридор: коридором
евген: евгения
составля: составляющую
информац: информация
ворот: воротах
разн: разные
взял: взялось
год: годах
мерзост: мерзости
чистопрудн: чистопрудном
открыва: открывала
интерв: интервью
райончик: райончике
законодательств: законодательством
вно: вно
кривизн: кривизна
андеграунд: андеграунд
трехсвятительск: трехсвятительском
размещен: размещение
черн: черный
классов: классовый
собра: собраны
закрыт: закрытия
книжн: книжный
служат: служат
вна: вна
например: например
одн: одна одни одним
классн: классно
реклам: рекламу рекламы
забот: заботятся
попрощ: попроще
чатик: чатике
избалова: избалованы
соответств: соответствии
пив: пиву
огромн: огромный
объединя: объединяет
подня: подняла
апрел: апреля
ответствен: ответственности
федерац: федерации
врод: вроде
подхватыва: подхватывают
стран: странный
придут: придут
использован: использования
мо: мою моих
громк: громкое
юдженич: юдженич
пьян: пьяным пьяных
местн: местными местный местные местных
дух: дух духе духа
кресл: кресла
душ: души
поменьш: поменьше
прокача: прокачана
качеств: качестве качество
веша: вешать
гусятников: гусятниковом
сраз: сразу
благодарн: благодарны
холодн: холодные холодный
вечн: вечный вечная
обнаружен: обнаружения
барн: барную барных
скажут: скажут
подростк: подростков
транслир: транслирует
жела: желает
талисман: талисманами
нек: некое
новост: новости
существ: существуют существу
лучш: лучшем
дума: думает
мгу: мгу
посет: посетить
ол: олей
партнерск: партнерские
талантлив: талантливые
интересн: интересного
дальн: дальнейшим
понын: поныне
молод: молодым
открыт: открытие открытиями
буквальн: буквально
дает: дается
безумн: безумная безумных
ссан: ссаный
как: какое какие каких какого
все: всей
рюмочн: рюмочная
произнес: произнес
меша: мешают
каф: кафе
площадк: площадки
атмосфер: атмосферу
прошл: прошлое
прежд: прежде
уютн: уютный
наслаива: наслаиваться
наверн: наверное
журналистск: журналистское
крафтов: крафтовому
откр: открылся открыть открыться
бесчислен: бесчисленное
достопримечательн: достопримечательности
наход: находила находить находят
никак: никаких
мослент: мосленте
вылиза: вылизан
aa: aa
rss: rss
moslenta: moslenta
ctrl: ctrl
telegram: telegram
enter: enter
