термина: терминал
ру: ру
комар: комаров
бензин: бензином
влиян: влиянии влияние
студентк: студентке
стат: статьи
учен: учения ученые ученый
захот: захотят
обычн: обычную
оказа: оказаться оказались
вызов: вызовам
стал: стала стало
надбавок: надбавок
детеныш: детеныш
северн: северное северный северного северных северному
призва: призвал призвали
удал: удалить
работ: работы
центр: центре
дополнительн: дополнительный дополнительные
удар: ударили
север: севера севере север
вернут: вернуться
врангел: врангеля
выяв: выявят
арх: архив
экономик: экономика
впечатлен: впечатлениями
вымерш: вымершего
манхэттен: манхэттене
добра: добрался
обновлен: обновление
человек: человека
охот: охоте
туш: туше
москвич: москвиче
заполярн: заполярный заполярном
давк: давке
морск: морских морского
личност: личность
поезд: поездом
структур: структуры
двухлетн: двухлетнего
подел: поделился
шар: шаре
показа: показали показал
назван: названия
радуг: радугу
звездн: звездные
мир: мир мире
влюб: влюбили
укол: уколов
силов: силовые
териберк: териберки
хоккейн: хоккейный
секретн: секретные
оленеводств: оленеводству
бура: буран
совершен: совершенно
прав: правила
связа: связали
природн: природное
бур: буря
амеб: амебу
нажм: нажмите
проект: проект проекте
шайтанк: шайтанки
резк: резкого
феврал: февраля
вперв: впервые
вымиран: вымирания
льдов: льдов
застря: застрявших застрявшей застряли
вбил: вбили
фронт: фронте
важн: важна важно
провел: провели
город: город города городом
декабр: декабря
льдин: льдине
украин: украине
гранат: гранатой
раскр: раскрыл раскрыли
выстав: выставил
россиянин: россиянин
рубл: рублей
сосед: соседа
постро: построят построить
туземк: туземками
редчайш: редчайшую редчайший
мороз: мороз морозы
конюхов: конюхова
нов: новый новой новую новых новым
нарушен: нарушениями
больш: большом
миллиард: миллиардов
мест: место места
госдум: госдума
корен: коренных
тишин: тишина
размороз: разморозился
опубликова: опубликовано
кин: кино
сорва: сорвал
фестивал: фестиваль
кана: канал
росат: росатом
стартова: стартовал стартовали
сдела: сделали
хищник: хищника хищник
эффективн: эффективность
шапк: шапку
видет: видеть
гран: грани
деактивирова: деактивирована
редк: редкое
редакциярекламаконтактыпресс: редакциярекламаконтактыпресс
страшн: страшно
пут: пути
нос: носом
жизн: жизни
адаптац: адаптации
русск: русские русской русского
кит: китами
подар: подарил
ноч: ночи
летя: летящего
кремл: кремле
оскар: оскар
пыта: пытались
сотн: сотни
летн: летнем
момент: момент
выж: выжить
покор: покорить
смог: смог
деликатес: деликатесы
сможеш: сможешь
путешеств: путешествия
старин: старинные
вышл: вышло вышли
популяц: популяцию
категор: категории
сша: сша
атакова: атаковал
машин: машины машинах машин
лидер: лидер
молодеж: молодежи
пойма: поймай поймал
скрыва: скрывался
техник: техника
утечк: утечке утечки
оленевод: оленеводов
культур: культура
личн: личные
секрет: секреты
бесплатн: бесплатно
далек: далеком
вылож: выложившего
материа: материал
врач: врач
ввел: ввели
проеха: проехал проехать
красив: красивые
вышедш: вышедшего
дрейф: дрейфующие
опасн: опасных опасность опасны опасный
явлен: явление
дал: дали
водоснабжен: водоснабжения
жител: жителю
документ: документы документов
будущ: будущих будущего
мечта: мечтают
полярник: полярники
дан: данные
индейц: индейцами
спецпроект: спецпроекты
арктическ: арктической арктическую арктические арктических арктическом арктическое
раскрыт: раскрыты
закон: закон
царск: царский
росс: россии россия
фбр: фбр
гусеничн: гусеничных
гиперзвуков: гиперзвуковой
мотор: мотор
автомобил: автомобилях автомобилей
ситуац: ситуацию
найден: найденные найденных
пожалова: пожаловать
якут: якутии
гипотез: гипотезу
арктик: арктики арктика арктике арктику
гигант: гигантов
выдвинул: выдвинули
обледенел: обледенелых
причин: причинах
выжива: выживать
конюх: конюхов
брак: браки
очк: очков
вирус: вирусы вирусов
лент: лента ленту
предлож: предложили
увид: увидите
опечатк: опечатку
спасен: спасение спасению
галер: галереи
миграц: миграции
оцен: оценили оценил
российск: российского российские российских российском российская российской российским российский российскому
остров: острове
возрожда: возрождает
уезжа: уезжать
начат: начата
зарабатыва: зарабатывают
невозмутим: невозмутимых
увидел: увидели
обнов: обновила
поездк: поездке
алмаз: алмазу алмаз
тундр: тундры тундре
разработа: разработали
жил: жилья
увидет: увидеть
клык: клыка
заня: заняли
поучаствова: поучаствовали
путин: путиным путина путин
медиа: медианная
офицер: офицер
кра: краю край
животн: животного
кадр: кадры
ссср: ссср
потеплен: потепления
маяк: маяки
итог: итоги
полгод: полгода
масштабн: масштабные масштабную
вошл: вошли
вопрос: вопрос
рассказа: рассказали рассказал
снежн: снежная снежном снежного
аэс: аэс
пришел: пришел
оптическ: оптическое
сиян: сияние
так: таком
изучен: изучения
ответ: ответили
воздушн: воздушном
норникел: норникель норникеле
порт: порта
прообраз: прообраз
срок: сроки
поздрав: поздравил
таймыр: таймыра
повелител: повелитель
станц: станцию
измен: изменить
мощн: мощными
красот: красота
держа: держав
атомн: атомных атомный
назва: назван
символ: символом символ
конкурс: конкурса
минус: минус
рутин: рутинный
противостоян: противостояния
иска: искать
мчс: мчс
космонавт: космонавтов
нефтедобыч: нефтедобычи
спутников: спутниковую
пробежк: пробежка
атмосферн: атмосферное
древн: древнейший древних
попа: попал попало попали попала
благородн: благородных
кита: китаем
посмотрет: посмотреть
спорт: спорт
последн: последние
сам: самых самые самым
жми: жми
зон: зоной
крушен: крушения
сва: сваю
норильск: норильске норильском норильска
народ: народов
пробежа: пробежал
тайг: тайге
увлекл: увлеклись
влож: вложит
голодн: голодный
главн: главное
неожида: неожиданном
полет: полет полета
нашл: нашли
воздух: воздух
пересчита: пересчитают
аляск: аляску
снег: снегу
век: веками
поможет: поможет
игрок: игроки
популярн: популярных
челябинск: челябинске
режиссер: режиссеры
смертельн: смертельной
област: области
заполяр: заполярья заполярье
чемпионат: чемпионат чемпионате
изуч: изучит
пентагон: пентагона
пролежа: пролежал
даст: даст
деревн: деревни
интернет: интернет
россия: россиян
необычн: необычные необычной
прода: продала
сибир: сибири
рекорд: рекорд рекордом
сбежа: сбежал
появлен: появление
замерзнеш: замерзнешь
полярн: полярной полярных
экспедиц: экспедиция экспедицию экспедиции
плен: плену плена
рацион: рацион
пришл: пришлось
развит: развитию
бел: белой белых белого белый
ежемесячн: ежемесячные
спаса: спасают
хвата: хватало
призов: призовые
сильн: сильнейших сильнейшие
соловк: соловков
ценност: ценности
ледокол: ледоколом ледоколу ледокол ледокола ледоколов
переп: перепись
спасл: спасли
ямал: ямале
пар: пару
ед: еду
капита: капитана
подвел: подвел
истор: истории
зрен: зрения
подозрева: подозреваемого
клуб: клуба клуб
гибл: гибли
одобр: одобрила
маршрут: маршруты
представител: представителей
вид: вида
виде: видео
снося: сносящая
остр: остров
нигд: нигде
красн: красных
ноябр: ноября
науч: научились
сельск: сельского
километр: километров
блогер: блогер
песец: песец
обеща: обещанного
наук: наука
вышел: вышел
олен: оленя оленей олени
пережива: переживают
дне: дней
эпох: эпохи
крыш: крышу крыши
парус: парусами
многоэтажк: многоэтажки
дом: домов
реш: решили
способн: способны
бил: бились
известн: известно
международн: международном международный
поддержк: поддержки
гамал: гамалеи
обитан: обитания
китов: китовыми
федор: федора
тысяч: тысячи
побыва: побывать
жемчужин: жемчужина
дня: дня
доб: добыли
землетрясен: землетрясениями
хорош: хорошие
профессиональн: профессиональный
стоимост: стоимость
сред: среда
морж: моржа моржей
сафар: сафари
сказочн: сказочный
похуден: похудения
снят: снять
язык: язык
умн: умных
снял: сняли
борт: борта
косул: косуль
арестова: арестовало
автобус: автобус
урага: ураган
нат: нато
держав: державы
погон: погоне
информац: информация
салон: салона
группировк: группировку
земл: земли
перебежа: перебежал
нарт: нартами
столкновен: столкновении
замет: заметили
планет: планеты
люд: людям
россиян: россияне россиянам
гибел: гибель
спуст: спустили спустил
огн: огни
полюс: полюсу полюс
министр: министр
широт: широтах
добыт: добытому
черн: черными
клонирован: клонирования
собра: собралась
волк: волков
одн: одну
продаж: продажу
живут: живут
миров: мировым
забот: забота
грант: грантов
подобра: подобрались
засня: засняли
мистик: мистикой
попрос: попросить
сми: сми
огромн: огромного огромному
убива: убивать
вездеход: вездеходов
музык: музыки
апрел: апреля
вод: воду
уникальн: уникальную
ми: ми
аренд: аренды
десятк: десятки
январ: января
проведет: проведет
регион: региона регионе регион регионом
обсерватор: обсерватории
громк: громкой
местн: местные
войн: война
отня: отнять
неб: небе
март: марта
испытан: испытании испытания
войт: войти
медвед: медведя медведей медведь
лошад: лошади
марк: марку
состав: составе
хокке: хоккея
прошел: прошел
номинант: номинантом
хокк: хоккей
собол: соболей
подробн: подробности
обнаружен: обнаружения
болезн: болезни
ракет: ракеты
приедут: приедут
новост: новости
лучш: лучший
перв: первую
ож: ожили
операц: операция
добр: добро добра
оо: ооо
параллел: параллель
брос: бросил
уголк: уголках
увелич: увеличить
голод: голод
мурманск: мурманской
всесобытиялюдиявлениядостиженияэкологиятуризмистор: всесобытиялюдиявлениядостиженияэкологиятуризмистория
холод: холод
пассажир: пассажир
участник: участники
зимн: зимнюю
фильм: фильм
создадут: создадут
отыска: отыскать
выпуск: выпуска
бывш: бывший
реальн: реальный
рекордн: рекордного
ребенк: ребенка
дешев: дешевым
трудоустройств: трудоустройства
откр: открыли
выплат: выплаты
миллион: миллионы
способ: способ
форм: формы
избав: избавились
killnet: killnet
ctrl: ctrl
appl: apple
enter: enter
