разговарива: разговаривали
найт: найти
чувствова: чувствовала
ру: ру
говор: говорила говорили говорить
влиян: влияние
студентк: студентке
понима: понимала
успел: успела успели
занят: занятия
стат: статьи
обычн: обычную
оказа: оказалось оказавшись
отдыха: отдыхает
вызов: вызову
конц: конца концах
перееха: переехала переехавших переехало
стал: стала стало
дорог: дорогие дорогая
возглас: возгласами
подкармлива: подкармливает
дорож: дороже
объясн: объяснили
геро: героем
нравоучен: нравоучений
удал: удалить
гуля: гулять
работ: работа работы
центр: центре центру
заход: заходили
арт: арт
вернут: вернуться
мероприят: мероприятия
прорва: прорвало
арх: архив
экономик: экономика
пож: пожить
налажива: налаживается
интеллигенц: интеллигенция
тщательн: тщательно
касс: кассе
инфраструктур: инфраструктура
приглаша: приглашала
сто: стоишь стоит стоить
учебн: учебную учебная
манхэттен: манхэттене
мил: милый
человек: человеку
приятн: приятная
эпиляц: эпиляцию
вообщ: вообще
лет: летом
каса: касается
пита: питаюсь
макияж: макияжа
разговор: разговор разговоры
то: той
леч: лечила
личност: личность
поезд: поездить
структур: структуры
дава: давай
филиал: филиалы
сезон: сезон
поэт: поэтому
котор: которым
квартир: квартиры квартиру
мир: мир миру
мальчик: мальчика
укол: уколов
силов: силовые
секретн: секретные
отнесл: отнесла
ящик: ящик
шаг: шагу
знают: знают
прав: права
внешност: внешности
этаж: этаже
безопасн: безопасно
проверя: проверяются проверяли
повезл: повезло
малайз: малайзии
вагнер: вагнер
девушк: девушке
либ: либо
уч: учишься
нажм: нажмите
ушл: ушла
вперв: впервые
тревожн: тревожно
лиз: лиза
порисова: порисовать
едеш: едешь
украшен: украшение украшения
дела: делаешь
ребят: ребята
оправда: оправдались
сух: сухую
получ: получился получится получить
байк: байк
клиник: клинике
фронт: фронте
скуча: скучаю
вытянут: вытянуть
отреза: отрезаю
устраива: устраивает
декабр: декабре
рук: руки
час: час
столкнул: столкнулась
украин: украине
гранат: гранатой
сжег: сжег
розов: розовый
раскр: раскрыли
выстав: выставил
позвол: позволить
больн: больной
покрас: покрасить
россиянин: россиянин
рубл: рублях рублей
сосед: соседа соседей
индустр: индустрии
постро: построена
занима: занимать занимаюсь
риелтор: риелтора
лиц: лицо
встрет: встретила встретилась
разумеет: разумеется
подруг: подруга
дешевл: дешевле
нов: новый новой новых новые
нарушен: нарушение
приготов: приготовить
кстат: кстати
больш: большие большой
мест: мест места
предоставл: предоставлено
лезут: лезут
счет: счета
бараба: барабаны
недвижим: недвижимость
достава: доставать
ждал: ждал
игр: игр
постоя: постоянно
перелет: перелет
сдела: сделать сделали сделала
кольц: кольца
внимательн: внимательные
эффективн: эффективность
видет: видеть
деактивирова: деактивирована
сложн: сложно
родител: родители
волейбол: волейбол
ча: чай
редакциярекламаконтактыпресс: редакциярекламаконтактыпресс
нос: носить
активн: активностей
жизн: жизни
русск: русских русские русский русскими русским
штук: штуки
пример: примеру
вперед: вперед
кит: китая
зашедш: зашедшей
чвк: чвк
выход: выхода
полноцен: полноценный
пыта: пыталась
отл: отлили
спортивн: спортивные
летн: летней
момент: момент
мор: море
развива: развивается
перебра: перебралась
подросток: подросток
основн: основные основная
лестниц: лестнице
путешеств: путешествия
труб: трубы
сожален: сожалению
поиска: поискать
сша: сша
машин: машину
лидер: лидер
процесс: процессе
подготов: подготовила
техник: техника техники
медицин: медицина
надолг: надолго
утечк: утечке утечки
европ: европе
постепен: постепенно
хотел: хотела
вытягива: вытягивать
культур: культура культуру культурой
передава: передавали
удив: удивились
провод: проводят проводятся
лнр: лнр
личн: личные личных лично личное
комфортн: комфортно
живет: живет
номер: номера
обраща: обращалась
подряд: подряд
помоч: помочь
помога: помогала
рынк: рынка
вечер: вечером
гостиниц: гостиницах
нрав: нравятся нравится
вылож: выложившего
материа: материала
сдают: сдаются
корейск: корейскую
помощ: помощь
выбира: выбирала
врач: врач врача
одет: одетые
любл: люблю
ужесточа: ужесточается
истечен: истечении
ереван: ереване
красив: красиво красивая
опыт: опыте
экскурс: экскурсии
заговор: заговорила
лор: лору лора
дал: дали
поинтересова: поинтересовались
жител: жителями
зонт: зонтами
документ: документы документов
будущ: будущем
приезж: приезжие
спокойн: спокойно
оплачива: оплачивать
задержа: задержаться
сопл: соплях
заведен: заведении заведений
вкусн: вкусно
собак: собаку
дан: данный данные
удивля: удивляют
спецпроект: спецпроекты
раскрыт: раскрыты
закон: закон
плох: плохо плохого плохое
росс: россии россия россией
фбр: фбр
ковид: ковид
гиперзвуков: гиперзвуковой
газ: газ
мотор: мотор
допуст: допустим
кор: корее
разрух: разрухи
познава: познавать
ситуац: ситуацию
пожалова: пожаловать
цикл: цикла
перевозк: перевозки
счита: считаю
таиланд: таиланд таиланда таиланде
причин: причина причинам
деньг: деньги
архитектурн: архитектурно
брат: брать
цел: целом целый
цен: цены цена
очк: очков
лент: ленте лента ленту
предлож: предложили
изуча: изучать
заран: заранее
кажд: каждым каждом
бордер: бордер
опечатк: опечатку
вынужд: вынуждена
галер: галереи
границ: границы границ границей
оцен: оценили оценил
российск: российского
монументальн: монументальный
организовыва: организовывают
политик: политике
вмест: вместе
взаимодейств: взаимодействий
минимум: минимум
плоховат: плоховато
выезжа: выезжать
покупа: покупай покупали
увидел: увидели
тупик: тупик
стыдн: стыдно
обнов: обновила
всяк: всякие всякими
поездк: поездка
разработк: разработке
жил: жилье жила жилья
увидет: увидеть
поколен: поколение
контейнер: контейнером
достаточн: достаточно
наступлен: наступлении
медиа: медианная
сюд: сюда
ссср: ссср
знаком: знакомились
мастерск: мастерские
итог: итоге
пыт: пытаясь
дел: дело делилась деле
рассказа: рассказала рассказать
студ: студия
помим: помимо
выслушива: выслушиваешь
коротк: короткие
развлечен: развлечения
так: такого таких
москв: москвы москве
никт: никто
нормальн: нормальным
пространств: пространство пространств
поменя: поменяла
сталкива: сталкивалась
срок: срок сроки
ручн: ручной
оплат: оплатили
красот: красоты
держа: держала
понрав: понравилось
аниматор: аниматором
существован: существования
воркшоп: воркшопов
август: августе
блогерш: блогерши
людьм: людьми
назва: назвал
материал: материалов
минус: минус минусы
собира: собирают собирается собиралась
массажн: массажный
снима: снимали снимаем
обсуд: обсудить
некотор: некоторые
звукозаписыва: звукозаписывающая
иска: искала
церемон: церемонии
куп: купи купил
кур: курить
подума: подумайте
обща: общались общался
аз: азии
удивительн: удивительная
такс: такси
коробок: коробок
увлека: увлекаюсь
диалог: диалог
куч: кучу куча
оформлен: оформления
кита: китаем
бар: бар
спорт: спорт
бат: батов
транспорт: транспорт
последн: последние
друз: друзья друзей
месяц: месяца месяцы месяц
зна: знаю
сал: салу
сам: самый
тво: твое
стереотип: стереотипов
стро: строится
захотел: захотел
жми: жми
тайц: тайцев тайцы
друг: друг друга
возвраща: возвращаешься
приход: приходил
длит: длится
сплетн: сплетнями
школ: школу школы
штамп: штамп
поня: поняла поняли
подобн: подобные
компан: компании компания
рассказыва: рассказывала
полеп: полепить
гост: гости
программ: программе
коммуникац: коммуникация
переезжа: переезжать
получа: получаешь получается
творог: творога
ира: иран
главн: главное главный
нашл: нашла нашли
записа: записался
женщин: женщина женщиной
жутк: жутко
наруша: нарушают
приезжа: приезжают
стоя: стояли
популярн: популярных популярные
смертельн: смертельной
рад: рады
простот: простоте
цвет: цвет
магазин: магазина магазин магазине
улыба: улыбаются
пентагон: пентагона
уеха: уехала
сво: своими своему свой
ран: ран
паспорт: паспорта
нача: начали
действен: действенная
реша: решать решаться
арендн: арендную
интернет: интернет
россия: россиян
прода: продаются
волос: волосы
рекорд: рекорд
возникл: возникли
вечеринк: вечеринки
комьюнит: комьюнити
приличн: прилично
вещ: вещей вещи
рефлексирова: рефлексировала
груз: грузию
привычн: привычной
пришл: пришлось
груб: грубила
несезон: несезон
продлен: продление
выстраива: выстраивается
знал: знал
уничтожен: уничтоженных
бес: бесило
технолог: технологии
соотечественник: соотечественников
рамк: рамках
зеленск: зеленского
поеха: поехать
прощ: проще
хвата: хватает
прилетел: прилетела
работа: работаю работаешь
нанесен: нанесения
прос: просила
ценност: ценности
долг: долгое
долж: должен
воск: воска
пар: париться
ед: еды еду
виз: визу визы виза
кошек: кошек
знатн: знатно
необходим: необходимые необходимо
ем: ем
истор: историю историй история
числ: число
ход: ходила ходить ходим
довер: доверилась
чист: чистых
подозрева: подозреваемого
сотруднича: сотрудничать
пойт: пойти
бабушк: бабушками бабушка
вид: видит виду вид
представител: представителей
сет: сети
виде: видео
разбит: разбитые
разрешен: разрешения
мастер: мастерам мастера мастер
безвизов: безвизового
реб: ребят
водител: водителя
тайск: тайский тайскую
армен: армению армении
спрос: спросом
зуб: зубы
цепля: цепляются
наук: наука
хот: хотите
пережива: переживать
переезд: переездом
дом: домом дом дома
реш: решила
международн: международной
известн: известно
дор: дорого
общ: общем
юбк: юбки
пригожин: пригожин
обитан: обитания
армянск: армянскими
недел: недель
тысяч: тысячи
побыва: побывать
хозяин: хозяина
ненавист: ненавистью
принцип: принципе
хорош: хорошую хорошие хороших хорошая
стоимост: стоимость
повод: поводу
азиатск: азиатскую азиатской
ид: иди
базар: базар
сред: среда
поест: поесть
им: имею
наш: нашим
грамм: граммов
прикольн: прикольно
мног: многие
люб: любит
палк: палка
можеш: можешь
плат: платить плату
похуден: похудения
язык: языков язык
умн: умных
план: плане
фот: фото
доллар: долларов
обязательн: обязательно
арестова: арестовало
автобус: автобусе
нат: нато
информац: информация
выгодн: выгоднее
больниц: больницы
салон: салоны салон
соседк: соседками соседка соседки
пхукет: пхукет
сход: сходить
негативн: негативный
разн: разные разному
письм: письма
дневн: дневный
трат: траты
таиландсюжетц: таиландсюжетцены
люд: людей
дожд: дождем
английск: английский английском
открыва: открываться открываются
ко: ко
поговор: поговорила
особ: особо
сумасшедш: сумасшедшие
закрыт: закрытое
каскад: каскадом
участлив: участливые
постарш: постарше
напл: наплыв
героин: героиней
например: например
знает: знает
одн: одна одном
полулегальн: полулегальная
отправля: отправляйте
продаж: продажу
внж: внж
самостоятельн: самостоятельно
коллег: коллегам коллег
маркет: маркет
классн: классно
забот: забота
отращива: отращиваю
понятн: понятное понятно понятным
улиц: улицам
потребн: потребность
удовик: удовик
приеха: приехать приехала
сми: сми
поосторожн: поосторожнее
стычк: стычки
плюс: плюсы
польз: пользуется
подня: поднять подняться
музык: музыки
апрел: апреля
мусор: мусора
проживан: проживания
заплат: заплатить
россиянк: россиянки
воз: возят
стран: страна странах страны стране
аренд: аренда аренду аренды
электрон: электронный
мо: моих моей моими моем
потрат: потратиться
громк: громкой
южн: южной
местн: местными местные
горазд: гораздо
душ: душа душой
смотрел: смотрела
япон: японии
испытан: испытании
войт: войти
еха: ехать
саба: сабай
комплекс: комплекс
глаз: глазами
наскольк: насколько
проблем: проблемы
айтишник: айтишников
алис: алиса
ювелирн: ювелирное
заяв: заявили
автоматическ: автоматическое
болезн: болезни
похож: похожих похоже
армянк: армянки
ракет: ракеты
ярмарк: ярмарки
чайн: чайные
новост: новости
перв: первые первых
быдл: быдло
дума: думала думают
окрашиван: окрашивания
добр: добро добра
оо: ооо
интересн: интересно интересных
оп: опыт
возможн: возможно
всу: всу
равн: равно
молод: молодому молодое молодой
возл: возле
короч: короче
коробк: коробки коробку
планир: планирую
открыт: открытые открыта
брос: бросил
зонтик: зонтик
краснееш: краснеешь
пребыван: пребывания
как: какие
турист: туристов
крут: круто
болел: болела
матер: материться
повлия: повлияло
каф: кафе
сюжет: сюжете
трога: трогать
бойц: бойцов
выпуск: выпуска
наверн: наверное
бывш: бывший
реальн: реальный
втор: втором вторых
точн: точно
арендова: арендовать
ерева: ереван еревана
дешев: дешевая дешево
сфер: сфера
преимуществен: преимущественно
вселюдизвериедапроисшествияперсонысчастливчикианомал: вселюдизвериедапроисшествияперсонысчастливчикианомалии
откр: открыли
достопримечательн: достопримечательность
наход: находились
армян: армяне
слуша: слушать
lenta: lenta
ru: ru
killnet: killnet
tuf: tuf
ctrl: ctrl
appl: apple
enter: enter
life: life
