сунул: сунули
обыча: обычаи
ру: ру
говор: говорила говорят
фактическ: фактически
поварих: поварихой
просоветск: просоветской
стат: статьи
воен: военной
казак: казаки
обычн: обычную
оказа: оказали оказались
пароход: пароход
памятник: памятнике
стал: стали ситуацию
перееха: переехали
мнен: мнению
объясн: объяснили
превыша: превышало
работ: работам
заход: заходишь
помянут: помянуть
север: север
арх: архив
экономик: экономика экономики
водк: водку
сто: стоят
выряд: изменили
манхэттен: жилья
просматрива: просматривается
сср: сср
плодородн: плодородную плодородная
охот: охота
пункт: пунктов
поступ: поступило
неспособн: неспособные
интеграц: интеграцией
макияж: нанесения
арм: армию
разговор: разговоре
морск: морские
должн: должны
кирпич: кирпича
структур: структуры
партизанск: партизанского партизанске
макс: макс
благодар: благодаря
назван: названия
котор: которое которую
лошадьм: лошадьми
силов: силовые
благ: благ
выреза: вырезали
секретн: выложившего
запад: западе
печен: печеньем
заманива: заманивали
шаг: шагов
железнодорожн: железнодорожных железнодорожном
связа: связана
регистрирова: регистрировали
самостийн: самостийность самостийной
отмет: отметила отметил
либ: либо
связ: связь
весн: весной
появля: появлялись
присматрива: присматривали
дела: делать
республикуциклот: республикуциклот
едет: едет
полага: полагаю
киевск: киевской
член: членов
устраива: устраиваются
хребт: хребта
книг: книги книге
центральн: центральной центрального центральных
беремен: беременная
скарб: скарб
малинов: лицом
украинк: украинках
врем: времена времен
альтернатив: альтернативой альтернативы
лин: линии
россиянин: болезни
изготавлива: изготавливали
обжит: обжитом
сосед: соседей бросил
занима: занимал занимали занимался занимались
постро: построил построили
свободн: свободны
лих: лихих
высеч: высечены
лиц: ним
родин: родину
украинц: украинцам украинцев украинцами украинцы
очевидц: очевидцев
нов: новую новых новые китаем новое
обошл: елизавета
двинул: двинулись
нож: ножи
част: часть частью
пожил: пожилая
уезд: уезда
завод: завод
выписа: выписал
сдела: сделать
выдава: выдавали
выкопа: выкопал
деактивирова: нажмите
сложн: сложно
переселя: переселялись
зажиточн: зажиточными
пут: путь
ночлег: ночлег
активн: активные активности
русск: русские русских русском русское русскими
пример: пример
чертов: вырядились
природ: природы
неизмен: неизменно
невероятн: невероятная
государствен: государственное государственного
окун: окунев
летн: летний внешности
отмеча: отмечает
натал: наталья
нелегальн: нелегально
архив: архивы архива
труд: трудился
путешеств: путешествия
крестьян: крестьяне
старик: старики
автоном: автономию
решетняк: решетняка решетняк
дальневосточник: дальневосточники
сша: сша
ресурс: ресурсов
миха: умер
лидер: ракеты
съезд: съезде
групп: групп
техник: техника
выпуска: выпускал
окрестн: окрестностях
наркомат: наркомата
хотел: хотели
культур: культура культуры
лнр: популярные
продолжа: продолжает продолжалось
помидор: помидорам
ловл: ловля
бесплатн: бесплатной
неизвестн: неизвестно
современ: современной
врач: нато
потерпел: потерпели
выступ: выступили
проеха: проехали
вклад: вклад
трудодн: трудодни
арбуз: арбузы
жител: житель жителей
мигрирова: мигрировало
разделыва: разделывают
подчеркива: подчеркивают
ожив: оживились
сравнен: сравнению
потребова: потребовала
волновах: волновахи
отключ: отключены
спецпроект: спецпроекты
протяжен: протяжении
рост: ростом
росс: россии россия россию сотрудничать
мисс: миссии
обширн: обширные
употребля: употреблял
фбр: пентагона
крестья: крестьян
отправлен: отправленных
уссурийск: уссурийском уссурийск
земельн: земельную земельных земельного
преуспел: преуспели
мотор: мотор
извест: известен
числен: численность
ситуац: утечки
выдач: выдаче
спецпоселен: спецпоселение
цикл: материалы
перевозк: перевозки
счита: считаются считались
причин: причине
утвержден: утверждения
архитектурн: архитектурным
окружн: окружная
цел: целых целом целую
гипертрофирова: гипертрофированную
спецоперац: спецоперации
обезлюдел: обезлюдел
отлича: отличались
лент: ленте ленту ленты лентой лента
подальш: подальше
опечатк: нашли
миграц: миграции миграция
российск: российского российском российской
суча: сучан
золот: золотых
администрац: администрация
веден: ведения
юг: юго
серьезн: серьезным
использова: использовали
уточня: уточняет
юр: юрия юрий
прибыт: прибытии
благополучн: благополучных
дворян: дворянам
всеукраинск: всеукраинском
сказа: сказали
ссср: ссср
езд: ездить
посылк: посылку
меньш: меньших
сталинск: сталинские сталинских
след: следили след
строк: строки
организац: организациями организации
заселен: заселения
помим: помимо
суверенитет: суверенитета
параллельмо: параллельмоя
прабабушк: прабабушку
убит: убитых
зелен: зеленый
так: такого таких
парамонов: парамонова
расселя: расселяли
примор: приморье приморья
событ: события
выясня: выяснять
течен: течению
уменьша: уменьшался
февральск: февральской
гарнизон: гарнизон
черкасск: черкасской
выходц: выходцы выходцами
заметн: заметно
блогерш: летней
назва: пригожин
головн: головные
внесл: внесли
переправ: переправили
остановк: остановке
океан: океану океане
игор: игорь
полев: полевым
количеств: количество
соглашен: соглашения
служа: служащим
твор: творится
собеседник: собеседник
попа: попали
остава: оставалось
богатств: богатстве
спорт: спорт
промысл: промыслами промыслов
мариупол: мариуполя
услов: условиям условиях
стро: строили строить
рсфср: рсфср
хабаровск: хабаровская хабаровске хабаровска
бежа: бежали бежать
приход: прихода
мехед: мехедов
сомнева: сомневаться
народ: народу
компан: компании
рассказыва: рассказывает рассказывали рассказывала рассказывал рассказывать
проруб: прорубая
программ: россией программы
тайг: тайгу
получа: получали
главн: главное
действ: действий
октябр: октябре октября
сестр: сестра
приезжа: приезжали
поражен: поражение
переманив: переманивая
отдел: отдел
рад: радой раду рада
созда: создать
монастырн: монастырных монастырные
ран: ранней
одесс: одессе одессы
нижн: нижнему
нын: ныне
паспорт: паспортов
исход: исход
отдельн: отдельные
караван: караваном
большевик: большевики большевиков
деревн: деревни
интернет: интернет
реализац: реализации
московск: московского
сибир: сибирь
огурц: огурцам
бегл: беглый
колоссальн: колоссальное колоссальный
деревя: деревянные
всеобществополитикапроисшествиярегионымоскв: всеобществополитикапроисшествиярегионымосква
тем: тему
основател: основателями
владивостокск: владивостокской
великобритан: великобританией
пришл: пришли пришлась студентке
кузнец: кузнецом
зерка: зеркала
комментар: комментарии
беженц: беженцев
находк: находки
колонизац: колонизации
приступ: приступила приступило
работа: работают работать работал работали
сильн: сильное
нанесен: блогерши
репресс: репрессий
долж: должен
амур: амура амуру
переброск: переброску
вызва: вызвана
десятилет: десятилетий
услуг: услуг
харьковск: харьковской
преподаван: преподаванием
числ: числа назвал числе
перебира: перебирались
правител: правителю
период: периодом период
подозрева: арестовало
вынужден: вынужденно
подсчита: подсчитать
сотруднича: захотел
демократическ: демократическом
дров: дров
автор: автора
бабушк: бабушке бабушка
виде: видео
ликвидац: ликвидации
остр: острее
объявл: объявлены
подольск: подольской
приключен: приключений
попада: попадали
ливийск: ливийской
намет: наметился
едут: едут
историческ: историческую
звуча: звучали
сельск: сельского
оста: остался остаются
прошеств: прошествии
заготовк: заготовкой
чугуевк: чугуевка
тих: тихому тихом
заселя: заселяли
альтернативн: альтернативные
реш: решили решить
олег: олег
общ: общего общем
гражданск: гражданской
пригожин: политике
обитан: обитания
высказыва: высказывалась
довест: удалось
поддержива: поддерживали
рек: реки
предпринимательск: предпринимательской
культурн: культурным культурные
телег: телеги
усср: усср
сред: среда среди
небыт: небытия
социальн: социальных
распад: распада
запелена: запеленали
эвакуац: эвакуации
погибл: погибло
мног: многие многих
ножовк: ножовки
утвар: утварь
люб: любят
похуден: уколов
язык: языке языках удалить
переселенческ: переселенческого
останов: остановился остановиться
фот: фото
обязательн: обязательно
прибегл: прибегли
взят: взятия
коллективизац: коллективизации
правд: правда
разн: разных
дальневосточн: дальневосточной дальневосточную дальневосточного дальневосточная дальневосточным
документооборот: документооборот
освоен: освоение освоения
планет: планете
люд: людей
отправк: отправкой
пиджак: малиновых
год: годы
лагер: лагерями
открыва: открываться
зачаст: зачастую
погруз: погрузили
ставк: ставку
мигрант: мигрантов
прич: причем
принадлежа: принадлежали
разреша: разрешалось
сахар: сахарой
волн: волны волна
одн: одном одни
мам: мама
продаж: выставил
широк: широкого
согласн: согласно
мат: мать
приб: прибыли
подобра: подобрать
гаван: гавани
улиц: улица
потребн: лнр
свидетельств: свидетельствуют
ханк: ханка
масс: масса
петр: петра
антибольшевистск: антибольшевистски
устрем: устремились
выда: выдать выдали
нехитр: нехитрый
кровопролитн: кровопролитных
иконк: иконками
стен: стене
топор: топором
десятк: десятки
регион: региона регион регионы регионах
войн: войны
историк: историк
камчатк: камчатке
испытан: стало
песн: песни
войт: войти
спровоцирова: спровоцировали
массов: массовой массовый
еха: ехали
интересова: интересовали
глав: главе
рушник: рушники рушник
состав: составили
кролевц: кролевцы
глаз: глазами глаз
деятельн: деятельности
совокупн: совокупное
колчак: колчаку
десятилетн: десятилетний
топонимик: топонимике
посадк: посадка
поселен: поселений
печата: печатались
бос: босые
сарафа: сарафаны
болезн: смертельной
украинск: украинского украинское украинском украинских украинские украинской украинскую украинскими украинский
половин: половина
похож: похожие
ракет: гиперзвуковой
хлев: хлевов
шахтер: шахтером
новост: новости
перв: первой первые первым первая первое первом
харбинск: харбинские
приня: принял принявшей
коров: корову
добр: добрым деактивирована добра
равн: равно
альперт: альперт
повес: повесили
чукотк: чукотке
как: каких
встреча: встречались
заполн: заполнила
закитайщин: закитайщина
земледел: земледелия земледелие
род: родиться роду
высок: высок
реальн: пожаловать
сосла: сослали сослана
втор: вторая
точн: точное
сфер: сфере программе
способ: способы
признан: признание
форм: форму
мер: мерам
приамур: приамурья приамурье
клин: клин
признак: признаки
губерн: губернии губерний
обрат: обратились
готов: готовы
влиян: влияние
студентк: похудения
костин: костин
независим: независимую
занят: занятием
обоснова: обосновались
ввод: вводился
столыпин: столыпина
конц: концу перестройку
эмиграц: эмиграции
рот: рот
жительств: жительства
развеша: развешаны
каменец: каменец
перепис: переписи
появ: появились появилась появился
призва: призвала
удал: пришлось
кневич: кневичи
практическ: практически
вернут: вернуться
климатическ: климатическим
вернул: вернулась
планов: плановых
конфликт: конфликтом конфликтов конфликта
четверт: четвертой
александр: александру
поют: поют
предк: предков предки
сошл: сошла
вообщ: вообще
единствен: горбачев
веревк: веревки
пересыльн: пересыльными
отъезд: отъезд
личност: раскрыли
поезд: поезда
х: х
переселенц: переселенцев переселенцы
поэт: поэтому
счит: считая
мир: мир
укол: популярных
накромса: накромсали
землепроходц: землепроходцы
вывеск: вывески
исследован: исследования
воинск: воинские
внешност: удивились
орга: органы
вагнер: чвк
нажм: опечатку
ива: иван
резк: резко
формирова: формировать
литер: литерой
волынск: волынской
боев: боевых
власт: властью власти
получ: получила
саблин: саблин
приобрел: приобрела
суражевк: суражевка
жительниц: жительница
фронт: фронте
город: городов городах
газет: газеты
удельн: удельному
национальн: национально
забира: забирайте забирали
украин: украиной украины украину украине
националист: националисты
гранат: соседа
внутр: внутри
раскр: последние
традиц: традиции
выстав: лидер
покинут: покинуть
могл: могли
движен: движения
матушк: матушка
анастас: анастасия
больш: большое
мест: место месте места
вырва: вырваться
калинк: калинки
везут: везут
счет: счет
киевк: киевка
принудительн: принудительных
существен: существенных
эффективн: оценил
видет: видеть
испытыва: испытывали
представительств: представительство
редакциярекламаконтактыпресс: всу
надея: надеялись
жал: обошлись
жизн: жизни
комаров: комарова
импер: империи
надел: надела наделов
деятел: деятели
солдат: солдаты
самовольн: самовольных
зашедш: заявили
населен: населенных населения населением население населении
сформирова: сформированы сформировать
чвк: уничтоженных
сокращен: сокращение
пыта: пытаются пытались
перестройк: довести
изредк: изредка
основн: основным основном основная
сихотэ: сихотэ
единиц: единицы
основа: основанных основали
нажит: нажитое
скрыва: скрывался
монограф: монографии
изб: избы
утечк: подозреваемого оценили
решен: решение
дефиц: дефицит
хат: хаты
оун: оун
сундук: сундуки
удив: сети
провод: проводила
личн: продажу
домашн: домашнюю
делегат: делегаты
советск: советской
ощуща: ощущался
искател: искатели
вылож: личность
нужд: нужду
генсек: генсеков
верховн: верховному
результат: результате
опыт: опыту
красив: красиво
полож: положил положили
передвинул: передвинулись
документ: документы документу утечке
предложен: предложение
дербер: дербера
ссылк: ссылка
преобладан: преобладанием
пристан: пристань
загадочн: загадочного
елизавет: дети
тэц: тэц
жен: женами жена женился женились
поедет: поедет
дан: личные данным
белорусс: белоруссии
полтавк: полтавка
установ: установили
имен: именем
войск: войсками
состоя: состоял
раскрыт: рекорд
царск: царские царских
суров: суровое
донбасс: донбассе
коз: козьим
сократ: сократилось сократился
мелк: мелких
гиперзвуков: новой
издава: издавать
цгав: цгаво
пожалова: добро
ссылок: ссылок
перекопа: перекопала
подвергл: подверглись
брат: братьев
четвер: четверо
вышит: вышитые
барабаш: барабаш
чит: чите
очк: умных
трудолюб: трудолюбием
добровольн: добровольно
возника: возникало
галер: галереи
границ: границу
оцен: очков врач
двр: двр
сохран: сохранили
восток: востоке востока восток востоку
остров: острове
политик: тупик
рыб: рыбу
уход: уходом
возведен: возведенные
муж: муж
тупик: зашедшей
обнов: манхэттене
правительств: правительство правительства
настроен: настроенных
жил: жили аренды
увидет: увидеть
черниговк: черниговки черниговке
имуществ: имущество
стара: старались
начал: начале
совнарк: совнарком
заня: занялись
потомк: потомки
наступлен: зеленского
добровольц: добровольцев
медиа: документов
высш: высших
кра: края
има: иман
повернул: повернулась
произошл: произошло
дед: деды дед
интеллектуал: интеллектуалы
колхоз: колхозы колхоз
дел: делая
рассказа: рассказала
деп: депо
пришел: пришелся
конкуриру: конкурируя
активист: активисты
озер: озера
обществ: общества
никт: никто
порт: порту
пространств: пространства
полност: полностью
усил: усилилась
срок: срока раскрыты
собствен: собственную собственностью
станц: станциях
измен: пиджаках
следств: следствие следствия
красот: красота
японск: японской
территор: территорию территории территорией
уда: жалею
землянк: землянку
разнообраз: разнообразием
невыработа: невыработанные
дет: чертовы
людьм: людьми
полтавск: полтавской
материал: президент
пахотн: пахотные
восточн: восточного
куп: купил
арест: аресту
мамалыг: мамалыги
окраин: окраины окраину
кита: испытании китае
район: районов района
хозяйствен: хозяйственной
ряд: ряде
последн: цикла
таврическ: таврической
сам: самых
уроженц: уроженцы
захотел: иран
жми: жми
детьм: детьми
организова: организованных
переда: передали
школ: школы
бо: боев
образован: образование
подобн: подобных
развертыван: развертыванием
прирост: прирост прироста
управлен: управления
ира: макияжа
приграничн: приграничных
характер: характер
нашл: ооо
снег: снега
рыболовн: рыболовные
николаевск: николаевска
век: века
предполага: предполагалось
западн: западных западной
вес: весу
популярн: эффективность музыки
мужчин: мужчины
урка: уркан
смертельн: язык
област: областей областях области
созрева: созревают
пентагон: секретные
сво: своими своим
уеха: уехать уехала
пропитан: пропитания
нача: начало начали
громад: громады громада
фортун: фортуна
уголок: уголок
поселенц: поселенцам
значительн: значительный значительно
го: го
аннулирова: аннулированы
потрясен: потрясениями
рекорд: обновила
черкасс: черкассах
ощутим: ощутимый
теря: терять
развит: развитие
горбач: михаил
рыбн: рыбная
уничтожен: число
выясн: выяснила
убор: уборы
зеленск: потребность
тряпк: тряпку
трет: третья трети
ценност: ценности
подразделен: подразделения
сегодняшн: сегодняшней
пар: пару
ссыльн: ссыльных
вил: вили
истор: истории история
двум: двумя
пробл: проблему проблем
сел: село селе селу села селились селах
сем: семья семью семьями семье семьи семей
даманск: даманском
вид: видишь
представител: данные
сет: наступлении
обув: обуви
умел: умел
екатеринославск: екатеринославско
умер: конца
внов: вновь
всплеск: всплеск
красн: красного
доход: дохода
естествен: естественного
николаевк: николаевка
дореволюцион: дореволюционным
наук: наука
стрем: стремился
малозаселен: малозаселенные малозаселенной
наказа: наказанные
возрод: возродились
эпох: эпоху
зе: зея зеи
дом: дому домами дом дома домах
известн: известно известные
сторон: стороны
поток: поток
тысяч: тысячи
родственник: родственники родственник
родн: родную
хорош: хорошие
стоимост: медианная
ид: идеи
подконтрольн: подконтрольно подконтрольная
ил: илья
переселен: переселению переселения переселение переселением переселений
наш: нашей нашу наших нашего
республик: республика республику
суражск: суражского
просьб: просьбой
сил: сил
умн: выпуска
план: план
арестова: фбр
нат: представителей
составля: составляло
информац: редакциярекламаконтактыпресс
строительн: строительные
призыв: призывы
земл: земли земля землю
никольск: никольске
хозяйств: хозяйства
семимесячн: семимесячным
берег: берег берегах берега берегу
забра: забрать
сестер: сестер
английск: английском
двор: дворов
трудност: трудности
пополн: пополнилось
закрыт: закрытия
очерк: очерки
дочер: дочери
дальнереченск: дальнереченске
например: например
артем: артема
снаст: снасти
живут: живут
миров: мировой
забот: забота
приток: приток
мазанк: мазанки
президент: единственный
каторжанин: каторжанин
масштаб: масштабах
сми: сми
огромн: огромный огромной
белогвардейск: белогвардейских
священник: священника
музык: громкой
стран: страна страны страну
аренд: стоимость
свет: свет
мо: мою моим моей
неприязн: неприязни
громк: гранатой
южн: южную
осваива: осваивали
местн: местных местные местная
васильченк: васильченко
чистк: чисткой
марлев: марлевую
качеств: качестве
лошад: лошадях
пил: пил
забуд: забудь
государств: государстве
благовещенск: благовещенске
владивосток: владивосток владивостоке владивостока
голубовк: голубовка
бушуйк: бушуйка
подъемн: подъемных
заяв: сфера
алин: алинь
киев: киеве
уборк: уборкой
самообеспечен: самообеспечением
приморск: приморского
отважива: отваживались
амурск: амурской
орган: органов
небольш: небольших
относ: относятся
корм: кормила
черниговск: черниговской
оо: информация
дальн: дальнем дальний дальнего
всу: бойцов
молод: молодые
сливянк: сливянку
коробк: коробку
уголк: уголков
брос: бросили россиянин
буквальн: буквально
обещан: обещанием обещаниями
демонстрац: демонстрация
сварич: сварич
крупн: крупное
соф: софия
китайц: китайцам
дмитр: дмитрий
молок: молоком
бойц: вагнер
харбин: харбине
выпуск: сроки
пустын: пустыней
прежд: прежде
бывш: бывший
пмж: пмж
становлен: становление
уничтож: уничтожить
федеративн: федеративном
откр: открылись
миллион: миллиона
рыбак: рыбаки
июн: июне
ри: риа
революц: революции
наход: находившиеся
источник: источником
погиб: погиб
xx: xx
ii: ii
killnet: killnet
ctrl: ctrl
xix: xix
appl: apple
wikipedia: wikipedia
enter: enter
