жертв: многотысячные
париж: кредиты
говор: сеть
слух: отреагировал
ру: ооо
банк: всемирного
влиян: очков нато
студентк: похудения
америк: рожать
независим: независимость
значен: рассказал
стат: статьи
воен: рисках получил жертвы
обычн: обычную
оказа: реформы
стал: фронте югославию
дорог: лежащий
си: союзы
удал: пришлось
призва: сексе
азбук: базе
последств: назвали
разрушен: трепет возродил
центр: экономический
белград: бомбежки
север: война
вернут: вернуться страны
арх: архив
экономик: крупнейших проблемы экономика
миг: истребителей
мид: ирак
конфликт: конфликта кндр
заморожен: вернут
радикал: боевиками
сто: военного
манхэттен: жилья
баскетболистк: наркотики
украинец: столкновения
аэростат: шпионские
единствен: остается
преврат: сяопин
арм: армия
свержен: образцом
макрон: раскритиковали
личност: установили раскрыли
дезинформац: организацию
структур: структуры
суд: тюрьмы
экс: трампом
всемирн: сотрудникам
шар: померились
перепута: войны
сообщ: натовское
ю: куан
провест: призвал
мир: мир власти
укол: популярных
силов: силовые
секретн: секретных ним дороге
запад: века
поджег: украинец
визит: миру
вагнер: чвк
скор: заявил
нажм: опечатку
подстав: байдена
конец: спрогнозировали
феврал: державой
оон: оон
нло: нашествии
норвег: посольство дипломатов
власт: властей свержения
получ: утечкой
европеец: немец
фронт: ситуацию
обеспоко: доме
косов: началась
важн: важнее
персон: объявила
вывел: ю
разведчик: самолетом американский
город: разрушенные
байд: решении сын
книг: написала революций
беремен: тысячи
экономическ: колонию
час: тяжелый
украин: украине украины
гранат: соседа
саудовск: помирил
сделк: зерновой
отец: главы
раскр: кризисом
актив: замороженные
выстав: лидер
лин: красные
россиянин: болезни
сосед: бросил
обвиня: президента
предупред: разведчик генсеком
встреч: отца
пенсион: беспорядки
истребител: передачу
отстал: нищеты
нов: новые китаем
нарушен: предотвратила
миллиард: передаст
цб: активы
нон: персонами
предполож: отправляет
слов: отреагировали
проукраинск: обвинил
дональд: ад
вучич: сотрудников
сдела: голль
эффективн: оценил
поруча: банка
видет: видеть
гран: оказалась
деактивирова: нажмите
грат: нон
мягк: мягкое
редакциярекламаконтактыпресс: сообщил
вспомн: людей
совет: неоколониализма
пут: путей музыки
жизн: жизни
дэн: кардинал
импер: империи
чвк: играет
самолет: норвежским
шарл: доверилась
немец: запада
момент: переломный
поссор: аэростаты
многотысячн: города
мор: балтийского
путешеств: путешествия
кндр: запуск
сша: сша
лидер: ракеты
техник: техника
утечк: расследования утечку утечке утечка стоявший
европ: всей
решен: поможет анонсировали
культур: культура
боеприпас: передаче средств
удив: удивила
личн: продажу
нужн: данных
отц: подставил
регбист: перепутал
помога: вместе
югослав: распад разрушила
биолаборатор: расследование
вылож: личность
опаса: стоит
еврокомисс: еврокомиссия
генсек: генсека шпионаже
помощ: американской
врач: представителей
беспорядк: франции
попытк: силы пожаловались
усомн: балканы
опасн: предупредил
ракетн: ответил
жител: пакетах
цветн: революция
документ: выложившего секретный документов документах
будущ: определил
гутерриш: гутерриша
выделен: утвердил
сын: лаврова побега заискивать
опровергл: опровергли
вторгл: преступления
расследован: завершении провести
средств: выделение
натовск: моря
дан: секретные каналах
роков: америке
балтийск: превращения
дат: дата
установ: италии
спецпроект: спецпроекты
слит: слитых
раскрыт: рекорд
росс: россии воевать россия
фбр: фбр
гиперзвуков: новой
разруш: цветная
финлянд: президент
угрожа: суд
мотор: мотор
допуст: центр
кор: южной
пожалова: добро европы
ситуац: влияние
отсутств: отсутствии
причин: высказались
раздража: выгодно
переломн: миг
цел: вероятная
очк: умных
лент: лента ленту
фраз: вступление
забастовок: протестов
мирн: маловероятными
дипломат: ответить
наркотик: сидевшая
опечатк: нашли
пройд: линии
галер: галереи
границ: нарушение
оцен: врач сво японии
российск: грата российской
незакон: обвиняют
канал: возможных
всеполитикаобществопроисшествияконфликтыпреступн: всеполитикаобществопроисшествияконфликтыпреступность
вмест: путь
умышлен: умышленной
британ: житель
золот: конец
ошибк: роковой
обнов: манхэттене
иностра: участие
преступлен: военные
правительств: отставки ошибкой
шпионаж: уличили
завершен: скором
жил: аренды
африк: союз помогает
продолжен: условия
пособник: личности
руководств: смены
маловероятн: февраля
путин: отношения
медиа: последние
заподозр: разведка
список: черный
ссср: ссср
масштабн: грани
нашел: британии
разведда: поддержке
организац: допустили
аргентин: едут
рассказа: геймеров сыном
игра: роль
сохраня: страной
высылк: раскритиковало
помир: изменится
проигра: детьми
ответ: пообещали опасаться
губернатор: сына
геймер: сообщество
москв: приезжал
несмотр: пройдены
срок: раскрыты
арав: саудовскую
баз: военной
мощн: угрожает
измен: сил косово
британск: регбистов
назва: названа мировой назвал пен отдалиться
трепет: шок
утверд: совет
превращен: разведданных
смен: риски
отношен: испортить отношение
застав: поссорили
ад: катится
аграрн: бедный
арест: ареста
отреагирова: сербии раздражает
турц: севере
конрад: христианин
диалог: прокомментировал
кратчайш: кратчайших
кита: заподозрила испытании конфликте
спорт: спорт
шок: биолабораториях
последн: оценили заявили
кредит: многомиллионные
куа: нации
услов: обнародования назвала
жми: жми
детьм: встрече
израил: израиль австралии
крах: неминуемый
тайн: планировании
захлестнул: помощи
вероятн: утечки затягивании
ира: аравию
главн: главное
нашл: ру
велик: аграрный сделал
век: золотого
испорт: попытке
приезжа: цзиньпин
внедр: попытки
вступлен: вероятность описал
поможет: москву
стоя: крах
поражен: последствия
популярн: эффективность
смертельн: язык
бедн: превратил
отстоя: отстоял
созда: зависимости создал
пентагон: пентагона
спрогнозирова: вагнер
байден: документ
лавров: виз
сво: ходе
нача: югославии поставить
реша: фразой
протест: волна
профессор: американского
посольств: российского разведчиком
передач: польше слухи
лежа: нашел
интернет: интернет
оруж: поставок
пообеща: мид
рекорд: обновила
тем: диалог
помер: губернатора
воева: призывом
великобритан: нло
пришл: студентке
де: шарль
анонсирова: германии
бел: рисками тюрьме
реформ: судебной
многомиллион: предоставит
нищет: сингапур
предрекл: китае
сотрудник: высылку трамп
трет: опасности
сидевш: радикалами
ценност: ценности
виз: значении
треб: пенсионной
высказа: революции
еврейск: еврейский
осуд: кореи
ход: потери ход
довер: час
ес: ес
швейцар: боеприпасы
слежк: слежка
подозрева: подозреваемого
аденауэр: конрад
пробл: решает
кризис: масштабного мощнейшим
раскритикова: разведки норвегии
призыва: правительства
сяопин: дэн
сет: утекли
представител: личные инструкцией
виде: видео
разрешен: попросила
едут: россиянок
рожа: хотят
красн: посольства россией
неминуем: предрекли
зернов: участия
боевик: британскими
оста: турция риске
сингапур: вывел
грайнер: баскетболистка
наук: наука
хот: аргентину
разреш: германия
возрод: аденауэр
дом: белом белый
известн: стало
возросш: предупредили
постав: разрешение
ирак: вторглись
затягиван: киеве
пригожин: пригожин
предостав: великобритания
поддержк: усомнились
обитан: обитания
голл: де
тысяч: осудили
хорош: хорошие
стоимост: медианная
серб: проблем
колон: азиатскую
азиатск: отсталую
сред: среда
нац: отец
распад: белграда
оборон: оборона
зависим: слова
похуден: уколов
плат: незаконно
выгод: момент
язык: удалить
планирован: китай
нашеств: вспомнить
сил: всу проукраинские баланс
умн: выпуска
доллар: миллиарда
арестова: арестовало
нат: силах
гроз: трампу
держав: великую великой
описа: финляндии
информац: редакциярекламаконтактыпресс
выгодн: иран
призыв: поджег
столкновен: рисков
образц: стала
прокомментирова: дом правительстве
люд: заставили
пен: ле
огн: париж
объяв: норвегия
балка: изменила
пакет: последних
отдал: призыв
предотврат: оружия
черн: внес
трамп: дональду начался переговоры
волн: захлестнула
одн: державу
продаж: выставил
отправля: экономике
россиянок: беременных
ле: экономик
миров: третьей
приз: макрона
забот: забота
улич: сохраняющей
запуск: ракетный
президент: экс марта
попрос: польша
польш: разрешила цб
поставок: тайных
сми: сми
итал: тему
сообществ: внедриться
молчан: порнозвезде
музык: громкой
апрел: апреля
австрал: вступления
цзиньпин: си
союз: создает выгоден
утекл: данные
стран: влиянии проиграли единственной байдене
аренд: стоимость
участ: продолжения предположили
инструкц: профессора
побег: пособников
громк: гранатой
южн: представители
войн: условие разрушенную нужна
япон: израиля
март: кризиса
испытан: известно
войт: войти
заискива: поручали
глав: визита
обвин: вучич
проблем: несмотря
подробн: подробности
секс: молчание
заяв: байден заявила долларов
баланс: решение
киев: руководства
болезн: смертельной
обнародован: цель
ракет: гиперзвуковой
новост: новости
шпионск: шарами
юнош: юноша
добр: деактивирована добра
христианин: европеец
написа: грайнер
оо: информация
возможн: дезинформации названы
всу: потерях
франц: огне
бомбежк: страну
американск: остаться книга боеприпасов
брос: россиянин
внес: поражения
порнозвезд: платил
отставк: требуют
как: африкой
определ: германию
крупн: одну
все: будущее
герман: путиным список войной
судебн: забастовок
повлия: повлияет
кат: страна
кардина: красный
переговор: мирные
тюрьм: книгу грозит
выпуск: сроки
передаст: швейцария
бывш: бывший
реальн: пожаловать
тяжел: прокомментировали
рол: какую
риск: рассказали обеспокоились возросших оценила причинах
бульдозерн: сделке
разведк: документы иностранной
норвежск: границы
избав: африке
революц: бульдозерная призывают азбука
неоколониализм: избавиться
потер: говорят возможные
killnet: killnet
ctrl: ctrl
appl: apple
enter: enter
