визитн: ключевская
случ: случился
говор: месяцев
ру: ооо
снаряжен: правильно альпинистского профессиональным
остатк: бомбы шлаком
значен: регионального
стат: статьи
леж: круглый
обычн: сильнее обычную выглядит обычная
оказа: оказалось оказался
прогуля: склоны
ангел: ангела
стал: активного стало территория
памятник: юнеско
се: охотятся
объясн: объяснил
ката: фрирайда
северн: северной северный
превыша: черте
категорическ: температур
реализова: реализовалось
рукавиц: теплую
работ: экспедиционных
росавиац: росавиации
дополнительн: дополнительные
север: тропа
мероприят: спортивные прочих
арх: архив
экономик: экономика
сейсмолог: сейсмологи сейсмологии
прикр: которым
впечатлен: создалось
сто: нужна
охот: удачной успешно
пункт: пунктах пункт
лес: мертвый перекочевали
лет: талого гидом
ветр: которое ветром
взрыв: раздался
выкидыва: кости
съезжа: вершину
присутств: программе
структур: структуры
сокоренк: наук
суд: начиналось
означа: ительменского
изверга: активным сей
запах: запаха
приземл: парашюта
сверхъестествен: сверхъестественного
ительм: ительмены
назван: получила
котор: пыли рюкзак
времен: временно
утомлен: повлиять
силов: силовые
запад: потухшим западе северо
юнеск: список
природн: дальнем южно состав стала
обратн: мутновского
туристическ: степенью
толбачик: плоский
пузырьк: пузырьков
двига: продолжал
либ: проявляет
связ: связи
ушл: солодов
вперв: восхождение
парашют: открытия
миллиметр: миллиметр
относительн: толбачик
обита: жерлах
выжжен: черную
дела: камчатской
флисов: куртку
верблюдих: называют
пепельн: пепельного
верн: верно
располож: пещер горелого вилючинская горелый
верс: выдвигая
шкал: шкале
устраива: трапезы
приблизительн: приблизительно
центральн: бразилии
барранкос: оврагами
прост: хочется
разнос: разносится
зал: молчания
занима: высыхает
дым: мясо
зап: запах
светл: светло
предупред: переломе предупредил
света: светать
профессионал: команда
карточк: визитной
гавашел: майя
нов: заверили
ног: следить тренировать
сверх: склон
внешн: проявлял
почувствова: катастрофу
слон: угол
част: профессионалов западной
корен: коренных неподалеку
авачинск: жилые ааг восхождения плане дня
алекс: алексей
слов: слово словам
кратер: вертолета десятка горелом подходить большом
постоя: постоянно
сдела: сделать фотографии символом
внимательн: щитом
определен: таких
трекингов: вариант нескользящую
юрт: огненными
деактивирова: нажмите
сложн: определить многим среди
ча: горячий
прогнозир: прогнозируется
камн: встречаться
любител: посещают
совет: альпинисты
пут: непростой океана
посеща: снег
активн: проявлении активных метров самым наблюдение ради воздержаться
сердечн: нарушение
пещер: расположены кратеров
исланд: исландии
превыс: суточное
ноч: ночь
заполнен: ледник
распростран: распространилось
расположен: алмаза получившей
сейсмическ: сейсмические
природ: памятником полюбоваться
куря: курящаяся
арик: известные
летн: потоки
отмеча: верещака
поверхн: поверхности
покор: высоты
вулканическ: остатками вулканического превращая
путешеств: путешествия
полуостров: полуострова единственный
фотографир: женщины
покорен: трудность
машин: машины
групп: домашней регистрация
помогут: водителями
выдвиг: происхождении
куртк: подошвой
техник: техника
европ: европы
постепен: постепенно
подготовлен: опытом
культур: культура
комфортн: выбрать
продолжа: обмелело нижний
материк: материке
помощ: развивать
выш: высотой
магм: магме
бразил: находят
здоров: противопоказаний
опасн: происходят опасности опасно овраг
жител: житель местные жителей
наоборот: скорее
издалек: понаблюдать
выделен: выделение
навык: тренированные подготовки
портал: групп
внедорожник: преодолеть
интерес: продуктами
обрыв: ледников
пеплов: пепловой
отделен: дальневосточного
спецпроект: спецпроекты
связыва: жертвоприношения
протяжен: длина
влажност: высокой
озерн: сопки
шин: послужить
ительменск: переводе
съеда: дым
росс: россии россия
помогл: выбраться
лебед: петропавловск
регистрац: раздел
четырех: займет
газ: газа ядовитые ядовитых
мотор: мотор
заглядыва: обратном
извест: озере
суточн: становилось
счита: принято считают связывали зафиксирована
причин: одна причиной
местност: склоне
троп: бомб подготовленных запада
воздержа: необходимости
лент: лента ленту
кажд: октября
опечатк: нашли
российск: отделения
ключевк: реки
множеств: найти
директор: директор
спор: республике
поездк: доступны
раздава: раздавался
затронут: местам
завершен: оповещают
юг: расположена
серьезн: пыльцу
алмаз: редкого
потухш: является
прекрасн: перевал
растут: горы
юр: юрий
примерн: примерно
поясн: пояснила
завер: обычного
настоя: сделали
петропавловск: петропавловска внедорожнике
слеп: слепил
список: внесенного
затронул: затронул
ссср: ссср
вулкан: сложным промокнут вулканов вулканом
выдел: маршрутов
лун: луне
меньш: меньших
след: следят внимательно хранит
институт: института
напомн: напомнил
организац: организации
снежн: небольшом вершине
помим: помимо
попыта: попытался
цельс: градусов
так: такую потоков склона развитие
воздушн: воздушное
тал: образуется
вулка: вулкан вулканы рекой вулкана
нормальн: нормально нормальным
пыл: сформировалось
событ: событие
сниз: зафиксированная
баз: лавой
хран: достигал
мощн: мощное появившаяся мощнейших
усилен: усиленное
спрыгнул: розов
эйяфьятлайокудл: эйяфьятлайокудль
беринг: упряжках
подошв: ребристой
символ: стали
обсуд: гавашели
некотор: некоторые некоторых
перешейк: снежном
предпочита: экстремалы
солод: владимир
подума: здоровью
количеств: количество количества
спрыгива: предпочитают
попа: попали версии
осмотрительн: осмотрительность
огнен: означает называл
добав: добавили
спорт: спорт мастер
выпа: выпало выпал
специальн: посещения пологий
покоря: готовы
солнц: свете солнце
скал: подойдут
услов: погодные
толст: стоять
закр: закрыли
помеша: толстовкой
правильн: спуск
наступ: наступить наступила
пирагис: александр
народ: народов коренной
степен: ним средней
программ: туров
погодн: тяжелые
главн: главное
полет: полеты полета
действ: считается внутри считать действующий
воздух: вдыхаемом
вошел: слонов
пепел: пепел
пят: часов
октябр: начались говорят
кратковремен: кратковременным
состоян: такого информацию
стоя: стоял остались
месторожден: известен
рад: ехать
голуб: ярко
региональн: парком
использ: гору
созда: влажности
кусок: рукавицы
проявлен: спокойствия
доберут: отдыха
ран: ран
помн: искать
нижн: слоя
обломк: скалистых
интернет: интернет
морозн: нового
авач: берингия
альпинистск: специального
гид: опытными опытным
полн: местность
легенд: слагал
знат: уровня
фотограф: крае
носк: пар
периодическ: лавиноопасны
корякск: относятся
рамк: авача
проч: августе
сильн: сильное последняя парит сильный сильнейшим
покр: территорию покрывшим
останавлива: активность
африканск: центральной
вызва: голодание
пляск: устраивали
бег: помощи
необходим: экстремалов
числ: точное
плоск: тысячи гавайский
тренирова: бега доберутся
трасс: домашних необорудованных
чист: родники
налычев: парке
сложност: маршрута
присво: присвоен
шут: шутили
маршрут: состоянии сложных трекинговые
видн: увидеть
восьм: закладывать
реакц: реакция
тренировк: используют
виде: видео
остр: сопка любая выделить
подход: газы
разрешен: специальное
температур: возле перепады
дойт: дойти
оценива: оценивать оценивают
спасател: возвращении
километр: километров километрах
оста: декабря
прояв: подниматься
лыж: марафоны
тип: гавайскому
тих: сторону
распространен: распространения
упряжк: собачьих
бил: били
международн: международной
сосуд: давлением
залож: среднем
гражданск: гражданской
честн: честное
обитан: обитания
недел: нескольких
побыва: побывали
рек: кислотной честь стекают лавовых
землетрясен: землетрясение
хранител: получить
профессиональн: навыками
жерл: верили выкидывали
сред: среда космоса
суелич: суелич
соста: вошел
слыш: слышен
разнообразн: растут
тромбоз: сердца
мног: свойственно
наблюда: летом
люб: опасный проявилась ключевскому
зависим: вне
равнин: начеку
пилот: пилотов
фот: фото
взят: стоит
катастрофическ: крупные
гор: гора подъеме вершины склонах
расплавлен: расплавленное
разн: разной играть
разл: лава
дальневосточн: работ
прорыв: побочного
жертвоприношен: делали
гамул: обитают
разв: выше
скайраннинг: лыжах
фиолетов: оттенками
физическ: особая
погруз: погрузился
особ: тасс
ходьб: осторожность
подъ: снаряжения
отключа: отключали
облак: облако пути
протека: ключевки
красноват: красноватого
май: острый
волн: волны
одн: роскосмос пурга
наблюден: присутствуют
катан: места
длят: извергал
подобра: палки
улиц: улиц улицы
козыревск: козыревск
масс: горный
склон: покорять вилючинский равнина часть крутом
команд: помогла
подня: видимость
спокойств: индикатором
любопытн: дружелюбные
апрел: апреля
заслужен: примечателен
находя: находящихся
предупрежда: случае
уникальн: настоящему черного
соблюда: соблюдать
участ: принять
десятк: пирагис
регион: уникальным
запрос: разделе
камчатк: камчатке камчатки никто
войт: войти
массов: часа
еха: камчатку
состав: составила опыта
перекочева: животные
картапол: картаполов
празднован: рамках
болезн: кровообращением горная
похож: кальдера
ребрист: ботинки
мутновск: активист поднимаются
вполн: вполне
жела: участие
подвоз: подвоз
новост: новости
перв: экструзию сотню
непрост: местами
посет: обычный
майск: майское
роскосмос: изображение
аллерг: астма
приня: восхождении
камчатск: усть январе духи суслики камчатского
добр: деактивирована добра
полюбова: прогуляться
преодолет: трассах
возл: площадка
пепл: пепла пеплом
ритм: сердечного
овраг: заглядывают глубокими
боя: юртами
определ: число
как: цельсия
турист: сложности останавливает покорить
кислотн: любуются расположено
фиксир: мощности вулканологи
смешива: смешивается
содерж: плоской
гул: гул
повлия: состояния
покрыт: следы
индикатор: цвета
площадк: обзорная
встреча: ходьбе
атмосфер: атмосфере атмосферу
высок: морозной ключевской
реальн: пожаловать
роз: валерий
тяжел: тяжелее обезвоживание
промокнут: случай
точн: регионом
фонов: снизилась
высот: горах определенной высоту высота
мертв: простирается
вертолет: спрыгнул
ночевк: активностью
извержен: извержение извержения извержении затронутым извержений уничтоженные
электричеств: электричество
авиац: авиации
форм: острой менять
лавиноопасн: снежного
парашютист: спорта
продукт: продукты заполненный
гавайск: относят столько
одежд: непромокаемую
максимальн: максимальный
найт: сети
готов: навыков
инопланетян: инопланетяне
образ: части
учен: ученые базы
тур: множество
дорог: осмотр
марафон: мероприятия
гарант: извержениями
случа: таком носков
появ: кальдер
удал: южной
частичн: удален
вернут: вернуться
апокалипсис: апокалипсис
рюкзак: брать
вершин: фиксируют название спрыгивать
александр: выбросы
единствен: лавы
веревк: кусок
валер: парашютист
шлак: покрыты
сообщ: сообщил
показа: показалось
поэт: поэтому
зафиксирова: зафиксировано сильная турбаз
вариант: простой
ветер: подняться
мир: мир
толстовк: флисовой
писа: писали
фрирайд: любители
противопоказан: серьезных
вулканолог: вулканолог вулканологии стекала
совершен: совершенно
безопасн: вилючинском обеспечить
скор: туристов
нажм: опечатку
метров: вулканная
резк: момент условия
феврал: действующим продлилось
необорудова: катающиеся
получ: группы сокоренко значения верблюдиха
шивелуч: шивелуч шивелуча
происхожден: спорят
ухудш: резко
жительниц: жительница
перевод: метр
важн: обувь
экспедицион: сделаны
город: дорога
побочн: фотографируют
пеплопад: пеплопад
декабр: продлившимся
дружелюбн: живут
час: ушло восьми
ежегодн: проходит
метр: метра авачинского ноябре
внутр: перешейке
встает: встает
чаш: озерами
прям: прям
поселок: поселок
ярк: озеро
сноуборд: съезжать
вула: реку
анастас: анастасия
водопад: наблюдать метровым
нарушен: тромбозы
выделя: продолжают
больш: большое стороны разлилась
мест: экскурсии длительный безопасные
начин: остывала
длительн: предстоит
подъем: знать понадобится
верблюд: экструзии
атласов: атласово
видет: видеть
поднож: ночевка стекали
редк: хранитель уникальное
редакциярекламаконтактыпресс: обсудить
страшн: страшного
экстремал: катания турфирмы
елизовск: острая
жизн: жизни
похолодан: похолодание
кит: палец
идт: причин
жар: почернели
пепловик: пепловика
населен: населенный населенных
сформирова: взрыв
сотн: превысило
спортивн: проходят
момент: любой
пошл: ветра
подраста: разрушается
мор: моря
развива: подъема
популяр: четырех
сможет: очередное
ледник: полна тающими содержит
пароксизм: пароксизм
щит: прикрыться
магматическ: магматическую
начек: вулкане
градус: достигает
личн: гарантий
средн: турист запад занимает
нужн: подготовка
домашн: безопасность домашний ски
удачн: считали
ощуща: ощущают
меня: активности варьируется
мильков: мильково
убира: убирают
экструз: вид горной
перепад: резкие
полог: относительно
собач: гонки
опыт: идти рассчитаны
экскурс: подножия
явлен: явлением
тасс: смитюк
жидк: типу
ключевск: подрастает февраля вулканам великан
взрывн: взрывное
ключ: ключей ключах ключи
сопк: козельской превышает
переменчив: помнить
скалист: камней
подойдут: трекинга
займет: тропы
веществ: вещество
изреза: юго разрешение
состоя: впервые
неподалек: протекающей
код: код
осторожн: проявлять
камен: скала
вряд: вряд
кругл: козельского
толчк: предшествовали
обзорн: прекрасная
пожалова: добро
внесен: парка
сантиметр: сантиметров
брат: советуют
ика: икао
понадоб: выносливости
доступн: каких
дерев: деревья
возраст: зависимости возраст
вдыха: давления
галер: галереи
оцен: предварительно
проявля: темп последнюю меняется
дво: дво
дымя: находились
глобальн: глобальное
восток: востоке тропу
раскален: полуострове
рассчита: востока
понаблюда: сможете
жил: пара
увидет: посетить
остыва: двигаться расстояния
трекинг: обломков
жир: китового
возвращен: завершении
горел: выкипать озерный кратере
заня: города
кра: губернатор камчатский камчатском
хел: скайраннинг
животн: почувствовали
произошл: произошло
обеспеч: помогут
стольк: занять
рассказа: рассказала
игра: солнца
непромока: подобрать
вар: киту
размер: различаются
активист: прорыва
озер: кратеры халактырском кислотное озеров
проход: проходили авачинском мероприятий
губернатор: поднимался
слага: приближаться
москв: москве
никт: дает
обезвоживан: утомление
пространств: пространство
несмотр: несмотря
перева: ледниками
велика: снаряжением
территор: жара парки частично территорией
август: отмечается
расширен: расширение
оповеща: туристы
рассвет: рассвет
поднима: силы категорически самое
смен: помешают
каремат: полиуретановый
иска: начинают
мчс: мчс
экипаж: экипажам
угол: протяженного
верещак: елена
родник: разнообразные
продл: июля октябре
район: районе
сад: садится
последн: возвышается последний огненный источники
месяц: недель
сам: последнее самый природы самых
качествен: ледорубы
жми: жми
ааг: арик
возвраща: охоты
организова: организовали
переда: передали
абсолютн: абсолютная
образован: редкое
парогазов: фумарольная
называ: называли жители народ
выполнен: выполнения
давлен: проблемы понижением
длин: горных
принят: сложно
нашл: ру
женщин: покрыл
жутк: жутко
космос: землю
раскат: раскаты
снег: снега лежит
заключа: покорения
выкипа: начинает
предполага: предполагают
перелом: шиной
начина: цвет автоматически пляски
очередн: застанете
расстоян: большие расположения
вер: легенды
западн: пустыню
почернел: толстые
пыльц: аллергия
горн: елизовском развиться маршруты сноуборде
кровообращен: сосудами
соцсет: соцсетях
цвет: голубого форму
коричнев: коричневый коричневого
достига: расположенной температура
предшествова: ноября
нача: толчки начало извержением начался началось
лавов: подножию
станов: днем
академ: российской
ядовит: действующего выделять
кликун: лебеди
значительн: значительной
превра: жерло
возникл: размерами
явля: вачкажец
парк: природном природным природного природные
вещ: вещь
поселк: поселков поселке
развит: воздухе
переж: пережили
различа: пещеры
уничтожен: трава
продолж: продолжит
предсто: ноги
обстрелива: периодически
происход: происходит катастрофические
континент: евразийском
ценност: ценности
взойт: действуют
прилетет: сверху
возвыша: расположен
осмотр: заложить
вачкажец: массив
пар: сменная впечатление заметили
тургрупп: составе
ел: авачинская
халактырск: кликуны
океа: тихого
верхн: начиная
тепл: чай
простира: интересен
гонк: трасса
произошел: произошел
сер: серы
выпаден: выпадение
легк: снаряжение
вид: виде край
сет: наоборот
обув: трекинговую
ботинк: легкие
мастер: заслуженный
красн: красный
ноябр: крупнейших предыдущее
водител: гидами
нескольк: длятся
закладыва: подъем
наук: наука академии
демянчук: демянчук
разда: леса
дом: дома
варьир: карточки
известн: козельский
голодан: кислородное
послуж: каремат
горяч: ногами извергает
сторон: пошло видно
поток: спуска раскаленные
указыва: барранкосами
импульс: импульсы
смотр: смотрите
наб: жилища
альпинист: опытные
китов: остатки
тысяч: мощнейшего
глубок: изрезаны
дня: празднования
хорош: хорошие
колон: колонну колонне
вынослив: подумать
предупрежден: предупреждение
предыдущ: камчатск
кислородн: болезнь
днем: каждым
темп: комфортный
республик: африканской
полиуретанов: качественный
палк: взять
успешн: судя
гром: грома
сил: оценить
план: первом
образова: водопад
оперативн: газов
понижен: вызванное
мяс: варили
извая: изваять
выброс: выброс парогазовые выбросил выбросам выброса
составля: составляет
информац: запросить редакциярекламаконтактыпресс
демянчуквулканолог: демянчуквулканолог
смитюк: налычево
земл: землей попало
обглода: съедали
нарт: поездки
пург: ветер
выгляд: внешне
видим: ухудшиться
замет: феврале
посещен: ключевский
восхожден: массового состоявшееся тренировки ежегодное
ски: хели
берег: берегов
погод: переменчивости
предварительн: возраста
высыха: лету
трудност: активностей
трав: лес
фумарольн: кратеру
застанет: лично
черн: похожа карбонадо
спуск: обстреливают наверх
катастроф: надвигающуюся
тьму: тьму
черт: камень
например: восхождением
подготовк: физическая взойти
примечател: водопадом
вне: желающие
самостоятельн: самостоятельно
кальдер: остывал получил
живут: вулан
карбонад: месторождением
забот: забота
обмелел: фумаролы
масштаб: масштабах
сми: сми
лав: залил возникли жидкой
чест: континенте
огромн: огромного
кокорин: кокорин
молчан: летнего
сло: слоем верхнего
турбаз: уничтожил
палец: набив
вод: воды чистейшей обрывов
мощност: степени
стран: страна
январ: фонового
уровн: уровнем среднего
свет: чаша
климатолог: климатолог
козельск: корякский популярен авачинской
фумарол: дымящиеся
южн: территории мутновский
местн: местный местная местных местному верблюд
дух: гамулы
нескользя: одежду
отдых: туристические
медвед: водятся
лаз: лазо
тающ: образованный
молн: молнии
кост: обглоданные
бомб: вулканические вулканических
стека: жира указывают водой
свойствен: погоды
проблем: форме
соверша: совершать
ледоруб: веревки
поража: поражают
опытн: тургруппы прилететь медведи
раздел: предупредить портале
автоматическ: спасатели
фиксирова: фиксировали
уст: облака
владимир: края
небольш: приземлился
относ: пяти расстоянии
оо: информация
возможн: возможность возможностью
дальн: авачинский
вилючинск: изрезанная например нартах
выбра: оперативно важно
открыт: кратер
дает: издалека
утр: утром
сердц: болезни
хочет: природой
крупн: фиксируются одно
евразийск: высоким
жилищ: возвращались
разруша: либо
крут: заключается
надвига: первыми
оранжев: фиолетового
накр: накрыло
суслик: любопытные
пустын: выжженную
бывш: бывший
приближа: боялся
турфирм: предупреждает
выпуст: выпустили
наверх: путь
воспользова: воспользовался
изображен: опасным
уничтож: ученых
трапез: рек
июл: начавшимся
ри: риа
наход: образование оранжевого находится
оттенк: разными оттенков
астм: ритма
источник: горячие
gosuslugi: gosuslugi
ru: ru
ctrl: ctrl
enter: enter
