обрат: обратится обратился
преобразован: преобразований
ру: ру
банк: банки
наделен: наделенных
влиян: влияние
студентк: студентке
парламент: парламентом парламенту
лев: левых
образ: образом
стат: стать статьи
воен: военные
обычн: обычную
повторн: повторно
советник: советников
дорог: дороги
стал: стала стали стало
ликуд: ликуд
объясн: объяснило
забастовк: забастовке
раскол: раскол раскола
случа: случае
призва: призвал призвали
удал: удалить
центр: центры
кучк: кучки
показыва: показывают
дополнительн: дополнительные
вернут: вернуться вернуть
рейс: рейсы
йорк: йорке
арх: архив
экономик: экономика
подчеркнул: подчеркнул
конфликт: конфликт
вмешива: вмешивался
герцог: герцог
манхэттен: манхэттене
человек: человека
наканун: накануне
единствен: единственной
арм: армии
съезжа: съезжаться
личност: личность
структур: структуры
суд: суда суд судом судьи
экс: экс
пригроз: пригрозивший пригрозил
резервист: резервисты
ветв: ветвью
котор: которую котором которым
провест: провести
двер: двери
гурион: гуриона
присоедин: присоединится присоединиться присоединились
мир: мир
укол: уколов
силов: силовые
секретн: секретные
предприят: предприятия
приостановк: приостановке
назначен: назначения
шаг: шаг
вест: вести
прав: правой права правых правом
безопасн: безопасности безопасность
гвир: гвир
консул: консул
подписыва: подписывайтесь
нажм: нажмите
вперв: впервые
отмен: отмене отменены
удаст: удастся
опас: опасаясь
сут: сути
власт: власти власть властей
начальник: начальник
сжеч: сжечь
обеспоко: обеспокоена
фронт: фронте
важн: важно
член: члены член
город: городов
грандиозн: грандиозный
давидглав: давидглава
национальн: национальной
рук: руки
час: часов
украин: украиной украине
чат: чатах
профсоюз: профсоюз профсоюзов
гранат: гранатой
внутр: внутри
левин: левин
ха: хаим
раскр: раскрыли
детск: детские
издан: издание
выстав: выставил
покинут: покинуть
позвол: позволит
россиянин: россиянин
сосед: соседа
площад: площади
позиц: позицию
предупред: предупредил
справедлив: справедливого
родин: родину
планирова: планировал
нов: новой
больш: большую
нож: нож
част: часть
покрышк: покрышки
законопроект: законопроектов
устро: устроить
вход: входят
офис: офиса
аналогичн: аналогичным
поприветствова: поприветствовала
эффективн: эффективность
видет: видеть
деактивирова: деактивирована
британц: британцам
сограждан: согражданами
редакциярекламаконтактыпресс: редакциярекламаконтактыпресс
совет: советов
примен: применить
окружен: окружение
активн: активно
свыш: свыше
жизн: жизни
ноч: ночью
госкомпан: госкомпаний
систем: системы
выход: выходом
сотн: сотни
отм: отмены
государствен: государственным
отмеча: отмечают
торгов: торговые
частн: частных
основн: основных основные
путешеств: путешествия
вышл: вышли
подсчет: подсчетам
текущ: текущий
сторонник: сторонники
заблокирова: заблокировали
атакова: атаковал
сша: сша
лидер: лидер лидера
немедлен: немедленно
групп: группами
невозврат: невозврата
техник: техника
напрот: напротив
утечк: утечке утечки
решен: решений решении решения
культур: культура
противн: противном
ультраправ: ультраправых
продолжа: продолжаются
личн: личные
чиновник: чиновники
госслужа: госслужащие
вечер: вечером
вылож: выложившего
миснитр: миснитра
верховн: верховного верховным верховный
врач: врачей врач
беспорядк: беспорядки
выступ: выступившего выступил выступить
подразумева: подразумевает
опасн: опасность опасности
документ: документы документов
будущ: будущее
наоборот: наоборот
задержа: задержаны
иерусал: иерусалим
дан: данные дан
отключ: отключены
борьб: борьбе
имен: имени
спецпроект: спецпроекты
раскрыт: раскрыты
закон: законы законов
беспрецедентн: беспрецедентных
росс: россия россией
фбр: фбр
оцм: оцма
гиперзвуков: гиперзвуковой
медицинск: медицинских
угрожа: угрожает
мотор: мотор
ставленник: ставленников
ситуац: ситуацию ситуацией
пожалова: пожаловать
счита: считаю
отказа: отказали отказаться
брат: братья
возвел: возвели
очк: очков
лент: ленте лента ленту
сообща: сообщает сообщают
дипломат: дипломат дипломаты
авив: авиве
опечатк: опечатку
вынужд: вынужден
галер: галереи
границ: границ
оцен: оценили оценил
лапид: лапид
восток: востоке
политик: политик
всеполитикаобществопроисшествияконфликтыпреступн: всеполитикаобществопроисшествияконфликтыпреступность
вмест: вместе
политическ: политический
полиц: полиция полиции
достич: достичь
обнов: обновила
правительств: правительства
объект: объекты
юг: юге
частност: частности
жил: жилья
арнон: арнон
продолжен: продолжению
руководств: руководство
поруч: поручили
медиа: медианная
пост: пост
ссср: ссср
кабинет: кабинета
масштабн: масштабных масштабные масштабной
разгорел: разгорелся
дел: дела
ночн: ночных
организац: организации
конституц: конституции
аргументир: аргументируют
храбр: храброго
яр: ярив
статус: статусе
приемлем: приемлемости
так: таким
обществ: обществе общество
порт: порт
полност: полностью
событ: события
срок: сроки
собствен: собственные
назнач: назначить
лишен: лишение
единств: единства
поворотн: поворотным
август: августа
расширен: расширение
материал: материалы
превращен: превращение
заложник: заложником
аэропорт: аэропорт
наста: настало
приостанов: приостановить
кита: китаем
бар: бар
спорт: спорт
асаф: асаф
специальн: специальное
сад: сады
последн: последних последние
заявлен: заявлениями
йоав: йоава
экстремист: экстремистов
представля: представляет
жми: жми
закр: закрыли
автомобильн: автомобильные
израил: израиль израиле израилю израиля
подожгл: подожгли
спорн: спорной
народ: народа
ицхак: ицхак
компан: компаний
ира: ирана
баррикад: баррикады
главн: главное
принят: принята
нашл: нашли
соответствен: соответственно
юридическ: юридических юридически юридической
достигл: достигли
предполага: предполагает
начина: начинался
израильск: израильских израильские израильскому израильское израильского израильской
увол: уволил
популярн: популярных
йегуд: йегудит
смертельн: смертельной
административн: административных
рад: ради
сдержек: сдержек
запланирова: запланированной
наблюдател: наблюдатели
пентагон: пентагона
спин: спину
сво: своими свой
воткнул: воткнул
нача: начавшиеся началась начался
протест: протестующие протестующих протесты протестов протестующими протестующим протеста
муниципальн: муниципальные
интернет: интернет
значительн: значительное
московск: московским
парт: партий партии
нью: нью
рекорд: рекорд
вслед: вслед
тел: тель
тем: теме
штаб: штаба
лапидлидер: лапидлидер
нетаньях: нетаньяху
пришл: пришлось
неправомерн: неправомерности
полн: полной
настаива: настаивают
бананов: банановая
реформ: реформа реформы
бен: бен
контрол: контроль контроля
биньямин: биньямин
продолж: продолжились
посредник: посредником
комментар: комментарии
прощ: проще
сотрудник: сотрудники
различн: различных
трет: третье
юстиц: юстиции
увольня: увольняют
работа: работаем
ценност: ценности
долг: долг
сегодняшн: сегодняшний
услуг: услуг
оказан: оказание
необходим: необходимость
истор: истории
еврейск: еврейский еврейского
евре: евреям
двум: двумя
подозрева: подозреваемого
кризис: кризис
диктатур: диктатуру
призыва: призываю
противовес: противовесов
сет: сетях
представител: представителей
виде: видео
положен: положение
кнессет: кнессетом кнессета кнессет
ноябр: ноября
историческ: исторических историческую
пришеств: пришествие
наук: наука
правя: правящей правящих
принима: принимать
объединен: объединение
городск: городских
мэр: мэров
реч: речь
дом: дом
реш: решила
способн: способной
поддержа: поддержала
вынос: выносить
генеральн: генеральный генерального
известн: известно
совпада: совпадает
обитан: обитания
призна: признанные
набор: набор
глубок: глубоко
переросл: переросли
включ: включая
дня: дня
хайф: хайфы
хорош: хорошие
стоимост: стоимость
перекр: перекрыли
галант: галанта
вторник: вторника
сред: среда
нац: нации нация
социальн: социальных
недействительн: недействительными
оборон: обороны оборонные
днем: днем
республик: республика
высокопоставлен: высокопоставленный
похуден: похудения
откажет: откажется
язык: язык
фон: фоне
большинств: большинством
сил: силы силой
останов: остановить
умн: умных
план: планах
фот: фото
арестова: арестовало
понижен: понижение
гроз: грозятся
нат: нато
насил: насилию насилие
информац: информация
призыв: призывом
гистадрут: гистадрута гистадрут
отлож: отложить
ключев: ключевые
столкновен: столкновений
примкнут: примкнуть
тормоз: тормозов тормоза
объяв: объявил объявили объявило объявивший объявить
сдержива: сдерживать
халуцб: халуцбывший
министр: министров министра министр
оппозиц: оппозиции оппозиция
создан: созданием
перераст: перерасти
собра: собрались
закрыт: закрытых
обязыва: обязывающие
ближ: ближе
понедельник: понедельник понедельника
одн: одна
продаж: продажу
забот: забота
обращен: обращением
улиц: улицы
действова: действовать
президент: президент
масштаб: масштабов
акц: акции акций
сми: сми
стычк: стычки
бибас: бибас
голодовк: голодовку
увольнен: увольнении
иерусалим: иерусалиме
музык: музыки
стихийн: стихийные
ответствен: ответственно
рассмотрен: рассмотрении
федерац: федерация федерации
стран: страна страны страну
ограничива: ограничивать
участ: участием
аренд: аренды
январ: января
десятк: десятки десятков
запрос: запрос
поскольк: поскольку
громк: громкой
местн: местное местные местных местному
коалиц: коалиции
сист: систему
яир: яир
войн: войну
март: марта
испытан: испытании
войт: войти
хаос: хаос
глав: глава
замир: замир
ближн: ближнем
государств: государства
утрат: утратило
порядк: порядка
заяв: заявил заявив
разрушат: разрушат
болезн: болезни
выражен: выражению
ракет: ракеты
угроз: угрозах угрозой
университет: университеты
новост: новости новостью
лучш: лучшего
добр: добро добра
крайн: крайне
демонстрант: демонстрантов демонстранты
написа: написал
оо: ооо
изменен: изменение
равн: равного
запомн: запомните
планир: планируют
брос: бросил
направ: направить
итамар: итамар
отставк: отставкой отставке
демонстрац: демонстрации
всеобщ: всеобщей
утр: утру утра
крупн: крупнейших крупнейшее
все: всей
голос: голосов
судебн: судебной судебная
премьер: премьеру премьер
рассматрива: рассматриваемых
прибега: прибегать
прошл: прошли прошлой
выпуск: выпуска
прежд: прежде
оппонент: оппонентов
бывш: бывший
критик: критики
реальн: реальный
изначальн: изначально
проводим: проводимой
точк: точки
сфер: сферах
взмах: взмахом
полицейск: полицейскими
наход: находится
ronen: ronen
ilan: ilan
ctrl: ctrl
appl: apple
zvulun: zvulun
rosenberg: rosenberg
telegram: telegram
elia: elias
reuter: reuters
mcdonald: mcdonald
twitter: twitter
killnet: killnet
awad: awad
israel: israel
nir: nir
ammar: ammar
time: times
enter: enter
