жертв: врагов
чувствова: леди
ру: ру
банк: победа
студентк: простая
понима: черта
кгб: генералы
лед: первой
независим: нужными
стат: статьи деникин
воен: звезды
обычн: обычную
туп: ноября
оказа: путч
конц: перестройку
рабоч: демонстрации
дорог: бабушка
стал: отставку студентка
зэк: труд
геро: путча
появ: лицом
един: существовании
показыва: показывает
льет: казнили
доступ: имевшие
павловск: глеб
вернут: вернуться
берлин: поход
арх: архив
экономик: кризис экономика
вмешива: заставляло
сто: выборы деле
партийн: кгб
выряд: октября
единствен: горбачев
приблиз: составе
москвич: захватить
арм: советская
проголосова: большинство
хрущ: системе
структур: структуры
х: х
буш: эру
звезд: рок
власовц: родины
уб: запросто
денег: лишил
горбачев: михаила проиграл
выкинул: умерла
мир: мир сталина
силов: силовые
секретн: февраля
запад: радиостанции
свят: святые
миш: границами
доста: коммунисты
нажм: опечатку
подстав: воды
конец: положить
феврал: дубинками
заб: оплакивала
верхушк: канал
власт: хрущева борьбе
член: судьбы
байд: переводчик
декабр: порядки
малинов: русские
кров: русская умоемся
гкчп: членов
украин: отношениях
прост: бориса
нажив: жажда
вдов: президента
горбачевск: горбачевская
могл: тушенки
лих: лихих лихие
лиц: ним
родин: предателям
лиш: попытались попытался
очевидц: очевидцев
украинц: закитайщина
нов: открывают появились
обошл: елизавета
больш: эмоции
част: решил
счет: разгромным
слож: забвение
устро: выкинули
карьер: перестройки политической
ждал: занавес
кана: донской
могуч: наступил
новочеркасск: корне
плава: миллионеры
генерал: подготовили
видет: видеть
гран: оказалась
деактивирова: нажмите
судьб: сложились
переселя: украинцы
редакциярекламаконтактыпресс: добивались
заговорщик: знает
мягкотел: марта проявили
жал: обошлись
жизн: жизни
березовск: байдена
русск: новые льется большого
забвен: смерть
чертов: вырядились
солдат: страны
систем: деспотической
выход: другого
пыта: села
переводчик: мужика
невероятн: невероятная
предател: главным
убежда: граждан
перестройк: перестройка довести директор
авторитет: пользовались
выж: помнят
труд: людей
митинг: вышли
путешеств: путешествия
борис: спасать вдове
исчез: тупо
вышл: ветераны
сша: рабочих
миха: умер карьера
машин: красная
лидер: наживы
вражд: конец
подготов: страну
техник: техника
тыл: чувствовали
дефиц: авторитетом
европ: уходила
хотел: москва
культур: культура
нужн: никому
советск: советскую зазвучали единого хозяин альянс огромная
букв: москву
смерт: унижение
генсек: генсеки генсеков
убира: заговора
лож: уничтожили
умира: умирали
полож: решили
враг: свергал тылу
заговор: жертвой партийный
выигра: возврату
продул: сохранение
колбас: копченой
дубинк: ответил
заст: застой
елизавет: дети
зазвуча: запада
коммунист: июня
борьб: горбачеву экономики
спецпроект: спецпроекты
станет: потеряем
толп: пьяных
казн: гитлером
росс: изменили россии россия
донбасс: шахтерах
мотор: мотор
пожалова: добро
цикл: цикле цикл
деньг: собирали
отказа: правителем
мужик: русского
цел: геноцид
цен: гулага
радиостанц: врага
лент: лента ленту
деспотическ: лидером
опечатк: нашли
галер: галереи
границ: ждало
российск: российскую
подчин: компартия
эр: новую
восток: дальний
остров: объявила
политик: ошибках
уход: армия
политическ: ельцину
развяза: гражданскую
зарабатыва: жили
директор: августа
золот: гречка
создава: условиях
ошибк: березовского
правительств: верхушка
престарел: престарелые
жил: презрения компьютеры
трибуна: клеймо
сталин: деньги ценой
танк: обгоняя
защитник: трое
настоя: войну
шло: солдат
ядерн: угрозе
повернул: повернулась
ссср: ссср
вошл: курилы
дел: каким
объявля: регионы
конституц: создавалась
попыта: сталинисты убить
параллельмо: параллельмоя
проигра: москвы
ветера: мягкотелый
ответ: омон
москв: советской толпах апреля послали
соратник: думают
измен: пиджаках дефицит
уда: жалею
существован: убеждали
дет: чертовы
август: президент
добива: объявляли
снимк: главных
копчен: доступ
собира: евреев
умерл: дороге
размыва: гробы
кладбищ: размывало
обернул: европы
отношен: испорченных
омон: ельцина
твор: творил
наста: настоящий
спорт: спорт
последн: последние умнее
бедност: власть
приказа: расстрелу
услов: каких
альянс: вступить
стро: сталин восток
жми: жми
расстрел: новочеркасскому ельцине
гулаг: зэков
друг: другим настал
бежа: стало
крах: приблизило помощник
приход: изменил
наступ: войны
переда: независимости
ахин: нес
оказыва: гибели
матеря: политиков
народ: целого подчинила
оплакива: дома
железн: рухнул
главн: жилось выиграл горбачева главное
нашл: ооо
привел: нато
фальшив: июля
октябр: республику
августовск: начался
вер: развал
ускор: денег
бедн: станете
созда: пытались
деникин: кровь
сво: острова
помн: народа
нача: москве танки
фортун: фортуна
оттепел: оттепель
сохранен: проголосовали
интернет: интернет
оруж: секретное
вступ: хотела
всеобществополитикапроисшествиярегионымоскв: всеобществополитикапроисшествиярегионымосква
законч: буш
фотограф: снимках
диктова: стран
хрен: революция
горбач: михаил
спаст: понимаешь
переж: пережили
бел: мчались защитников
пользова: колбасе
спаса: приходите
компьютер: золото
запрет: машина
ценност: ценности
десятилет: десятилетий
истор: историю история главные
гражда: верили
евре: десятки
правител: стать
прова: гкчп
чист: равно
гонк: гонки
кризис: развязать
преемник: поиске
сел: строили
презрен: годы
имевш: бедности
бабушк: союза
возврат: шло
клейм: поддержал
виде: видео
сверга: хрущев
заставля: выхода
умер: конца
посла: республики
красн: декабря
ноябр: рухнула
ельцин: митинг достали вице стоить
виц: подстава
прояв: развале
курил: карьеры
наук: наука
путч: провала августовский заговоре
хот: украиной
крыс: бежали
задав: выжившие
дом: белого белому
реш: сша союз
поддержа: гитлеру
компарт: кпсс
восста: правительства
гражданск: хотите
унижен: мягкотелость
защища: москвичи
обитан: обитания
довест: удалось
босс: могучий
хозяин: босс
хорош: хорошие
глеб: счетом
сред: среда
жажд: ложь
республик: союзные создать
геноцид: устроили
погибл: герои
мног: многое
гречк: берлин
большинств: буквы
умн: потеряла
умо: начало
тушенк: банку
гроб: плавали
разва: ускорило
нат: частью
обгон: дому
информац: редакциярекламаконтактыпресс
столкновен: милиционеры
мчал: столкновениях
противник: соратники
люд: выселение
примкнут: отказался
пиджак: малиновых
гибел: путче
год: лагеря
объяв: вошли
лагер: трибунал
открыва: советских
министр: ахинею
потеря: конституция своими
черт: миша
гитлер: победы примкнуть
знает: хрен
комсомол: исчез
волг: строил
забот: забота
пода: последний
президент: ельцин единственный оружие десятка
помощник: корабля
сми: сми
огромн: убирайтесь
ма: мая
донск: волго
апрел: противники
баст: министр
вод: чистой
союз: крах советский
корабл: крысы
стран: страна вмешиваться защищали обернулось
десятк: фотографов олигархах
побед: миру власти стоила
развал: крахе
регион: президентов
брежневск: брежневский
пьян: донбасса
союзн: расстреле
войн: холодную ядерной
марс: оказываешься
сентябр: россию
март: привело
войт: войти
сепаратизм: борьба
эмоц: передать
состав: президентом
испорчен: преемника
глаз: глазами
олигарх: матерящихся
выбор: павловский истории
хрущев: лишить
порядк: диктовать
холодн: закончили
запрост: могли
поход: фальшивый
милиционер: военные
угроз: вражде
шахтер: бастующих
новост: новости
разгромн: продул
перв: зарабатывали стала
нес: забыли
дума: борис
корн: задавить
сталинист: восстала
миллионер: первые
добр: деактивирована добра
оо: информация
поиск: выборах
дальн: переселялись
хрущевск: хрущевская
равн: спасти
огон: открыть
демонстрац: огонь
отставк: подал
тро: погибли
занавес: железный
как: советского сепаратизм
кпсс: запретил
рухнул: народ марсе
закитайщин: сентября
бывш: бывший
реальн: пожаловать
лафет: лафетах
ельцинск: ельцинские
рок: кровью
уничтож: комсомол
ник: бедными
откр: приказали
июл: власовцам
июн: победить
выселен: кладбища
захват: заговорщики
революц: грани
ii: ii
ctrl: ctrl
enter: enter
