лауреат: февраля
говор: учился
ру: ленты
рф: государственной
шевел: шевелить
велосипед: велосипеде
провер: ъ
пшеничн: пшеничный
жаропонижа: никакими
влиян: украине
студентк: похудения
понима: узнавал
лев: русфонда
стат: статьи
обычн: обычную выглядело
оказа: поездка
стар: улице
конц: победа
дорог: дорогого
стал: фронте мужем
объясн: лнр
ката: кататься
соглас: клиника
ребенок: ребенок
реагир: бурно
судорог: передергивало
появ: перенесенного
удал: пришлось
центр: практический центре реабилитационного
практическ: научно
вернут: вернуться
мозг: головного
вернул: кровообращения
арх: архив
реабилитац: поможет старается успешной
живот: спины
экономик: экономика
медикаментозн: ребенка
сто: реабилитация
размеща: письма
манхэттен: жилья
д: центра
специализирова: центр
поступ: семьи
перенес: перенес
единствен: москву
москвич: привлечение
макияж: нанесения
леч: болезнь
личност: раскрыли
структур: структуры
дава: реабилитацию
ф: имени
карт: банковских
дыша: спазмы
пальц: пальцами
сообщ: сообщить
отправ: решили
ъ: писем
денег: денег
диагноз: диагноз
нко: реестр
мир: мир
мальчик: мальчик июля минут
укол: популярных
силов: силовые
осен: создан
секретн: выложившего
клиническ: клиническую перенесенная
бурн: лунтика
слушател: собрали
внешност: удивились
вертикализатор: стоять
обратн: мальчика
этап: следующий
вагнер: чвк
уч: твердую навыков необходимо
скор: жаропонижающими
нажм: опечатку
ушл: купировать
феврал: тяжелобольным
сообщен: наличностью
голосов: помощью
получ: декабре миллиарда
крича: плакал
крова: ногами
происхожден: неуточненного
перевод: добиваться возможны
узнава: узнавать никого
клиник: единственная реабилитационную
фронт: ситуацию
провел: ребенку
город: добрый
вирусн: диагностировали
судорожн: вернулось
реестр: входит
национальн: москвичей лауреат
декабр: услуг
рук: предметы точку
час: торопил
ужаснул: результат
столкнул: девочка
украин: очков
гранат: соседа
раскр: сша
детск: детский
выстав: лидер
больн: костного
россиянин: смертельной
рубл: собрано
сосед: бросил
циклжизн: циклжизнь
движен: сын
позвон: юле
повышен: дыханием
нов: китаем
ног: бился тонус ног
нарушен: двигательные
больш: стоит
айфон: приложения
миллиард: свыше
вырва: пытался
подскоч: утром
ждат: велели
клапа: голосового
счет: оплатить
глота: глотать
инфекц: неизвестной бактериальную
длительн: жевать
вход: лучник
ждал: коридоре
полезн: общественно
выписк: серьезная
исполнител: нко
сдела: вместе
эффективн: оценил
видет: видеть
деактивирова: нажмите
терап: протонная
родител: больших родителей
жева: дышать
редакциярекламаконтактыпресс: всу
донор: поиска
окружен: трубках
свыш: помогать
жизн: жизни
вперед: впереди
ноч: менялся
эфир: сайтах
зашедш: заявили
чвк: уничтоженных
срочн: дашу температура
пыта: терапия кровать
полноцен: убрать
невероятн: добился
правмир: фонд
государствен: амбиндер
вопрек: холодное
летн: врачей внешности
приглас: врач
выж: врача
смог: восстановительного
путешеств: путешествия
привлечен: город
неуточнен: инфекцию
курс: первого помог
читател: москва
сша: последние
лидер: ракеты
процесс: процесс
сознан: терять
подготов: восстановительное
техник: техника
утечк: подозреваемого влияние
культур: культура
русфонд: президент русфонд ру
удив: сети
одея: завернули
лнр: популярные
личн: продажу
нужн: нужна
смерт: смерть
меня: быстро
помога: подробности помогаем теме
бесплатн: россии
вылож: личность
неизвестн: вызванного
помощ: помощь звуками медицинской
врач: ужаснул обратно врачи прогнозам
ввел: кошечку
протон: спасет
приложен: фонда
результат: невероятных приезжайте отключены
банковск: переводы
выигра: январе
двигательн: ногах
прорвичневролог: олег
документ: секретные утечке
удержива: положении
навык: навыки коммуникационных
тверд: полноценно
сын: скорой поступили вашего
интерес: пробудила
вначал: вспоминает
грустн: отвлечься
средств: сбор
позвоночник: операция
трубк: вырвать захару
стимуляц: лекарства
дан: личные
отключ: комментарии
установ: мальчику
имен: детям
отделен: приемное
спецпроект: спецпроекты
раскрыт: рекорд
попроща: пригласил
даш: потолок
рост: сразу
росс: россия сотрудничать звонок
помогл: счет
помог: прерывать
фбр: пентагона
реанимобил: приехал короткой
обследован: ростове подробное
помож: давайте
гиперзвуков: новой
ком: глубокой коме бодрствующая
энцефал: энцефалит
медицинск: специализированной
мотор: мотор
кот: друга
ситуац: утечки
пожалова: деактивирована
цикл: девочке
передергива: сознание
очк: умных
лент: лента читатели ленту
спасет: летнего
звук: мимикой
опечатк: нашли
лекарств: препараты
галер: галереи
оцен: состояние нато
российск: русфонде
мозгов: стимуляции
политик: тупик
серебрян: премии
вмест: завершен
воспитательниц: позвонила
муж: сказали
тупик: зашедшей
обнов: манхэттене
поездк: реанимобиль
купирова: приступы
серьезн: длительная столкнулась
жил: аренды
реабилитацион: сентября реабилитационном реабилитолог
юл: маме дело разгибались
продолжен: продолжение
стара: научиться
областн: доставить
достаточн: рублей
мультфильм: смотреть
наступлен: зеленского
медиа: документов
сказа: руках
ссср: ссср
слез: сдерживая
вспомина: юля
след: обуви следует
минут: сердце
вялост: простуда
дел: доброе
организац: президентский
заверш: успешно
параллельмо: параллельмоя
пятн: синими
реабилитолог: прорвичневролог
коротк: оказалась
завернул: рассказывает
противосудорожн: антибиоткики
ваш: воспитательница
простуд: обычная
капельниц: окружении
никт: лечить
москв: перевода радио ясенецкого
нормальн: поможем
срок: раскрыты
назнач: дыхание
оплат: клинику оплату курс
держа: держать
мамин: ест
уда: комы
добива: стали
дет: помощи получили
блогерш: летней
назва: пригожин
материал: детей
головн: вялость обследование
конкурс: грант
восстановлен: восстановления работать
лечен: лечения начали
амбиндер: лев
кита: испытании
спорт: спорт
район: отделение
мысл: грустных
ростовск: ростовской
сад: сад
последн: цикла
друз: родственники
месяц: месяца месяцев
приоткрыт: попрощаться
захотел: иран
жми: жми
друг: старого другу
дыхан: проблемы облегчить
бежа: бежал
сбор: достаточно
выгиба: атаки
рассказыва: пятнами
благотворительн: оплатил
программ: россией
тяжелобольн: помогают
выглядел: вначале
зайт: разрешили
покорм: кричал
ира: макияжа
лезт: хочется
главн: главное
характер: боль
сдержив: веками
нашл: ооо
четырехлетн: инфекцией
потолок: лезть
перенесен: ваську выяснилось
сестр: сестры
век: приоткрытыми
приезжа: срочно
рубеж: числе
поможет: малышу
состоян: выжил выгибался
стоя: опорой
вер: телеканала
прогноз: вопреки
популярн: эффективность музыки
кровообращен: мозгового
смертельн: язык
рад: мяу слушатели
област: московская области
научн: принять
созда: российский
пентагон: документы
спин: поворачиваться
сво: своему
приемн: привезли
телевизион: печатных
пробуд: радуется
нача: мозга капельниц ночью полчаса
тонус: мышечный
занов: заново
лежа: лежал
интернет: интернет
атак: судорожные
московск: райки
рекорд: обновила
полчас: ждали
всеобществополитикапроисшествиярегионымоскв: всеобществополитикапроисшествиярегионымосква
тел: тело
поселк: поселка
тем: материалы
теря: начал
пришл: студентке
интенсивн: интенсивного
сайт: размещаем
достав: удалось
знал: никто
прерыва: желательно
уничтожен: число
продолж: нарушения
предсто: область
обществен: исполнителей
комментар: бесплатный
выясн: обследования
зеленск: потребность
приступ: лечение
адрес: рф
работа: трахеостомы
нанесен: блогерши
ценност: ценности
долг: долгий
покр: судорогами
пап: папу
вызва: энцефалита
услуг: полезных
телефон: андроида
ел: ним
необходим: четырехлетний
числ: сообщением назвал
произвел: клиническая
подмосковн: подмосковном
подозрева: арестовало
сотруднича: захотел
сем: друзья
автор: осенью
очеред: ждать
опор: живот учить
убра: этап
вид: реагирует
сет: социальных наступлении
представител: данные
виде: видео
обув: ортопедической
захар: захар захара зайти
умен: умения
положен: опоры
привезл: сыном
рвот: началась
температур: высокая
президентск: выиграл
науч: научился многому
ростов: больницу областную
энцефалит: результате
нескольк: нескольких
быстр: мамочка болезни
лунтик: мультфильмы
мышечн: повышенный ушли
наук: наука
предмет: речь
разреш: реанимацию
городск: отправить
реч: понимал
ясенецк: войно
дом: интерес
реш: знал
дон: ростова
бил: галлюцинации
мимик: эмоции
олег: удерживать
известн: стало
постав: поставили
пригожин: политике
райк: д
обитан: обитания
глубок: состоянии
родственник: помогли
доб: правмир
хорош: хорошие
стоимост: нормальной
организм: произвела
сред: среда
социальн: вера
ест: удовольствием
мног: предстоит
андроид: айфона
успешн: ожил средств
борщ: мамин
люб: борщ
закат: закатив
похуден: уколов
бактериальн: вирусно
язык: удалить
останов: реанимобиле
умн: выпуска
син: покрылось
фот: фото
арестова: фбр
коридор: очереди
нат: представителей
информац: редакциярекламаконтактыпресс
больниц: городскую районной
письм: проверив
удален: подготовим
разгиба: руки
забра: одеяло
удовольств: дома
телекана: эфире
девочк: талантливая позвоночнике
улыбнул: юлия
целин: целина
маш: болезнью
малыш: учиться малыш
реанимац: забрали
собра: ростов родители самостоятельно
звонок: телефон
диагностирова: изменения
одн: смотрел
трахеостом: удалению
мам: мама маму часов
отвлеч: пытаюсь
продаж: выставил
самостоятельн: собрать
забот: забота
ортопедическ: вертикализаторе
поспева: еле
грант: получил
улиц: видит
васьк: кота
потребн: объяснили
президент: больных
приеха: дону
галлюцинац: начались
сми: сми
трахеост: установили
музык: громкой
стран: страна
лопн: быстрей
электрон: карт
аренд: медианная
бодрств: оценили
наличн: электронной
пищ: перетертую
смотрет: любит
январ: рдкм
побед: первая
громк: гранатой
сидет: пищу
войн: ф
смотрел: движения
сентябр: выписке
март: марта
испытан: известно
сбива: подскочила
войт: войти
мамочк: поспевала
фонд: адрес благотворительный
эмоц: выражает
мя: говорить
глаз: глаза
утрач: утрачены
счаст: лопну
пис: отчаянных
пит: смог
сраз: добро
холодн: слезы холодным
проблем: появились
подробн: провели рубежа
отчая: авторам
заяв: сфера
максимк: максимке
болезн: сон характер серьезной
ракет: гиперзвуковой
антибиоткик: назначили
выража: результатов
новост: новости
печатн: сетях
лучш: лучшему
перв: улыбнулся концу
прем: национальной
ож: коляске
желательн: реабилитации
тороп: счастья
операц: срочная
облегч: трахеостому
приня: согласилась
бол: маше головная
добр: сделали конкурсе добра внес
талантлив: мыслей
оо: информация
изменен: тяжелые
возможн: телевизионных
поиск: организацию
всу: бойцов
спазм: мышечные
рдкм: национальный
брос: россиянин
поворачива: клапана
голов: голову
внес: стоимость
трехколесн: трехколесном
сон: медикаментозный
утр: рвота
сердц: остановилось
хочет: боли
перетерт: пить
препарат: противосудорожные
плака: трубки
лучник: серебряный
кошечк: покорми
бойц: вагнер
прошл: прошлого
выпуск: сроки
высок: сына
велел: больницы
бывш: бывший
реальн: пожаловать
тяжел: организме
восстановительн: курса продолжить
ребенк: ввели москве
ник: кома
коммуникацион: восстановлением
точк: одну
коляск: сидеть
сфер: программе
июл: происхождения июле
костн: доноров
июн: июня
наход: находился
никак: сбивалась
app: app
rbc: rbc
ru: ru
killnet: killnet
mail: mail
kommers: kommersant
ctrl: ctrl
appl: apple
vesti: vesti
sm: sms
enter: enter
rusfond: rusfond
