париж: париж
готов: готовые
ру: ру
живодерск: живодерского
говор: говорить
влиян: влияние
студентк: студентке
оттуд: оттуда
образ: образа образ
стат: статьи
обычн: обычную
конц: конце
стал: стало
се: сей
объясн: объяснили
геро: героев герои
успех: успех
случа: случае
удал: удалить
показыва: показывать
вернут: вернуться
бестолков: бестолковый
арх: архив
бесконечн: бесконечное
экономик: экономика
платоническ: платонический
ришел: ришелье
александр: александра
франсу: франсуа
пол: поля
сто: стоит
манхэттен: манхэттене
человек: человека
приятн: приятным
финальн: финальной
уроженец: уроженец
д: д
единствен: единственная
приблиз: приблизить
макияж: макияжа
преврат: превратить
вольн: вольные
то: той
личност: личность
должн: должна
структур: структуры
экс: экс
показа: показал
ощущен: ощущение
благодар: благодаря
котор: которую котором которым
квартир: квартира
пор: порою
вариант: вариантом
мир: мир миру
укол: уколов
силов: силовые
секретн: секретные
запад: запад
миф: мифа
назначен: назначения
совершен: совершенно
вест: вести
внешност: внешности
вагнер: вагнер
скор: скорее
нажм: нажмите
связ: связи
адюльтер: адюльтер
классическ: классический
дела: делать
боев: боевого
сцен: сцены
получ: получив получившем получились
французск: французской французском французский французского
верс: версия
фронт: фронте
важн: важнее
книг: книги
центральн: центральных
украин: украине
гранат: гранатой
раскр: раскрыли
врем: времен
шанс: шансов
венсан: венсаном
выстав: выставил
лин: линия
позвол: позволил позволить
россиянин: россиянин
сосед: соседа
проверк: проверки
позиц: позиции
ложн: ложному
юнгвальд: юнгвальд
лиц: лица
крипс: крипс
разумеет: разумеется
измаза: измазанные
очевидн: очевидно
нов: новом новой новые новая
придума: придумать
атос: атоса атосом
нож: ножом
подвеск: подвески
мест: местом
част: часть
клюкв: клюква
ждат: ждать
традицион: традиционно
кин: кино
устро: устроили
карьер: карьере
предпочел: предпочел
навлеч: навлечь
сдела: сделано
эффективн: эффективность
видет: видеть
грязн: грязными
деактивирова: деактивирована
редк: редкой
пул: пулей
оттенок: оттенок
британц: британцы
редакциярекламаконтактыпресс: редакциярекламаконтактыпресс
страшн: страшная
фигур: фигуру
че: чей
жизн: жизнью жизни
ноч: ночь
противоречив: противоречивости
зашедш: зашедшей
покушен: покушение
чвк: чвк
выход: выходит
шарл: шарль
персонаж: персонажей
шер: шеро
ремикс: ремикс
сотн: сотням
узна: узнать
блуберр: блуберри
летн: летней
квартет: квартет
мушкет: мушкет
основн: основной
путешеств: путешествия
дюм: дюма
вышл: вышло вышла
читател: читатель
сша: сша
лидер: лидер
патрис: патрис
техник: техника
гвардейц: гвардейцами гвардейцам
напрот: напротив
окружа: окружающей
утечк: утечке утечки
воплощен: воплощение
культур: культура культуре
дружб: дружба
доказыва: доказывали
удив: удивились
гряз: грязь
лнр: лнр
личн: личные
отц: отца
удачн: удачные
аккуратн: аккуратный
обраща: обращает
католик: католиков
далек: далеких
вылож: выложившего
материа: материал
унима: унимается
ребр: ребра
современ: современный
благословен: благословение
малоприятн: малоприятные
врач: врач
даб: дабы
опыт: опыты
попытк: попытка
артанья: артаньяна артаньян
фанат: фанатов
контекст: контексте
документ: документы документов
предложен: предложения
пожева: пожеванные
командировк: командировка
мартин: мартина
самодурств: самодурство
сменя: сменяются
подколодн: подколодной
подчеркива: подчеркивает
скачет: скачет
дан: данный данном данные
отключ: отключены
приобрета: приобретает
протестирова: протестировали
спецпроект: спецпроекты
войск: войск
раскрыт: раскрыта раскрыты
кинематограф: кинематограф
росс: россии россия россией
едв: едва
фбр: фбр
ветеран: ветеранами
гиперзвуков: гиперзвуковой
кон: коне
схватк: схватку
мотор: мотор
романтичн: романтичного
недобр: недобрыми
ситуац: ситуацию
пожалова: пожаловать
героическ: героического
тума: туманные
приконч: прикончить
злокознен: злокозненным
мужик: мужики
четвер: четверых
цел: цель
очк: очков
провинц: провинции
сериал: сериале
лент: лента ленту ленты
приравнива: приравнивается
старш: старше
порук: порукой
опечатк: опечатку
галер: галереи
риску: рискуя
оцен: оценили оценил
российск: российских российский российском
политик: политике
угрюм: угрюмости
прихвостн: прихвостнями
отличн: отличным
тупик: тупик
кассел: касселя касселем кассель
обнов: обновила
дуэл: дуэль
серьезн: серьезных
прекрасн: прекрасная
увидет: увидеть
чебурашк: чебурашку чебурашка
жил: жилья
небрит: небритые
продолжен: продолжения
блестя: блестящем
наступлен: наступлении
медиа: медианная
отрублен: отрубленными
кадр: кадров кадр
ссср: ссср
нуар: нуара
рассказа: рассказать
невозможн: невозможно
капитан: капитаном
вычеркнут: вычеркнуть
никт: никто
картин: картина картины
зме: змеи
недавн: недавней
срок: сроки
нарыва: нарывается
богохульств: богохульству
сообраз: сообразили
гаррел: гаррель
условн: условному
антисанитар: антисанитария
территор: территории
дет: детей
блогерш: блогерши
назва: назвал
материал: материалы
контрастир: контрастирует
формул: формуле
оборачива: оборачивается
застав: заставят
противостоян: противостояние
арест: арест
удивительн: удивительно
актрис: актрисы актрис
рома: романа роман
экранизирова: экранизировать
кита: китаем
спорт: спорт
вторич: вторичен
ряд: ряды
последн: последние
саж: сажей
забалу: забалуев
друз: друзей
кинематографист: кинематографисты
парижск: парижскими
хим: химию
оставл: оставлены
гаскон: гасконь
объем: объеме
мушкетер: мушкетеры мушкетеров мушкетера мушкетерами
скаж: скажем
звон: звон
метаморфоз: метаморфозы
захотел: захотел
жми: жми
друг: другим
дик: дикий
приход: приходится
георг: георгия
помойк: помойка
головорез: головорезов
тайн: тайный
воображен: воображения воображению
подобн: подобное
бондарчук: бондарчук
рассказыва: рассказывает
степен: степени
программ: программе
ира: иран
главн: главное
принят: принято
характер: характеров
действ: действует
нашл: нашли
складыва: складывается
велик: великом
век: века веке
оскорбл: оскорблены
начина: начинается
вер: верующие
популярн: популярных популярные
режиссер: режиссера
смертельн: смертельной
хилькевич: хилькевича
пентагон: пентагона
сво: своими своем своим
марма: мармай
соревнован: соревнование
интернет: интернет
значительн: значительно
ефремов: ефремовым
парн: парные
рекорд: рекорд
херек: херека
винтер: винтер
штаб: штаб
тем: теме
зарожден: зарождением
тревил: тревилем
пришл: пришлось
претерпел: претерпел
де: де
настаива: настаивает
зрител: зритель зрителю
пьянств: пьянство
уничтожен: уничтоженных
праздн: праздного
комментар: комментарии
зеленск: зеленского
трех: трех
королевск: королевская королевских
сильн: сильно
работа: работают
нанесен: нанесения
ценност: ценности
пренебрега: пренебрегает
ев: евой евы
перем: перемен
вик: вики
мрачн: мрачный
числ: число
разъясня: разъясняет
заварух: заваруху
королев: королевы королевой
подозрева: подозреваемого
вниман: внимания
сотруднича: сотрудничать
подтек: подтеками
милед: миледи
автор: авторы
представител: представителей
сет: сети
виде: видео
избиен: избиение
приключен: приключений
звучн: звучные
попада: попадает
спецназ: спецназа
мастер: мастер
явн: явно
историческ: историческую
быстр: быстро
реальност: реальности
сивил: сивиль
наук: наука
прочност: прочность
рейтинг: рейтингом
реш: решили
известн: известных известно
общ: общем общую общая
знаменит: знаменитый
эстетик: эстетику
прокат: прокате прокат
товариществ: товарищества
пригожин: пригожин
обитан: обитания
венса: венсан
бэкингем: бэкингемом
изобретен: изобретении
сознательн: сознательно
принцип: принцип
хорош: хорошие
стоимост: стоимость
никит: никитой
наутр: наутро
полутор: полутора
сред: среда
арамис: арамисом
им: имена
повида: повидавшись
обвинен: обвинению
подзаголовок: подзаголовок
мног: многом
титр: титра
плащ: плащи
сыгра: сыграть
портос: портосом
успешн: успешно
похуден: похудения
язык: язык
фон: фон
сил: силу
умн: умных
обяза: обязан
неприбра: неприбранная
план: планах плане план
снял: сняли
отморожен: отмороженность
арестова: арестовало
нат: нато
информац: информация
стив: стивена
правд: правда правду
разн: разной
трагическ: трагическую
выгляд: выглядят
дюрис: дюрис
тетрис: тетриса
экран: экране
английск: английской
шпаг: шпаги
дотянут: дотянуть
ревиз: ревизию
переосмыслен: переосмысления
особ: особого
супруг: супруга
пополн: пополнить
маргарит: маргарита
деконструкц: деконструкция
книжн: книжных
дожда: дождаться
героин: героиня
например: например
знает: знает
продаж: продажу
протестант: протестантами
забот: забота
настольк: настолько
приб: прибыв
улиц: улицами
вестерн: вестерн вестерна
столиц: столицу
потребн: потребность
лу: луи
акт: акта
роман: романом
сми: сми
экранизац: экранизации экранизаций
кожан: кожаные
музык: музыки
гасконц: гасконца
апрел: апреля
стен: стенах
контрапункт: контрапункт
врод: вроде
аренд: аренды
гнев: гнев
смотрет: смотреть
юношеств: юношества
громк: громкой
испытан: испытании
песн: песне
войт: войти
нечт: нечто
счаст: счастью
выбор: выбор
сраз: сразу
всекиносериалымузыкакнигиискусствотеатрфотограф: всекиносериалымузыкакнигиискусствотеатрфотография
марг: марго
проигрыва: проигрывает
бурбулон: бурбулона
подробн: подробно
мушкетерск: мушкетерская
заяв: заявили
болезн: болезни
похож: похож похоже
ракет: ракеты
вполн: вполне
выигрыва: выигрывает
новост: новости
корол: короля
существ: существуют
спагетт: спагетти
перв: первую первых первая первого
отморозк: отморозки
возрастн: возрастным
яросла: ярослав
юнош: юношу юноши юноша
добр: добро добра
крайн: крайне
оо: ооо
изменен: изменений
всу: всу
молод: молодого
франц: франция
проделыва: проделывал
брос: бросил
грин: грин
исполнен: исполнении
голов: головами
скук: скуки
тро: троими
сердц: сердце
хочет: хочется
как: какую
голословн: голословными
крупн: крупных
пи: пио
бока: бокала
меша: мешала
кардина: кардинала
бессмерт: бессмертием
фильм: фильм фильме фильмах фильма
сюжет: сюжет сюжета
бессмертн: бессмертного
бойц: бойцов
эстетическ: эстетических
выпуск: выпуска
людовик: людовика
прежд: прежде
ахиллес: ахиллеса
бывш: бывший
реальн: реальный
мечт: мечта
втор: втором вторых
отпуск: отпуска
точн: точно
рол: роль
ром: ромен
изображен: изображения
радикальн: радикальная
ра: ра
сфер: сфера
иконическ: иконические
слоня: слоняются
наход: находятся
tv: tv
artagnan: artagnan
killnet: killnet
mousquetair: mousquetaires
ctrl: ctrl
xvii: xvii
appl: apple
xiii: xiii
le: les
enter: enter
troi: trois
