случ: случилась
лапш: лапшой
оценк: оценки
слух: слухи
рф: рф
банк: банки
влиян: влияние
гаврилин: гаврилиной
америк: америке
успел: успел
занят: занятий
оказа: оказался оказалась оказать
отдыха: отдыхать
дорогущ: дорогущий
конц: концы концами
перееха: переехали
стал: стали стало
дорог: дорогу
детдом: детдоме
соглас: согласился
ледников: ледникового
случа: случае
работ: работу работе
заход: заходите
центр: центре
рекламн: рекламные рекламных рекламной
частичн: частичное
экстремистск: экстремистской
показыва: показывают
доступ: доступ
роскошн: роскошные
арх: архив
хитов: хитовый
сч: сч
предел: предел
хаус: хаус
удач: удачу
правов: правовая
привлеч: привлечены
съ: съ
получен: получения
сто: стоит
басков: басковым
тв: тв
человек: человеку
тус: тусим
пагубн: пагубная
схем: схем
передозировк: передозировка
поступ: поступил
з: з
лет: летом летие
торгова: торговал
приблиз: приблизилось
л: л
разговор: разговоре
телеэкра: телеэкраны
н: н
тр: тр
знакомств: знакомства
банальн: банальный
поезд: поезде
накрут: накрутились
карт: карте
х: х
ч: ч
шар: шарами
подел: поделился
отправ: отправились
гримас: гримасы
звезд: звезда
назван: название
незамысловат: незамысловатый
котор: которым
владелец: владелец
квартир: квартире квартиру
денег: денег
двер: дверь
повар: повар
мин: мин
пор: порой
футбол: футбол футболом
ветер: ветер
обманыва: обманывать
мальчик: мальчика
мир: миру
осен: осенью
продава: продавать
признава: признавал
прав: права правила
сольн: сольный
подписыва: подписывайтесь
отмет: отметил
уч: уч учиться
нажм: нажмите
уш: уш
проект: проекту проект проекта
феврал: феврале
появля: появляться
конец: конец
весн: весну весной
зав: зав
дела: делать
ребят: ребята
получ: получил получая получить получилась
приобрел: приобрели
режим: режиму
шатун: шатунов
книг: книга
списк: списке списка
беремен: беременна
декабр: декабря декабрю
рук: руку
чат: чат
отец: отец
детск: детский детском
нно: нной нное
млн: млн
прям: прямо
заработк: заработки
рубл: рублей
зал: залили
индустр: индустрию
лих: лихим
зат: затею
юмористическ: юмористические
лиц: лицом
подруж: подружился
планирова: планировал
заработа: заработанные
лиш: лишился
нов: новую
придума: придумали
трабл: траблы
нарушен: нарушений
больш: больших большую большая
медийн: медийность
монетизац: монетизации
част: часть
нок: нок
иде: идея
перевалива: переваливает
устро: устроено устроиться
карьер: карьере карьера
журна: журнала
ждал: ждал
выручен: вырученные
кана: канала
парен: парень
нны: нный нные
отзыв: отзывов
отда: отдала
рожден: рождения
строчк: строчку
всер: всерь
выкладыва: выкладывал
смогл: смогла
родител: родители родителей родителями
подорва: подорвало
мошенническ: мошеннических
лайк: лайки
совет: советы
энциклопед: энциклопедия
жизн: жизни
ведом: ведомым
забит: забитой
мог: могу
листовк: листовки
мок: мок
мол: мол
момент: моменту момент
приглас: пригласили
частн: частном
мор: моря морем
высокооплачива: высокооплачиваемых
основн: основным основные
шо: шоу
мны: мные
простеньк: простенькие
техник: технику
автомеханик: автомеханика
андре: андреев
хотел: хотел
владельц: владельца
биограф: биография
средн: среднюю среднее
продолжа: продолжала
спуска: спускал
подсад: подсадила
подряд: подряд
секрет: секрет секрета
нрав: нравилась
нужд: нужды
помощ: помощь
зды: зды
слайд: слайд
выступ: выступил
улетел: улетел
чувак: чуваков
изгнан: изгнании
секунд: секунд
анап: анапу
броса: бросал
текст: текст
дисконт: дисконтом
будущ: будущими
предложен: предложения предложений
запрещен: запрещенной
хавчик: хавчик
выпускн: выпускном
спокойн: спокойно
сын: сын
выросл: выросла
альб: альбом
интерес: интереса
дан: данила даню дане дани даня даней
андреев: андрееву
отключ: отключить
веществ: вещества
быт: быт
спецпроект: спецпроекты
протяжен: протяжении
слит: слить
состоя: состоял
плох: плохой плохие
сирот: сироте
росс: россии
помог: помог
кож: кожей
едв: едва
блогерств: блогерство
ситуац: ситуация
фирм: фирмы
отсутств: отсутствие
камер: камеру
наказыва: наказывали
деньг: деньги
брат: братом брат
цел: целях цель
продюсер: продюсера
вирус: вируситься
экипировк: экипировку
предлож: предложил
старш: старшие старшим
изоляц: изоляция
опечатк: опечатку
прожива: проживала
границ: границу
оцен: оценил
российск: российский российском российской
романтическ: романтических
канал: канале
политик: политика
вмест: вместо вместе
завирус: завирусился
уход: уходили
зарабатыва: зарабатывать зарабатывал зарабатывают
лимонад: лимонад
коммерческ: коммерческих
интеллектуальн: интеллектуальные
самоизоляц: самоизоляции
фигуристк: фигуристкой
покупа: покупать
всяк: всякую
раздава: раздавал
пятер: пятеро
частност: частности
обложк: обложках
танц: танцы
музыкальн: музыкальную музыкального
имуществ: имущества
юл: юлией
начал: начале началом
сынов: сыновей
заня: занял
оренбург: оренбурге оренбурга
юр: юрий
примерн: примерно
хейт: хейтили
высш: высшее
приют: приютил
выдел: выделите
итог: итоге
обеспеч: обеспечить
вспомина: вспоминали вспоминала вспоминал
ерунд: ерунду
дел: дело
раскручива: раскручивать
стремительн: стремительно
игра: играть
цитат: цитаты
вар: варю
вскор: вскоре
коротк: коротко
воздушн: воздушными
письмен: письменного
москв: москву
никт: никто
нормальн: нормальной
отсылк: отсылкой
покупк: покупку
течен: течением
копирован: копирование
бережн: бережная
зеркал: зеркале
редакц: редакции редакция
измен: изменилась
понрав: понравилось
уда: удалось
дет: детей
заметн: заметно
материал: материалов
внесл: внесло
снима: снимают снимал снимает снимать
обсуд: обсудить
тиктокер: тиктокеров тиктокерам тиктокер
дедовщин: дедовщина
некотор: некоторое
отношен: отношениях
родительск: родительского
зну: зную
попа: попал
просмотр: просмотров
реалит: реалити
последн: последними последний
солнц: солнцем
месяц: месяцы месяц
услов: условия
сам: самых самый
фонограмм: фонограмму
бе: бе
детьм: детьми
друг: другими другом другим друг другую
сутк: сутки
дик: дико
пушк: пушка
листа: листай
крас: красуется
школ: школу школы
бо: бой
тотальн: тотальным
образован: образование
называ: называть
вероятн: вероятно
компан: компании компания
рассказыва: рассказывал
программ: программы
влож: вложить
неожида: неожиданную
зов: зову
нашл: нашли
записа: записать записал
телепроект: телепроекты
женщин: женщина
усынов: усыновили
начина: начинающего
горьк: горького
состоян: состояние
разлад: разлад
популярн: популярных популярного
вс: вс
сотрудничеств: сотрудничество
соцсет: соцсетях соцсети
спикер: спикера
агентств: агентства
магазин: магазинам
годовал: годовалый
достига: достигают
угада: угадай
сво: свой своим своими сво своему
уеха: уехал уехать
кампан: кампании
объясня: объясняем
помн: помню помнит
ролик: ролики роликов роликом
нача: начались начал
отдельн: отдельную отдельности
процвета: процветала
необычн: необычный
интернет: интернет интернете
го: го
прода: продал
пообеща: пообещали
волос: волосами
парн: парня
тег: тег
сбежа: сбежать сбежал
парк: парке
свод: сводила
основател: основатель
теря: терять
воспитан: воспитание
полн: полное
журнал: журналов
знат: знать
груб: грубой
настаива: настаивали
сайт: сайта
знан: знаний
контрол: контроль контроля
колледж: колледж
подонок: подонок
технолог: технологии
ежемесячн: ежемесячные
поставл: поставлю
запрещ: запрещ запрещена
выясн: выяснилось
пользова: пользоваться
поеха: поехать
хвата: хвататься
проч: прочую прочий
ярик: ярика
алкоголик: алкоголик
трек: трек треками
пап: папой
пар: пары пару
норм: норме
подписчик: подписчиков
видеоролик: видеоролики
тимат: тимати
рекламирова: рекламировали
телефон: телефон
ел: елена
прож: прожил
необходим: необходимую
числ: число числе
истор: истории
довер: доверие
ход: ходили
цифр: цифра
период: периода
тиктокерш: тиктокерш
пробл: проблем
ещ: ещ
сложност: сложности
факт: факты
человечек: человечек
сем: семья семье семьи
блиста: блистать
автор: автор
тренировк: тренировки
сдержа: сдержали
джиган: джиганом
милохин: милохина милохин
сер: серь
легк: легко
скудн: скудные
сет: сетях сеть
конфиденциальн: конфиденциальности
виде: видео
сигарет: сигареты
ухажива: ухаживать
положен: положенные
разрешен: разрешения
доход: доход дохода
реб: реб
оценива: оценивалась
оста: остаться
блогер: блогер блогера блогерами блогеры
вконтакт: вконтакте
прояв: проявил
тим: тим
вышел: вышел
виновн: виновные
принима: принимал
рдо: рдо
воспринима: воспринимал
зв: зв
зд: зд
сумм: сумма
хоч: хочу
неоднократн: неоднократно
набра: набрал набрало
крыш: крышей
рейтинг: рейтинге
переезд: переезд
дом: дом доме дома
реш: решил решили
бил: били
способн: способности
известн: известных
общ: общей
оконч: окончил
просоч: просочилась
сторон: стороны
сид: сидит
смотр: смотрите
предостав: предоставил
видеодуэт: видеодуэты
любов: любовь
недел: недели
призна: признался признана
побыва: побывать
глубок: глубоком
стоимост: стоимость
медведев: медведевой
защищ: защищены
зарисовк: зарисовки
певец: певец
ил: илья
социальн: социальных
наш: нашими
совершеннолет: совершеннолетия
ип: ип
анапск: анапской
пользовател: пользователи
мног: многих
сыгра: сыграла
ургант: ургант
зависим: зависимость
люб: любые любой
успешн: успешных
плат: платили
сил: силой
останов: остановило
тележк: тележке
план: план
фот: фото
сервис: сервисах
евген: евгенией
информац: информация
соверш: совершить
правд: правда
гот: готов
разн: разных
трат: тратить тратам траты тратами
люд: людей
спуст: спустя спустить
пен: пение
год: годах годам
прогулива: прогуливал
интерв: интервью
контракт: контрактов контракты
км: км
съеха: съехал
законодательств: законодательством
аудитор: аудитория аудиторией
недобросовестн: недобросовестной
тикток: тиктоке тикток
сахар: сахар
приш: приш
дожда: дождаться
скандальн: скандальный
запил: запилили
перспективн: перспективный
одн: одном
мам: мамой мама
прин: прин
воспитыва: воспитывался
живут: живут
никола: николаем
мат: мат
реклам: рекламе рекламы рекламу реклама
запуст: запустился
смуща: смущает
настольк: настолько
супермаркет: супермаркете
оренбургск: оренбургские
столиц: столицы
тюленев: тюленевы тюленевых тюленевым
соответств: соответствии
дрим: дрим
апрел: апреле апреля
познаком: познакомился
ответствен: ответственности
карантин: карантине карантина
федерац: федерации
заработок: заработок
воз: возить
стран: страну страны
участ: участием участие
аренд: аренда
использован: использования
селф: селфи
платформ: платформу
мо: мо моей
местн: местный
снг: снг
официант: официантом
март: марта
песн: песни песню
войт: войти
кровн: кровные
качеств: качестве
выживан: выживание
предпринимател: предприниматели
направля: направлялся
государств: государства
пиш: пишу
обнаружен: обнаружения
жным: жным
откровен: откровениями
поход: поход
подростк: подростком
пишет: пишет
апартамент: апартаменты
переубед: переубедить
семечк: семечки
новост: новости новость
перв: первому первую первых первые первого первом
воспита: воспитало
отсчитыва: отсчитывал
яросла: ярослав
формат: формат
дума: думаю
вячеславович: вячеславович
миллионер: миллионер
интересн: интересное интересные интересного
возможн: возможно
равн: равно
молод: молодого молодому молод молодой
кида: кидают
открыт: открытый
выбра: выбрал
пмэф: пмэф
буквальн: буквально
обещан: обещание
чура: чурался
голов: головы
интернат: интернате
безумн: безумными
наполня: наполнять
крупн: крупные
приобр: приобр
жилищ: жилище
дмитр: дмитрий
произнес: произнес
коллаборац: коллаборации
повлия: повлияло
кримина: криминал
каф: кафе
площадк: площадках
принадлеж: принадлежит
последова: последовали
встреча: встречался
род: родился
воспитател: воспитателей
бывш: бывший
обход: обходилась
видос: видосы
отпуск: отпуск
выпуст: выпустил
контент: контентом контент
прежн: прежнему
ярослав: ярославу
вечерн: вечерний
полмиллион: полмиллиона
откр: открыл открыть
клип: клип клипа
миллион: миллионной миллионы
шокирова: шокировать
сперв: сперва
наход: находится
опекун: опекун
источник: источником источник
ctrl: ctrl
honor: honor
forb: forbes
milokhin: milokhin
instagram: instagram
youtub: youtube
east: east
rss: rss
hous: house
tiktok: tiktok
enter: enter
wildjam: wildjam
aa: aa
new: news
pravda: pravda
team: team
merced: mercedes
maybach: maybach
pepsico: pepsico
milokhinr: milokhinreal
huawei: huawei
vk: vk
dream: dream
meta: meta
visa: visa
komsomolskaya: komsomolskaya
danya: danya
