протез: примерять лежат
ру: ру
говор: прооперировали говорила
банк: зайти присылали
вымога: вымогает
оттуд: повестка
стат: статьи
воен: военного одному связывалась полные военной военную
леж: идее
обычн: обычном обычную
оказа: незнакомца
служ: служил
стал: стали стала сообщение
объясн: знаком
получател: получателя
нич: ничем
повторя: повторяла
работ: работу собиралась
центр: центре
завис: выкуп
рекламн: сплошь
дополнительн: дополнительный
арх: архив
экономик: экономика
пол: опубликовали
сто: стоить военнопленного
человек: человека анонимный
солдатск: комитетов
лен: душевная
местоположен: местоположение
арм: армии
разговор: месяцев
выкуп: поучаствовать нелегального долларов
ста: находились
должн: лежит
структур: структуры
публикац: публикация проблема
карт: карту показал тысячах
котор: которым ситуацию
денег: денег
уб: обрадовалась
силов: силовые
вест: вести
доста: достался
связа: связаться различных
прав: конвенцию уполномоченному вопросов
участвова: позвонил
военноплен: военнопленных какие военнопленными каждого
либ: либо
связ: связь связи
появля: появляться
дела: представляете
ребят: командир
голосов: отправлял
фи: фио
травм: такими травма
разобра: обещают
инстанц: инстанции
сожра: пожелания
врем: возникло
лин: линии
рубл: рублей
занима: украинцев
лиц: взяли
встрет: двойники
карточк: российские
подруг: подруга
позвон: объявлениях елене
украинц: выйти военнопленные
нов: методы
ног: ранение ноги
внешн: участие
част: запросы возили воинской
медсестр: выдает
тишин: фоне
слож: описать
опубликова: фотографии историю
устро: карте
слов: словам выкладывать
парен: знал
постоя: датой
якоб: якобы
сдела: сделать сделают
расспрашива: убит
выкладыва: напоминаем
деактивирова: нажмите
судьб: судьбу
родител: петербурге
мошенническ: мошеннические
министерств: сайте
дают: бьют
охранник: представлялись
невестк: обсудила переслать мессенджере
обряд: обряда обряд
совет: суммы
примет: особые
ноч: недель ночью
распростран: подобные
пропа: пропал пропавших пропавшего информацией
витал: спиной
выход: перестал выходил
срочн: срочно
журналист: журналистов
переписыва: параллельно
узна: узнать которую узнал
персональн: персональные персональными
нелегальн: возможность
невзнача: невзначай
путешеств: путешествия
бесед: беседы
заблокирова: заблокировал заблокировала
жалост: жалость
атакова: ольгу
машин: причем
метод: мельникова
групп: группы разоблачал боя группах групп
техник: техника
журналистк: журналисткой
пуска: операция
европ: территории
хотел: поняла
размест: разместила
культур: культура
заезжа: горючее
волонтер: фальшивые
продолжа: продолжала продолжает
номер: номер звонки номеру
обраща: очередь обращалась
помоч: помочь
оксан: пленного
бесплатн: наничкиной
вечер: девяти неточная наступлению
скажет: увидит
помощ: помощи помощь помощью
батальон: миллион получается
выш: шансы
обменя: обменяют быстро
здоров: проблем
проеха: километров
усомн: собеседницы
уполномочен: прокуратуру
окса: супруге ответить
запрещен: азовцев
сын: разыскивает декабря пропавшем участвовал заезжал
прочита: прочитать
ротн: приехал
агрессивн: агрессивно
средств: средства
трубк: трубку
потребова: всу порекомендовали
кобец: кобец
евр: долларах
отключ: комментарии
спецпроект: спецпроекты
связыва: заявила
протяжен: угрожали
зарегистрирова: карты банка
росс: россии россия
помогл: помогла написали
механик: числился
четырех: команде
мотор: мотор
ситуац: тяжелая описала
имеет: конкретно
вызволен: вызволению
счита: делом считает
комендатур: комендатуры представляет
миноборон: минобороны
спецоперац: спецоперации пошел
лент: лента ленту ленты
завед: останков
кажд: каждую потребовали
опечатк: ооо
шла: шла
российск: гривнах обращаться
канал: каналов
сплош: стена
пробит: ранили
параллельн: успела
примеря: поликлинику
запрашива: минуты
обруш: поисках сети
останк: опознания
сказк: рассказывать
гадалок: гадалок
поясн: вольного
список: список
сказа: сказали
ссср: ссср
знаком: знакомую
ввест: ввести
езд: спрашивать
слез: слезы
след: екатеринбурге
организац: террористическая волонтеры
аньк: виталий
невозможн: погибших
юрист: например
мельчайш: мельчайших
помим: помимо
попыта: попыталась
коротк: двое
новичков: дарья
шквал: обрушился
так: такую жене батальоне женщины таким
гадалк: гадалки гадалка гадалками гадалке
перевест: могу
уязвим: уязвимом
оплат: оплаты покончу
перенесл: перенесли
назва: назвала
собира: устроило
описыва: описывал
прокуратур: крест
скриншот: скриншоты
откуд: откуда
обсуд: час
получш: действовали
собеседниц: собеседнице протез собеседница
некотор: спрашивайте
введет: ага
лечен: тратить
подума: подумала
служб: службу службы
полев: генералом
собеседник: собеседник
попа: военном четырех
спорт: спорт
специальн: специальной
незнакомец: дома
зна: зная
мариупол: мариуполь
звон: звонил удивило звонила
представля: ясновидящая душу сообщения ольге
друг: другую друг метрах
приход: приходится
активизирова: активизировались
липов: забрал
поня: лично общалась
рассказыва: рассказывает рассказывал начал
донецк: донецк донецка
елен: сообщений
получа: батальон
зайт: работой
главн: главное
действ: действий действиях
фамил: фамилий фамилия фамилии фамилию
фальшив: добычей
сестр: такого сестрой
бедр: самое
состоян: состоянии введет
стоя: группу
девят: прошлого услугу
раб: продавали
гепатит: здоровьем
присыла: запрашивали присылала
раз: слову
ран: ранен области
отдельн: чечне
интернет: интернет интернете
мобилизова: мобилизовали
тем: выкупа
официальн: официальные
гиг: гигиены
пришл: предприятии буквально
полн: сложившуюся
фотограф: фотографией познакомились фотографию
знат: вопрос
госпитал: полевом госпиталей
знак: парнем
знал: звонивший теряться
комментар: новичкова
сотрудник: сотрудников
работа: работают горловке
сильн: сильная
запрет: запретил
прос: просили разу
вызва: удаляла
услуг: пробить услуги
телефон: домашних потребовать телефон телефону
необходим: необходимо
числ: части числе
проб: невестка человеку
шум: голоса
сложност: сложности
видн: бедро
восьм: восьми
лежат: травмами
выйт: помогли
перевезл: дня
очеред: первую
виде: видео
положен: положении
мамаш: пусть
явн: протеза
продовольств: ситуация
ростов: девятого
километр: машине
оста: принять насобирали
вконтакт: вконтакте
быстр: объяснил
заключен: предлагал
подозрен: большое
эксперт: почту
спрос: спросила легкое
принима: принимал
переписок: переписок
характеристик: внешние
реч: заплатит
реш: решила
нажива: наживаются
зампол: замполит
международн: представительство
общ: общей
поконч: счетах
обитан: обитания
недел: протяжении
марин: марины марина марине
включ: освобождением
обм: обмен обмена
сред: среда
социальн: обращений
погибл: задание
мног: сентября
уста: устал
незнакомк: оксане
люб: отправила
контакт: контакт списки
фон: говорили
снял: сняла
фот: фото
гниен: ногу
погибш: отправилась
правд: правда
гот: таких
транс: транс
взял: сторон
завтр: ним
адвокат: юристы
люд: платить людей
медбрат: представлялся
отвеча: отвечала
экспертиз: медицинской
конкретн: пояснив конкретное
интерв: данным
кузнецов: ольга
комитет: союза образовываться
особ: характеристики
супруг: супруг дать
принадлежа: женщине
прич: екатеринбург
звонок: медсестра
знает: знает
одн: принадлежащий одна одном срывов
мам: кричал
прим: организация
неутешительн: неутешительным
мат: выходить
обращен: жена
действова: организации
выда: выдают планшету
команд: командиров
достоверн: достоверную
стен: пустая
апрел: братом
незнакомц: разговор расспрашивать номеров
участ: каких участия
соблюда: первых
высла: выслать
запрос: запросила креста запросил писали
сентябр: добровольцем сентябре
март: марте марта
войт: войти
аккаунт: аккаунт
глаз: своими глазах
сраз: сразу
крест: красный красного
валентин: матерей
подробн: подробностях обороны
бот: бот
украинск: украинских украинского
сильнодейств: перевести
жела: становятся
новост: новости
перв: украина советует
командир: приезде частям узнала ротный
проведен: проведения
присла: прислал прислать прислала
приня: готов
добр: деактивирована добра
написа: написала написал объявление
поиск: поиску поста
отстава: мошенниками
вымогател: вымогателей
ушел: ушел
повер: сыном
голов: головы
участник: участников
как: скажет попал какими зарегистрированные какое киев
поначал: пленных
участниц: участница
голос: услышала слышны
матер: солдатских
напомина: постоянно
встреча: встречается
последова: ответа
прошл: конце
видеозвонок: факты
род: родом
реальн: пожаловать
тяжел: дают отпускали медбратом
точн: точно
избав: побыстрее
обрат: обратилась обратиться
жертв: жертвой
разговарива: апреля
найт: найти
готов: готова разговаривать
провер: проверить вечеру
информацион: информационно
успел: счет
образ: образом
мобилизац: мобилизации
ввод: вводит
конц: лечение
дорог: дорога
предлага: связался предлагала охранниками
образовыва: эксперт
гарант: никаких
соглас: гепатита
ольг: одну специалистов переводила
маринин: проверили
удал: некоторое удалил
появ: появилась перезвонила
случа: отдельные
частичн: частичной
петербург: санкт
практическ: пробила
вернут: вернуться
вернул: вернулась
незнаком: незнакомая
чечн: телефонов
знающ: знающих
разыскива: разыскиваемого ковальчук
табуретк: сидит
александр: александр
добра: невозможно
утвержда: утверждала утверждает утверждал
схем: схеме схемы
единствен: делают пускают
вольн: заключенного
санкт: погибли
сообщ: интервью сообщило
показа: увеличилась
екатерин: екатерины екатерина екатерине
отправ: просьбе отправить командира отправили реквизиты
стонущ: непонятный
мир: мир
писа: писала маринин началось
предприят: работал
продава: украинцы
срыв: нервных
обещ: передать
обсужда: обсуждать
воинск: макеевке
екатеринбург: перевезли живет
девушк: девушки девушка
обрадова: аньков
нажм: опечатку
феврал: феврале получилось
днепропетровск: комендатуру
пересла: видно
ранен: получил ранения
сообщен: шквал голосовые пришло
боев: боевых
получ: обменяли оттуда получить
крича: голос представитель
начальник: запрос
публик: ошибку публикует
объявлен: опубликовала рекламных
горловк: проживал
разоблача: разоблачает мошенником
перевод: банковских каком
вытянут: хотела
город: метро
списк: видел включить списка
ищет: ищет
декабр: механиком
кров: сдала
рук: руки
час: часов длился
украин: мельниковой украины
столкнул: окончательно
метр: встретиться ста
прооперирова: ампутировали
отец: отец
посодействова: посодействовать
шанс: приметы
издан: изданий
двойник: комитеты
позиц: забрали
могл: могли
макеевк: согласились
побыстр: хотят
сдал: глазами
приготов: приготовить
больш: вызвала готовятся совершают
счет: положить переведу
спрашива: шум кричать
реквизит: вечера
отда: заплатишь
генерал: крупным
видет: видеть
опознан: днк
представительств: российское
редакциярекламаконтактыпресс: отключены
видел: заявил
женевск: соблюдает
жизн: жизни
бьют: издеваются
солдат: солдат
мог: единственное
пыта: пыталась
наничкин: подозрение оксана
мол: мол
момент: момент
мошенничеств: распространились
пошл: ребята
основн: основном
константин: константин
поликлиник: ездил
потороп: поторопимся
почт: совершалось
подытож: главнокомандующие
отпуска: никого
передава: случаи
удив: тишина женщин
отвезл: товарищами
провод: анализы
личн: завтра
живет: парень
нужн: гниение нужна
домашн: времена
сослуживц: сослуживцем сослуживцев
отц: отца отце отцу
поздн: поздно
порекомендова: настоятельно
вылож: выложила
ясновидя: закончились
яцин: яцина
банковск: уста
дав: давил
полож: банк
душевн: людям
заговор: заговор
дал: видеозвонок дал заплатить
тасс: тасс
приезд: рассказали
ссылк: ссылку
увеч: увечья
повестк: пришла
жен: женой зовут мать правдивости жены
дан: данными данные предварительным
собак: сожрали
дар: выше
мельников: валентина карточки
дат: даты незнакомка телефонный
весьм: рассказал
имен: имени
указа: указала
перевед: состояние
детальн: оплату
ладн: стало
неточн: информация
медицинск: медицинская судебной
угрожа: незнакомцы
перевел: перевели перевела
освобожден: занимающихся
пожалова: добро
ковыря: даст
тетрадн: тетрадном
деньг: деньги
отказа: отказалась
созвон: предложил
брат: брата брат отказывались госпитале созванивались
пошел: наничкина
предлож: сумму
увид: какую
галер: галереи
прожива: кузнецова
дво: сутки
вмест: вместе
финансов: финансовые
окончательн: проехать
полиц: начальника
ошибк: большую
муж: мужа созвониться сведения
увидел: увидела увидел
жив: жив
жил: жил
начал: начале началом
многочислен: брать
поучаствова: хотите
бюр: заведующая
наступлен: большому
заблужден: заблуждение
добровольц: спецоперацию
справочн: справочной
пост: посты публикации пост
ковальчук: елена
лист: листе
итог: итоге
минут: невестке минута предлагали
стольк: позвонила
слышн: должны
дел: уголовным
вопрос: вопросы появился наводящих вопросам
рассказа: родители незнакомец
вычисля: легко
конвенц: женевскую
вскор: вскоре
аватарк: минут
ответ: утвердительный ответом ответил знали жену
главнокоманд: искал
никт: гарантий
сталкива: сталкиваться
срок: короткий
переписк: переписку
наплел: информации
суток: любое
правдоподобн: правдоподобные весьма
уда: удалось
территор: зарегистрированного
отказыва: командиры
материал: материале
аг: бесплатно
иска: зеленский искать искала
куп: купила
обща: сестра общаться
услыша: зависит виду
посмотрет: посмотреть
последн: последней последний
месяц: рабов
сам: табуретке
жми: жми
сутк: ладно
михальчевск: михальчевский
возвраща: возвращаются
переда: города
бо: поле
подобн: является
длил: незнакомцем
неожида: неожиданно
нашл: правам нашла
женщин: услышал тяжело довели женщина невесткой
нервн: женщину
предполага: предполагаемой
вел: вела
начина: правило
очередн: сообщила
развоз: местные
мужчин: мужчина
развод: поняли
област: днепропетровской
спин: коленях
сво: сво добраться
нача: утра столько
даст: никто
специалист: нехватки
станов: публикуют муже
атак: дней
исключа: правах
парн: переписываться
кряж: подытожила
возникл: мошенничество
явля: новшеством
вещ: вещи
плен: списках плен плену плена тяжелом
законч: атаки
теря: начинали
сведен: детальные
уголовн: разобраться
правдив: усомнился
представ: представился представилась
горюч: развозил
сайт: атаковали полиции
проверен: проверенный
выясн: выяснилось выяснить
зеленск: срок
различн: родственники ночам
хвата: хвататься
окруж: обстрел
задан: пошли
ценност: ценности
ел: мама сын
истор: истории правдоподобную
зовут: стонущий
ход: ходе
тепл: теплые
мошенниц: мошенницы развод мошеннице
пробл: многочисленных
факт: предоставить
довел: собаки
сем: семью
легк: пробито европы
мошенник: мошеннику столкнулась мошенники мошенников мошенник понятно
сет: социальные
представител: липовый
вид: имеет
кондратюк: кондратюк
настоятельн: требовали
днк: кровь
днр: днр
насобира: наплела
красн: часть международного
естествен: естественно
нескольк: вычисляла
обеща: адвокаты
наук: наука
хот: осталось нужны
дне: отставали
сумм: оставшуюся отдаешь настойчиво
созванива: созванивался продовольствием
довоева: довоевался
дом: оказался позициях
горяч: горячей
сторон: окружили
шоков: шоковом
сид: отправил
предостав: ответ
обстрел: попали
тысяч: тысячи речь
дня: больницы
родственник: родственниках родственников родственник родственника родственникам родственником многие
родн: родными
хорош: хорошие
анонимн: контакты
пуст: военных практически
ид: удивилась
звонк: обрушились
утвердительн: дала
оборон: министерства
пользовател: пользователь пользователей
просьб: явно просьбой
плат: считаю
доллар: просил требовал
товарищ: друга
новшеств: новы
информац: поначалу информацию вытянуть удалила
описа: поверила подробнее
больниц: ростове сказки
призыв: призыве
анализ: экспертизы
трат: избавиться
перезвон: следующий
забра: последовало февраля
предварительн: нашли
соломинк: соломинку
ки: отвезли
требова: очередной получше
переста: елены
мессенджер: аватарке различные
поговор: поговорить
служат: знать
например: паразитирует
азовц: писать
отправля: отправлять звонок
забот: забота
понятн: становится
секретар: ответственный
попрос: попросила
приеха: вечером
настойчив: препараты
сми: сми
забинтова: забинтованы
ответствен: ответственных кряжев
познаком: сыну
союз: секретарь
заплат: мамаша лень спросил
воз: сына
январ: января
отлич: отличие
мо: моего
местн: служат
душ: ковырять
вышлет: вышлет
наводя: нескольких
прошел: прошел
нехватк: проводиться
проблем: единственная
соверша: переводов обещая
заяв: мошенница молодой
раздел: лица
издева: прим
удаля: оксаны
уст: передавалась уст
владимир: владимир
небольш: разделены
тороп: торопиться
добыч: желанной
операц: брату операции
оо: редакциярекламаконтактыпресс
возможн: возможности исключает
всу: военными
молод: мессенджеры
планшет: мужем
увелич: сумма
буквальн: группе
паразитир: теме
утр: утром суток
колен: стояли
крупн: сайтов
препарат: сильнодействующие
страниц: страницу
судебн: бюро
гривн: евро
грив: гривен
террористическ: запрещенная
бывш: бывший
прежн: прежней
ник: домой
ампутирова: больнице
откр: открыло
навред: навредить
миллион: сто
ри: риа
наход: небольшие находятся находится
никак: выкупить
непонятн: дали
пожелан: сыне
ctrl: ctrl
telegram: telegram
enter: enter
qiwi: qiwi
