париж: парижем
леонид: леонидом
ру: ру
впоследств: впоследствии
фактическ: фактически
рассказ: рассказам
стат: статьи
воен: военным военные военных военно военную
фасад: надпись
обычн: обычную
оказа: оказался оказалась
стал: стали стала стало
памятник: установлен
мнен: мнением мнению
правоохранител: правоохранителей
объясн: объяснил лнр
став: претензии
ниш: ниш
центр: центром центру
разрушен: разрушенным разрушениям
белград: белграда белград
показыва: неизвестный
север: севера север
мероприят: мероприятие
бомбежек: бомбежек
прорва: прорваться
арх: архив
экономик: экономика
пол: поле
радикал: радикалы
манхэттен: жилья
прийт: прийти
лет: летию
вооружен: вооруженные вооруженных вооруженную вооруженной вооружении вооруженного вооруженное
макияж: блогерши
взрыв: взрыва
арм: армией армии армия
нарастан: нарастания
свержен: свержения
млад: младен
проголосова: проголосовала
сув: родном
структур: структурами структуры
суд: суда суд
пригроз: пригрозив пригрозило
подел: поделился
человеческ: человеческим
назван: названием
карл: карла
уб: убили
времен: особняке
здан: здания
силов: силовой силовые силовыми
секретн: секретной выложившего утечке
запад: запад
пафос: пафос
активизац: активизации
свят: святой
признава: признававшего демонстративно
связа: связанных
обратн: обратном обратно
ризва: ризван
отмет: отметив
компромиссн: компромиссного
проект: проекта
столтенберг: столтенберг
дела: делали лично
засел: заселяя
албанц: албанцев албанцы албанцами албанцам
саботаж: саботажем
ричард: ричардом
полага: полагали
верс: версия
рамштайн: рамштайна
отреза: отрезать
центральн: центральным центральный
лазар: лазар
прост: простых простым
союзник: союзников союзник союзники
позвол: позволит
обвиня: обвиняли
справ: справа
постро: построили
немцов: немцова
предупред: предупредили
встреч: встречи встречу
полномоч: полномочий
вспыхнул: землей
освободительн: освободительная освободительной освободительных
нов: развязать китаем нови
искон: считающих
конгресс: конгрессе
парламентар: парламентариев
антич: антич
приговор: приговорил
слом: сломить
част: частью часть частях
марьянович: марьяновича
алекс: алексей
устро: устроил
черногорск: черногорских черногорские
исламизац: исламизации
слов: слова словам
цк: цк
преуспева: преуспевающей
госсекретар: госсекретаря
одновремен: одновременно
посчита: посчитали
отказ: отказа отказом
могуч: могучих
сдела: законы сделали
особен: особенного
кларк: кларк
идеолог: идеолог
деактивирова: нажмите
переселя: переселялись
пул: пуль
министерств: министерства
совет: совета
пут: путем
символическ: символическим
активн: активные активно активное
денис: денис
русск: русско русская
упорн: упорного
куск: куски
военизирова: военизированных
немц: немцов немцами
систем: система
населя: населявшие
кремл: кремле
самолет: самолет
олбрайт: олбрайт
должност: ставит
журналист: журналист журналистов журналистами
узна: узнал
государствен: государственной государственный
окун: дмитрий
летн: летний внешности
оккупац: оккупации оккупацию
отмеча: отмечали
отступа: отступать
албан: албанией албания албании
обороня: обороняющаяся
труд: труда
путешеств: путешествия
полыха: угасало
автоном: автономию автономии
курс: курс
бесед: беседует
заблокирова: заблокировал
осад: осада
сша: сша
атакова: атаковали
лидер: лидеров лидер
немедлен: немедленное немедленно
осколк: осколками
процесс: процессу процесс
вражд: враждой
техник: техника
европ: европе европы
требован: требования
постепен: постепенно
мадл: мадлен
хотел: хотели хотел
культур: культура
флагшток: флагштоков
черногор: черногории
лнр: популярные
продолжа: полыхало продолжалась
номер: номер
выл: вспыхнули
помоч: помочь
вып: выпить
неизвестн: таки дата
провозглас: провозгласила
современ: современной
помощ: помощь
врач: представителей
напряжен: напряженность напряженности
выступ: выступили
женев: женевы
клинтон: клинтон клинтону
опаск: опаской
агресс: агрессию
ракетн: ракетно
жител: житель
балканист: балканиста балканист
холбрук: холбруком
будущ: будущем
прекрат: прекратить прекратилось
спокойн: спокойно
тверд: твердое
немецк: немецкую
заочн: заочно
интерес: интересов
утрачен: утраченную
славянск: славянской славянских
потребова: потребовали
бомбов: бомбовыми бомбовых
силовик: силовиков силовикам
отключ: комментарии
борьб: борьбу борьбы
отделен: отделение
спецпроект: спецпроекты
осуществля: осуществлял
закон: признававший
авиаудар: авиаударах авиаудары
покойн: покойного
росс: россии россия россию сотрудничать
рассерд: рассердить
помогл: помогло
мисс: миссией
едв: едва
фбр: документов
поговарива: поговаривали
мотор: мотор
бомбардировок: бомбардировок
завоеван: завоевания
убед: убедить
имеет: имеет
ситуац: ситуацию ситуация
битв: битва битвы
плюралистическ: плюралистического
счита: считаю считала считали считал считать жить
цел: целом цели
цен: уверен
лент: лентой лента ленту
завел: завели
мирн: мирных мирного мирное
руководител: руководителей
маркус: маркус
опечатк: нашли
миграц: миграцию
настро: настроены
эл: элит элом
российск: российские российской
всеполитикаобществопроисшествияконфликтыпреступн: всеполитикаобществопроисшествияконфликтыпреступность
политическ: политических
создава: создавались
администрац: администрации
иностра: иностранных
юг: югу
завершен: завершение
серьезн: серьезным серьезный
итальянц: итальянцами
обруш: обрушились
установл: аэропортом
пройт: пройти
примерн: примерно
прибыт: прибытии
сюд: сюда
сказа: сказали
ссср: ссср
североатлантическ: североатлантического
ибраг: ибрагим
след: следующий следующие след следами
пыт: пытаясь
кассетн: кассетными
конституц: конституцией
побуд: побудив
засад: засаду
статус: статуса
кумир: сделался
убит: убитых убитыми
балканск: балканской балканский
порохов: пороховой
мебел: мебель
так: го
событ: событием события
течен: течение
баз: базу
техническ: технического
усилен: усиление
выходц: выходцами
блогерш: летней
капитуляц: капитуляции
назва: пригожин назвали
контролируем: контролируемая
турк: турки
косовск: косовская косовской косовских
обернул: обернулась
откуд: откуда
некотор: некоторое
антигосударствен: антигосударственный
противостоян: противостояние противостояния
игор: игорь
слободан: слободаном слободану
количеств: количеством количество
соглашен: соглашений соглашение соглашения
преказ: преказ преказе
диалог: диалога
спорт: спорт
специальн: специальных
самопровозглашен: самопровозглашенной
друз: друзья друзей
зна: знаем
услов: условий
боснийск: боснийскую
бежа: бежали бежать
зон: зоны
крах: краха
помеша: помешать
восстанов: восстановить
активизирова: активизировали
поня: понять поняли
маркс: маркса
народ: народов народы
степен: степени
ограничен: ограничению
программ: россией
выглядел: выглядели
зайт: зайти
главн: главное
действ: действия действий
разбира: разбиралась
воздух: воздуха
церков: церковь
страда: страдало
велик: великой
привел: привело привели привела
наруша: нарушалось
неправильн: неправильно
октябр: октября
приезжа: приезжали
сербск: сербскими сербско сербского сербские сербских сербское сербским
инициатив: инициативу
рубеж: рубежи
состоян: состоянии
стоя: стояли
стеванович: стевановича
плотн: плотно
поражен: поражение
отдел: отделившись
рад: радио ради
имеют: имеют
штурмовик: штурмовик
нападен: нападения
созда: создать
патриарх: патриарха
албанск: албанской албанским албанских албанского
адем: адема
помн: помнит
ствол: стволов
отдельн: отдельных
зрк: зрк
виток: виток
протест: протесты протестующие
конструкц: конструкции
передач: передача
деревн: деревня деревне
смягчен: смягчения
иоан: иоанна
интернет: интернет
предоставля: предоставляли
командован: командование
волос: волосами
завяза: завязался
тел: тела
тем: теме
штаб: штаб
воева: воевали
великобритан: великобритании
пришл: пришли пришлось
полн: полной
периодическ: периодически
бел: белом
знал: знали
комментар: окунев
позицион: позиционный
приступ: приступила приступило приступить
заперл: заперли
работа: работал работает
сильн: сильно сильная
нанесен: нанесения
вызва: вызван
десятилет: десятилетия
заполыха: заполыхал
необходим: необходимостью
числ: числу назвал числе
подходя: подходящего
отошл: отошло
период: период
подозрева: арестовало
сложност: сложности
кризис: развитие
вниман: внимание
присво: посмертно
сотруднича: захотел
пойт: пойти
одобр: одобрили
реакц: реакцией
очеред: очередь
виде: видео
ликвидац: ликвидации
остр: острее
положен: положение положением
подход: подходу
спецназ: спецназ
изгна: изгнанным
историческ: исторических
звуча: звучали
километр: километрах
оста: осталось
заключен: заключению
принима: принимавшие принимал принимать
оак: оак
разреш: разрешил
воспринима: воспринимается
объединен: объединенными объединении
тит: тито
заселя: заселялись
посмертн: молодых
распространен: распространением
реч: речь
накал: накалилась
многолетн: многолетней
реш: решил решились
бил: били
сбит: сбитый
международн: международном международного
переросш: переросшие
генеральн: генеральный генеральным
остав: оставившая оставив
залож: заложен
общ: общее
объ: объем
гражданск: гражданского
передел: передел
окончан: окончания
бронетехник: бронетехники
сбил: сбила
пригожин: политике
честн: честно
страдан: страданиям
обитан: обитания
состо: состоит
недел: недели
обе: обеих обеими
федор: федоров
ненавист: ненависть
рек: сува
обм: обмен
профессиональн: должность
серб: сербии сербам сербами сербией сербия сербы серб сербов
повод: повода
стихл: стихли
пехот: пехотой
побоищ: побоище
удобн: удобным
вглуб: вглубь
милошевич: милошевич милошевича милошевичу милошевичем
сред: среда
соста: состав
шрам: показывает
распад: распад распада
урегулирован: урегулирования урегулировании
погибл: погибли
мног: многих многие
посвящен: посвященных
люб: любил любую
похуден: уколов
способствова: способствовали
избежа: вучичу
язык: удалить
фон: фоне
останов: остановить
пилот: пилотам
неофициальн: неофициальные
фот: фото
возрожден: возрождения
происходя: происходящее
недар: недаром
погибш: жив
взят: взяться
катастрофическ: катастрофическим
гор: гором
гот: готов
разн: разной
взял: взяли
миросла: мирослав
люд: людей
гибел: погромы
год: годы годов
владен: владения
подписан: подписание
министр: министр
применен: применении
кульминац: кульминацией
потеря: потерявшей потерявших
вывод: вывод выводе
разбомбл: разбомблены
македон: македонией
одн: одним одно
продаж: выставил
широк: широкой
венгр: венгрии
перемир: перемирие
куманов: куманово
пода: подала
столиц: столице
потребн: объяснили
густ: густой
эколог: экологии
мвд: мвд
рудник: рудниках
стычк: стычки
команд: команды командующий
сообществ: сообщества
кровопролитн: кровопролитных кровопролитной
стен: стены
апрел: апреле апреля
хорват: хорватов хорватии хорватией
рачак: рачак
участ: участие
прислуша: прислушаются
глас: фасаде
регион: региона регион региону регионов
союзн: союзному союзная союзных союзными союзной
войн: войн войне война войны войну
историк: историк
горазд: гораздо
сентябр: сентября
март: марте марта
испытан: известно
войт: войти
соедин: соединиться
массов: массово массовый массовой массовые
понтифик: понтифик
тон: тони
глав: глава
состав: составит составе
сража: сражаться
обвин: обвинили
словен: словенией словении
убийств: убийства
словенц: словенцев
посеч: посечены
болезн: смертельной
похож: похожий
половин: половины
всяческ: всячески
ракет: гиперзвуковой ракетами
буяновац: буяноваца
выража: выражаются выражали
шахтер: шахтеров
новост: новости
балкан: балканах
существ: существует
перв: первой первые первым
достижен: достижения
косоварск: косоварских
командир: командиров
посет: посетивший
приня: приняли
добр: деактивирована добра
изменен: изменение
бомбежк: бомбежки
осажден: осажденные
национализм: национализма
отставк: отставку
каз: казими
болгар: болгарии
противореч: противоречий
зван: присвоено
как: какую каким
детств: детстве
кпсс: кпсс
произнес: произнес
премьер: премьер
переговор: переговорам переговоров
габсбург: габсбургов
рамбуй: рамбуйе
сражен: сражений сражении
реальн: пожаловать реальную
угаса: принадлежу
интеллектуа: интеллектуал
сосла: сославшись
тяжел: тяжелой
втор: вторая
рол: роль
погром: вылившиеся
точк: точкам
сфер: программе
авиац: авиация авиацией
мер: мер
лояльн: лояльных
обрат: обратиться обратили
жертв: жертвам
готов: готовил готовы готовые
уэсл: уэсли
терроризм: терроризм
компромисс: компромисс
антироссийск: антироссийские
влиян: оценили
студентк: похудения
вступа: вступать
независим: независимости независимость
ввод: вводились
обрад: обрада
конц: кризис конца
окн: окна
советник: советников
найд: найдены
дорог: дороги
соглас: согласилась
геро: звание
случа: случае
удал: студентке
удар: удар ударов ударами ударом
практическ: практически
вернут: вернуться
павл: павла
грец: греции
конфликт: конфликт конфликтов конфликта
александр: новую
мятежн: мятежном
утвержда: утверждали утверждал
санкц: санкции
наканун: накануне
мирослав: мирослава
стремлен: стремлении
давн: давний
личност: раскрыли
дава: давали
пабл: пабло
х: х
краев: краевой
отправ: отправить
квартир: квартира
вывест: вывести
мир: мир мире
укол: популярных
наркотрафик: наркотрафика
предприят: предприятиях
писа: писал
оборонительн: оборонительные
отнесл: отнеслись
прекращен: прекращении прекращение
воинск: воинской
внешност: удивились
безопасн: безопасности
вагнер: чвк
нажм: опечатку
резн: шрамы резней
коллективн: коллективном
боец: боец
феврал: февраля
оон: оон
ранен: ранеными
постреля: пострелять
боев: боевой боевые боевых
власт: власти властям
получ: получила получил
приобрел: приобрели
разраста: разрастался
объявлен: объявленную
косов: косовом косово
фронт: утечки
важн: важную
провел: провел
город: город городе городов города
экономическ: экономически
национальн: национальном национальное национальных национального национально
декабр: декабря
кров: кровью
рук: руках
вдол: вдоль
националист: националистом националистов
гранат: гранат
украин: очков
метр: метров
внутр: внутри
отец: отец
раскр: последние
выстав: ракеты
покинут: покинутые
сбрасыва: сбрасывались
прям: прямого прямо
могл: могли
югославск: югославскими югославская югославской югославским югославские югославских
сдат: сдаться
удержа: удержать
манифестант: манифестантами
движен: движений
подписа: подписанного подписать
ужиц: ужице
надп: музей
больш: большие большим большой большую большая большое
китайск: китайское
полуразрушен: делал
начин: начиная
предоставл: предоставлена
иде: идея
андр: андрей
длительн: длительному
сорва: сорван
направлен: направлении
ждал: ждал
лозунг: лозунги
сопровожда: сопровождались
вучич: александру вучич
резиденц: резиденция
эффективн: оценил
генерал: генералов
запреща: запрещалось
видет: видеть
развернут: развернуть
гран: грани
смогл: смогли
расшир: расширилась
блэр: блэр
редакциярекламаконтактыпресс: всу
нормализова: нормализовать
жизн: жизни
суверен: суверенной
расслаб: расслабилась
импер: империей империи империю
ознаменова: ознаменовался
зашедш: заявили
населен: населения население населенное
чвк: уничтоженных
сокращен: сокращением
пыта: пытались
воеводин: воеводины
момент: момент моментом моменту момента
американц: американцам
ожесточен: ожесточенном
особняк: полуразрушенном особняк
мор: моря
митинг: митинги
борис: борис бориса
сторонник: сторонников
демонстративн: погибший
развернул: развернулось
средневеков: средневекового
сознан: сознании
дошл: дошло
утечк: преднамеренной влияние
решен: решения
удив: сети
всерьез: всерьез
подействова: подействовали
личн: лояльность продажу личная
устаревш: устаревшая
советск: советских советские
смерт: смерти смерть
самосознан: самосознании
югослав: югославы югославии югославия югославией югославию
далек: далеких
павлович: павлович павловича
вылож: личность
дольн: дольне
земел: земель
ввел: ввели
беспорядк: беспорядки
результат: результате
турецк: турецкой
продвинут: продвинуться
рынок: рынок
эскобар: эскобара
дейтонск: дейтонских
гайдар: гайдар
ермолинкандидат: ермолинкандидат
документ: секретные секретных
предложен: предложение
увер: уверена избежать
сопротивлен: сопротивление сопротивления
затронувш: затронувших
мультикультурн: мультикультурному
хамез: хамез
белорусс: белоруссии
имел: имели
дан: личные
дат: река
войск: войсками войска
раскрыт: рекорд
подавля: подавлялись
павловичжител: павловичжитель
гиперзвуков: новой
освобожден: освобождения
пожалова: добро
скупщин: скупщина
подвергл: подверглись подверглось
формирован: формирований формированию формирования
вынуд: вынудили
отказа: отказался отказалась
брат: брат братья
летевш: летевший
убежден: убеждение убежденным
муз: временем
очк: умных
стреля: стреляйте
эскалац: эскалации
дипломат: дипломатии
грачаниц: грачаница
спасен: спасения
галер: галереи
границ: границы границе
оцен: украине врач
светозар: светозара
обезлюдевш: обезлюдевшие
политик: политики тупик политику
восток: востоку
вмест: вместе
уход: уходят
окончательн: окончательно
полиц: полиция полицией полиции
развяза: неизвестна
смир: смирились смирилось
ругов: ругова
жив: гласит
тупик: зашедшей
савин: савин
обнов: манхэттене
преступлен: преступления
объект: объектам
настроен: настроенные настроений
резолюц: резолюции
жил: жилых жилой аренды
начал: начале
стара: старались
продолжен: продолжения
наступлен: зеленского
телевиден: телевидения
медиа: подозреваемого
кра: края краев край крае
армейск: армейских
ориентирова: ориентированных
произошл: произошла произошло
итог: итогам
вспомина: вспоминал
обеспеч: обеспечить
вошл: вошла
дел: дело деле
поощря: поощрять
жит: продолжают
внутрен: внутренних
приштин: приштине приштины
заверш: завершилась завершились завершивших
вскор: вскоре
пришел: пришелся
размер: размеру
игнориру: игнорируя
проигра: проиграли
ответ: ответ ответил ответом
обществ: общества
москв: москва
никт: никто
усил: усилило
боестолкновен: боестолкновения
полност: полностью
срок: раскрыты
собствен: собственных
измен: изменила
следств: следствие
британск: британский
замк: замке
территор: территорию территории территория
избра: избран
уда: удалось
разнообраз: разнообразие
этническ: этнических этническая этническими этнической
материал: материалы
целостн: целостность
отношен: отношение отношению
ад: адем
австр: австро
турц: турцию
аэропорт: героя аэропорт
жесток: жестоких
кита: испытании
район: район
ряд: ряд
сад: саде
последн: последнего отключены
месяц: месяца
приказа: приказал
сам: самых
набира: набирала
альянс: альянса
захотел: иран
жми: жми
недовольств: недовольство
возвраща: возвращаться
подключен: подключения
организова: организовали
переда: передать
бо: бой
оказыва: оказывать
подручн: подручными
длил: длилась
длин: длинными
озабот: озаботились
гост: гостей
погранп: погранпост
шарыйэксперт: шарыйэксперт
наслед: наследия
бочк: бочкой
ира: макияжа
характер: характер
принят: принятие принятием
йенс: йенс
нашл: ооо нашла
глубин: глубине
билл: билл биллу
нервн: нервными
век: века веке век
очередн: гибель
вер: верил верить
западн: западные
популярн: эффективность популярность болезни
побоя: побоялся
брежнев: брежневым
мужчин: мужчина
смертельн: язык
церкв: церквей
пентагон: документы пентагона
владычеств: владычества
оккупирова: оккупирована
сво: резни своим
нача: началась начались начался
невида: невиданное
реша: решающий
слаб: слабы
специалист: специалисты
горд: гордая
посольств: посольство
значительн: значительно
оруж: оружие оружием
атак: атаку
го: конце
королевств: королевством королевство королевства
оруд: орудием
парт: партии
рекорд: обновила
вслед: вслед
выступлен: выступления
таннер: таннер
законч: закончите
развит: развитой очередное
листовок: листовок
уголовн: уголовное
интенсивн: интенсивность
нанес: нанесены
атлантик: атлантикой
контрол: контроль
гуськов: гуськовой гуськова
уничтожен: уничтожении число
задач: задачей
происход: происходили
выясн: выяснилось
зеленск: потребность
различн: различные
окруж: окружил
приведш: приведших
ликвидирова: ликвидирован
преднамерен: заявил
пал: пали
ценност: ценности
подразделен: подразделений
пап: папу
деструктивн: деструктивную
алексинац: алексинац
ел: елены елена
исток: истоки
приветствова: приветствовали
истор: истории
ход: ходе
ес: ес
гибл: гибли
сел: селе села
флаг: флаги
уйт: уйти
представител: представителем данные представители
вид: виду
сет: наступлении
навсегд: навсегда
защит: защиты защиту
внов: вновь
всплеск: всплеск
прекраща: прекращались
боевик: боевики
виц: вице
ельцин: ельцин
договор: договор
наук: наука наук
стрем: стремились
укр: укрылся
пво: пво
урон: урон
дне: дней
полома: поломана
предоставлен: предоставлении предоставление
мост: мост
социалистическ: социалистической
упоминан: упоминания
дом: домом доме домов дома
поддержа: поддержали поддержала
способн: способных
известн: фронте известность известных
берлинск: берлинском
сторон: сторонами сторона сторон
поддержк: поддержку
любов: любовь
призна: признать признается признана
тысяч: тысячи
глубок: глубокий
дня: дня
доб: добиться добился
родственник: родственники
претенз: ценим
родн: своем
хорош: хорошему хорошие
стоимост: медианная
ид: идеи
плакат: плакатах
им: имею
миротворц: миротворцы
наш: наших
республик: республиками республик республики
оборон: обороны
фундамент: фундамент
просьб: просьбой
большинств: большинства большинство
сил: силы сил силой
умн: выпуска
егор: егор
кошар: кошаре
арестова: фбр
нат: нато
держав: держава державой
соответствова: соответствовали
евген: евгений
выбит: выбиты
информац: информацию редакциярекламаконтактыпресс
печ: печ
группировк: группировки
земл: земли исконной
испуга: испугало
отлож: отложилось
столкновен: столкновении столкновения
оппозицион: оппозиционно
противник: противники
прешев: прешево
бомбардировк: бомбардировки бомбардировкам бомбардировке
троиц: троицы
иосип: иосипа иосип
ровн: ровно
спуст: спустя
замен: заменой
балка: балканы
объяв: объявили объявила объявило
объедин: объединила
граждан: граждане
идет: идет
торжеств: торжеств
миров: мировой
забот: забота
отстаива: отстаивают
секретар: секретарь секретарем
соответств: соответствии
президент: президент президенту президентом президента
масштаб: масштаб
акц: акции
сми: сми
огромн: огромному
голодовк: голодовку
ма: май
доктор: доктора
федерац: федерации
иван: иванов
стран: странами страна страну страны стран
аренд: стоимость
январ: января январе
уровн: уровне
побед: победил победой победили
римск: римского
перешел: перешел
включа: включал
местн: местных
коалиц: коалиция
артиллер: артиллерии
чистк: чистках
качеств: профессиональным
медвед: медведя
трновац: трновац
ненасильствен: ненасильственный
антисербск: антисербский
государств: государство государству
бомб: бомбами бомбы
правительствен: правительственные
дуна: дунай
утрат: утратил
дум: думе
османск: османского османской
проблем: проблемы проблемой проблеме
националистическ: националистических националистически
заяв: сфера пентагон
бород: бородой
коммунистическ: коммунистических
выражен: выраженные
яшар: яшари
примак: примаков
угроз: угрозы угрозам
орган: органов
борот: бороться
дума: думаю думать
операц: операцию операции
корн: корни
нанесл: нанесла
демонстрант: демонстранты
оо: информация
возможн: возможности возможность возможно
дальн: дальнейшей
всу: вагнер
молод: молодые кумиром молодая
огон: огонь
американск: американский
открыт: открытое
броз: броз
демонстрац: демонстрации
смущен: смущенными
пребыван: пребывания
хочет: хочет
крупн: крупная крупных
преобразова: преобразована
комментатор: комментаторы
дмитр: памятник
прозва: прозванный
принадлеж: принадлежит ним
присоединен: присоединения присоединение
сюжет: сюжет
бойц: бойцов бойцы
провозвестник: провозвестником
воинствен: воинственность
выпуск: сроки
восстан: восстания
миротворческ: миротворческой
бывш: бывший
мечт: мечта
обрел: обрела
лояльност: качествам
монастыр: монастырей монастырь
выступа: выступавшие
уничтож: уничтожили уничтожил уничтожим
ник: никого
преимуществен: преимущественно
откр: открыли
косовар: косоварам
июл: июля
полицейск: полицейских
июн: июне июня
наход: находясь
аок: аок
потер: потерей потерям
источник: источники
слобода: слободана слободан
xx: xx
serrailli: serraillier
ctrl: ctrl
appl: apple
kfor: kfor
ander: anders
getti: getty
enter: enter
rapho: rapho
ii: ii
armi: army
new: news
xix: xix
xvi: xvi
corbi: corbis
yugoslav: yugoslav
ap: ap
michael: michael
reuter: reuters
pettersson: pettersson
killnet: killnet
radu: radu
sigheti: sigheti
rl: rl
imag: images
xv: xv
gamma: gamma
