случ: полете
ру: ру
слух: слух
впоследств: самолета
понима: понимали
стат: стать статьи
обычн: обычных обычную обычная
стар: стараясь
оказа: оказалась
повторн: повторно
пакетик: ящички
пискаревск: мемориал
мнен: мнению
очут: очутилась
родион: родионов
осадок: человеческий
став: ставила
центр: побывала
прогулк: прогулки
сосковц: олега
арх: архив
реабилитац: центре
экономик: экономика
впечатлен: впечатление
водк: ограничился
пол: пол
выряд: вырядились
высад: татьяной
баскетболистк: баскетболистки
поступ: поступил
лет: произошло
должн: правило
структур: структуры
означа: означал
крепк: обменявшись
человеческ: соглашений
ящичк: выдвижные
пальт: пальто
котор: которому
горбачев: горбачева
времен: извинилась
здан: нового
силов: силовые
пестрел: пестрела
бурн: дороги
ум: ума
признава: признавался
вест: вести
прав: установил
визит: визитом визита
ирланд: премьером проспал
вперв: впервые
при: прием
появля: никак
рональд: рональд
таллинск: ныне
суш: причем
ричард: ричард
роберт: роберт роберту
одева: одеваться
верс: появилась
продела: эдуарда
член: членов
книг: книге
песчинк: песчинкой
малинов: русские
этикет: соблюдая
прием: следили конце
лампочек: люстр
врем: заявила
преподнесл: подарка
зал: зале вошли таллинский
трепета: трепетали
здравств: здравствуйте
лих: генсеков
встреч: встречи встреча встречу встрече
лиц: повернулась лицами
справедлив: справедливости
крепост: петропавловскую
встрет: концов встретилась дозаправку встретился жизель
эксплуатац: эксплуатацию
очевидц: глазами
украинц: закитайщина
обошл: обошлись
нов: стройплощадке новой появились
тост: поднял своим
убежд: неопределенность
кант: кантом
госдум: госдумы
част: часть неотъемлемой
алекс: алексей
мерзл: кустарниками
грунт: высадили
слов: словам единства
цк: цк
перелива: переливалась
дворц: дворца кладбище
одновремен: пары
внимательн: репортеры
особен: учесть особенное
деактивирова: нажмите
переселя: украинцы
фигур: фигурами
пут: проделала
посеща: посещал
моментальн: моментально
сердечн: встретили
русск: новые
чертов: чертовы
ноч: ночь
процедур: процедуре
систем: демократической
кремл: повседневная кремле кремль
выход: ожидали
самолет: самолетом самолете вышел
журналист: журналисту журналист свидетельству
шеф: тогдашний
невероятн: х
государствен: монарх олицетворением государственным
окун: довольна
дяд: приходившийся
отмеча: отмечал
нема: эрмитаже
путешеств: путешествия
перемеж: перемежаясь
бесед: беседа беседует беседы
сша: сша
лидер: лидера
миха: михаила умер
процесс: некомфортные
созрел: созрела
техник: техника
хотел: хотели
букинетк: руках
культур: культура культуры
нравствен: нравственный
помоч: помочь
вып: приема
нрав: нравился
неизвестн: неизвестного охранять
протягива: протягивать
одет: одеты одетых
художествен: художественную
волнова: волновались
одел: оделась
обменя: середине
довольн: подала
придава: придавало
уважен: уважением
будуч: ирландию
взор: взоры
спокойн: спокойный
тверд: заслуживают
отключ: комментарии
спецпроект: спецпроекты
плох: приступ
толп: толпа
росс: россии россия россию
мисс: выполняя
мотор: мотор
ситуац: ситуацию
цикл: материалы
счита: английской гостье считала
внуков: внуково
всплеснул: шутку
противоположн: метров
цел: подписан цель
выдвижн: внутри
лент: лента ленту сердечно
середин: встретились
сэр: сэр
опечатк: нашли
радост: большей
российск: российского ленте российскую
русла: журналиста
политическ: политический
духовн: воплощением
столб: деревья
поездк: задолго
церемониал: положенного
останк: останки
повседневн: подводят
прибыт: следующее
сюд: приезд
петропавловск: эрмитаж
протокольн: протокольное
ссср: ссср
татьян: еленой
строг: сушу
пыт: пытаясь
след: саду внимательно
желтевш: бурно
луч: рукопожатиями
статус: статус
так: такого немало
коржак: александр
рукопожат: неположенных крепкими
ученик: языка
описыва: описывают
остановк: летевший
некотор: некоторых появлялась
церемон: церемонию
подума: выступления
служб: шеф
целова: целовать
соглашен: ряд
остава: улицах
шагнул: шагнул
добав: верю
спорт: спорт
присел: присел
кулак: стучать
услов: условие
анатол: лондоне
стро: восток
расстрел: расстрела
георгиевск: георгиевском
друг: другим
приход: николай приходились
реактивн: реактивный
виндзор: виндзорам
елен: дочерями
иронизирова: корреспондент
главн: главное
делов: деловых
полет: признался
дива: дивана
велик: убеждены
низк: гостью
октябр: октября
имидж: имиджа
шеннон: инцидента
заверен: британия
люстр: шести
банкет: пьет
улыба: лучезарно
созда: пытались
нын: бухте
стол: кулаком
раздева: раздевайтесь
выполн: достоинством
интернет: интернет
необычн: необычным
торжествен: торжественного торжественность
репетиц: посольства
официальн: ближайшее
великобритан: великобритании
вячеслав: вячеслава
пришл: иронизировал
велич: истории
венок: венок
комментар: окунев
сотрудник: заверению
приступ: случился
сильн: будучи
долг: долгое
долж: должен
репресс: репрессий
русл: русло
устремл: устремлены
театр: большом
заслужива: успехом
числ: числе
посол: российский
королев: королевами королева последовал королеве королевы королеву
демократическ: частью
видн: подаст
очеред: очереди
виде: видео
мемориа: крепость
подход: подходили
положен: цветы
президентск: президентских президентский
явн: явные
историческ: духовного исторической
оста: осталось осадок
монарх: хардман монархов монарха идею
прояв: проявила
депутат: депутата депутат
вышел: рейнольдсом
принима: принимающей
тип: типа
инцидент: охнула недели
коньяк: грузинского
реш: решил морю
многолетн: президентах
олег: премьера
остав: навсегда
гражданск: гражданской
зада: задает
обитан: обитания
довест: удалось
недел: прошло
набор: стандартный
побыва: соборы
обм: состоялся
спешн: спешно
сред: среда среди
хардман: хардману
эдуард: правнучка эдуард
мног: многое многие многих
люб: любая
прикоснул: прикоснулся
принес: процесс
язык: английского
останов: остановилась
фот: фото
стил: стилю
стройплощадк: камень
прокол: проколы
взят: взятых
чопорн: чопорности
соверш: совершил
ретирова: ретировалась
люд: людей
пиджак: малиновых
год: годах годы
свезен: мерзли
поступок: поступок
особ: особа особо особую
супруг: супруг супруга
грищенк: грищенко
прич: залив
хардма: рассказал
хакамад: хакамада хакамаду
одн: драмкружка
подаст: дожидаясь
широк: широко
мат: мать
конфуз: особенности началось
конфузн: конфузную
приж: смогли
приб: прибывшей прибыла
пода: даме прощались никому
улиц: кричали
свидетельств: королевой
помощник: помощники
подарк: качестве
монашеск: монашеского
огранич: банкете
донск: донской
подня: водкой
эрмитаж: площадь публикой
смотрет: смотреть
задолг: официальный
пьян: сильно
навстреч: навстречу
войн: войны
никсон: никсон
уклон: уклонилась
сентябр: сентября
войт: войти
проща: утверждал
интересова: интересовалась
некомфортн: перемен
глаз: глаза история
протокол: рукопожатий многолетний
посадк: посадку
холодн: холодно
половин: половине
похож: роз
милиционер: усеян
новост: новости
принц: принц
перв: первыми
бог: богов
подвод: подводили временами
бухт: ревельской
посет: посетить посетил
смокинг: смокинги смокингах
промямл: промямлила
приня: приняла
достоинств: нации
добр: деактивирована добра
вбок: вбок
кремлевск: кремлевской кремлевского
шест: лучами
голос: голос
кпсс: кпсс
премьер: вице встретиться
последова: последовало шевченко
встреча: встречалась
господин: обнимет
прошл: сил
закитайщин: изменили
высок: букета высокие
реальн: пожаловать
роз: букет
дешев: дешевых
достопримечательн: достопримечательности набор
вудард: вудард
готов: готовы
чувствова: плохо
нескладн: нескладными
костик: костиков
преподнес: поклоном
конц: вина противоположных перестройку
преемствен: мудрости
дорог: вдоль
марафон: марафон
соглас: согласилась
успех: увенчаются
появ: прессе лицом
случа: видно
расставлен: расставленных
петербург: петербург москве
вернут: вернуться
вернул: вернула
возглав: возглавили
наин: наина
александр: безопасности
галантн: галантно
разноцветн: разноцветно
утвержда: подает
вообщ: вообще
единствен: единственный
констатирова: констатировал
москвич: москвичами
спецназовц: округи
неловк: таких
ожида: конфуза
санкт: санкт
хрущ: хрущев
х: лихих
показа: показала
сообщ: любезностями
дворец: дворец
отправ: чувствовал
поэт: пьяным
заминк: некоторой
ловкост: ловкостью
памят: памятью
мир: мир мире
внешност: внешность
безопасн: службы
нажм: опечатку
варфоломе: варфоломеев
обед: обеда
шутк: тостом
отдела: отделанного
крича: адамишин
подтвержда: миссию
публик: предстать
флот: флота
важн: подтверждаете
провел: провела
репортер: британские
город: спецназовцы
неопределен: принес
рук: видят держать руку всплеснула рук
вдол: столбы
правлен: системы правление
метр: длиной
внутр: дерева
традиц: традиции
линьков: руслана
увенча: усилия
прям: прямо
площад: площади красную
покинул: покинула
могл: могла
подписа: результаты
предвкушен: предвкушении
облачен: облачения
больш: большого похоже преподнес посмотрели
адамишин: анатолий
охраня: пришлось
ждал: ждали
костиков: костикова
балтик: балтике
неположен: неожиданных
резиденц: резиденции
видет: видеть
англ: отношениях англию
исчерпа: инцидент
смогл: растения
мягк: мягкий
восхища: восхищалась
редакциярекламаконтактыпресс: цикла
плавн: плавно
окружен: окружения
жал: республику
жизн: жизни
импер: империю
надел: надела
деятел: деятели государственный
солдат: солдата
пыта: пытаться села
приглас: пригласили пригласил
момент: момент неловких
перестройк: довести
мор: пути
пообща: пообщалась
борис: борисом борис
вышл: протянет
грузинск: выпил
подготов: проспала
воплощен: правления
делегат: делегаты
советск: советским советскими советские
почв: почва
ощуща: ощущала
генсек: генсек отключены
правнучк: требовал
чет: ним чета
результат: оставайся
приседа: приседать
обнаруж: обнаружены обнаружила
приезд: остался
яхт: яхте исчерпан
ирон: иронией
елизавет: елизавете елизавета елизаветы елизавету
безлик: безликое
вначал: вначале
иностранк: иностранка
жен: жена
дам: этикета
весьм: весьма
установ: протокол
посторон: посторонний
состоя: букеты
камен: мемориальный
вряд: англией
пожалова: добро
стуча: громко
летевш: го
брал: радостью
фрак: фраки
заран: пресса
дерев: полированного неизвестно
галер: галереи
политик: политики политику
восток: дальний
вмест: отправил учениками
усея: добавила
британ: возвращаться
почтительн: низким
рейга: рейган
регбистк: регбистки
муж: мужа
увидел: увидела
невин: невинно
стара: сотрудники
начал: конфуз
писател: писателю
кра: краям
напрокат: напрокат
повернул: фортуна
коллекц: коллекцию
произошл: поездки
вспомина: вспоминал
вошл: одновременно вошла
ближайш: достигнут ближайшего
вопрос: вопросы
рассказа: лампочек
размер: размера
пулков: пулково
заверя: заверял
ответ: ответ
изучен: углубленным
вреза: врезалось
москв: москву городах
усил: великие
несмотр: деятель
букет: небольшого брала большой
охнул: руками
смея: смеялись
измен: изменилось пиджаках
единств: исторического
британск: британских британская британское британского британской поэтому
держа: держалась улыбался должна
замк: замке
уда: жалею
дет: детей дети
цилиндр: цилиндрами
бизнесм: бизнесмены
неотъемлем: монархия
людьм: людьми
невидимк: невидимкой
грановит: грановитой
ирин: ирина
материал: горбачев
угл: углу
восстановлен: восстановления
кладбищ: пискаревском
отношен: отношении наших
претенд: претендующий
аэропорт: аэропорта аэропорту
наста: настали
рома: роман
престижн: одну
сад: семенами оставила
ряд: целый
посмотрел: ельциными
снисходительн: снисходительно
могил: могиле
мемориальн: открыла
жми: жми
учест: старались
возвраща: решила
возлага: возлагают
расстреля: расстрелянной
школ: столичных
романов: романовых
гост: гостей гостили сообщил гости гостья приветствовал
длин: длинное зал
извин: вышла
неожида: оберегая
нашл: ооо
женщин: женщина женщинам женщин
пресс: пресс сосковца несмотря
бесформен: бесформенное
никол: николая
жизел: театре
вер: верить твердо
инвалид: реабилитации
мужчин: мужчинам
цвет: подготовила
рейнольдс: альбертом
сво: столу своем свой
нача: утро
фортун: очевидцев
посольств: посольство здания посольстве
замеча: замечать
россия: россиян
го: шенноне
раская: раскаявшуюся
церемониа: строгий
выступлен: началом
мудрост: государственной
горбач: михаил
представ: представили представилась
оберег: случается
выясн: заминки
округ: всей
поеха: поехали
королевск: королевской королевский королевского королевская
достигнут: пик
ценност: ценности
перем: времена
пар: чете
предста: высокая
виз: визит
пьет: приеме
драмкружк: репетицию
приветствова: господин
вин: красного
истор: преемственности невероятная
филипп: филипп
лондон: посол
сел: строили
сем: прижиться семьи
семен: пакетики
вид: букинетку
умер: конца
навсегд: семья
красн: красной бокалом достопримечательностей
ельцин: ельцин ельцины ельциным вместе преподнесла ельцина
кникс: книксен
виц: вместо
наук: наука
памя: память
неоднократн: неоднократно
соблюд: моментов
способн: способный
известн: известный известных
сторон: стороны
альберт: ирландии
слегк: слегка
проспа: гувернантка версия
костюм: костюмах
призна: призналась коржаков
адмира: адмирал
глубок: глубоким
тогдашн: впоследствии
дня: дня
родственник: родственниками
хорош: хорошие
ид: важную
никит: никита
из: держался
нац: величия
наш: пиком
республик: создать
школьник: школьниками
плат: платья
сил: изо
изумлен: изумление
описа: описал
информац: редакциярекламаконтактыпресс
сход: сходили
облача: облачаться
протянет: руки
олицетворен: считают
сканда: скандала
английск: сюда изучением
требова: церемониал требовали
кустарник: желтевшими
улыбнул: улыбнулся
покаян: покаяния
черн: черное
собра: собравшихся
любезн: любезно обмен
смакова: заранее
дочер: сада
васильков: василькового
спал: спала
величеств: величество
лучезарн: милиционерами
никола: летом николаем
забот: забота
страх: страха
секретар: секретарь секретаря
президент: кремля президент президенты президенту президентом президента
роман: романах
восприня: восприняли
приеха: приехать
сми: сми
чест: честь
гувернантк: выяснилось
бокал: тост
полирова: коробку
воротник: воротнику
стран: страну страной
мо: мое
громк: подумал
углублен: школ
непринужден: непринужденно
виндзорск: виндзорском
качеств: коньяка
корреспондент: линькова
пик: считаю вряд
прошел: прошел
дозаправк: остановки
столичн: престижных
собор: дворцы
медвеж: смаковала
заяв: словами
владимир: владимир
управля: управлять
поклон: почтительным
небольш: церемониалу
дума: думаю думал
относ: относилась
формац: формации
нанесл: нанесла
оо: информация
дальн: переселялись
коробк: ельциных
буквальн: буквально
штандарт: императорской
дожид: подают
палат: палате
утр: прибытия
ревельск: штандарт
убиен: убиенных
все: свезенные
дмитр: дмитрий
оранжев: оранжевым
растен: грунт
императорск: дядей
поведен: поведение
бывш: бывший
ник: яхта
шевченк: протокола
стандартн: петербурге
откр: инвалидов
ри: риа
революц: революции
никак: никакой выхода
каков: каково
обнимет: медвежьи
ii: ii
librari: library
hussein: hussein
ctrl: ctrl
bae: bae
graham: graham
getti: getty
anwar: anwar
keen: keene
pa: pa
pictur: picture
vii: vii
martin: martin
tim: tim
imag: images
enter: enter
