ру: ру
банк: открытую
понима: причин
стат: статьи мечтал
воен: линии связь военная семье военной подходить
обычн: обычную
оказа: совпадению дорогу оказать
служ: офицером
стал: испытанием стало
объясн: ребенку лнр
нич: ничем
гуля: отправлять
работ: детская запас выполняя работы
разрушен: покидать
центр: социальный детскими работает
дополнительн: обстрелов
арх: архив
экономик: экономика
инфраструктур: разбит
пол: удовлетворена
учебн: продлили
манхэттен: жилья
приятн: посылками
критическ: питьевую
охот: занимаются
пункт: эвакуированными
поступ: эмоциями
лет: прилет
макияж: нанесения
взрыв: взрывом
разговор: отвлечь
антен: утыканную
знакомств: знакомство
структур: структуры
макс: максим
запас: выход особых
котор: мальчик
времен: пунктах
силов: силовые занимался
секретн: позволяет выложившего
кухн: кухни импровизированной
прав: республики лад
связа: образование стресс
угадыва: угадывается
нараста: нарастающий
внезапн: опасений
связ: налажена антеннами
при: приему
весн: среды
опас: опасаясь
ребят: ребята встречались
устоя: стрессом
член: наряду
разобра: разобраться
прост: руководствуется силы простых
багажник: багажника
лин: помощи
россиянин: россиянином болезни
сосед: соседи бросил
детвор: донбасскую
справ: помогает
занима: приходилось донбассе показалось
удивл: немало
встреч: родственная
лиц: вдохновил
планирова: управлением
запорожск: весной
встрет: встретить крае
разумеет: солдаты
дружеск: личное
весен: весеннего
нов: китаем освоить
внешн: внешне
част: нормальная
лязг: лязг
алекс: самостоятельные
устро: представлений неожиданно
слов: секторе
осво: учебу
якоб: эпизод
кольц: подтягивается
сдела: сборах
определен: испытывает
расспрашива: вилку
куденк: алексей
деактивирова: нажмите
сложн: отгораживаться
пул: фонтанчиками забрать
родител: винит следует
дают: обширное
камн: камни
совет: представители
нос: мальчика носятся
активн: активных
русск: зазуля
пример: страны
ноч: глубокой
расположен: проползти
куск: куски
мариупольц: заявкам
выход: секретность
срочн: находится
летн: летней
отмеча: школьной
натал: супруга
частн: запасов
нема: российские
трудн: дня
путешеств: путешествия
откопа: шиком
сша: последние
машин: понял
лидер: ракеты
процесс: образовательного
техник: техника техники
надолг: задерживался
напрот: луковенковпсихолог
культур: культура
волонтер: волонтер родственниках помогавшим волонтеры никто ковалевым
заезжа: волонтеров редко
лнр: популярные
продолжа: центрами продолжались
помоч: помочь
помога: психологом обеда соцсетях всерьез самооценку
ловк: ловко
перенест: квалифицированный
рисова: хочется
купл: лекарства
помощ: помощь помощью доставка
врач: нато
здоров: больших здоровья
заключ: вместе
дорожк: беговую
опасн: грозила ел поставить
жител: жители оставленный
сигнал: случаях
будуч: будучи
азовста: азовстали
спокойн: мешал
опасен: оправданных
средств: медицинские подручных
отключ: комментарии
спецпроект: спецпроекты
шик: интересно
росс: россии россия россию сотрудничать
помог: разговором носил
помогл: смыслом
обширн: поле
едв: познакомился
фбр: пентагона
гусеничн: гусеничной
мотор: мотор
автомобил: автомобиль
ситуац: стрессовых сложной утечки ситуация
найден: принесли
причин: эмоции
артиллеристск: артиллеристских
эвакуирова: эвакуированы работал
отлича: отличаются
лент: лента ленту
середин: спасателем
мирн: возвращаться
опечатк: нашли
лекарств: мариупольцев
педагог: луковенков родителей
шла: школах
российск: встретившие российском украинского
взаимодейств: систематическое
кукушкин: кукушкина
безвылазн: дону
идут: идут
иностра: большой
раздава: развозить
юг: юго
пятер: пятеро
налич: предполагает
серьезн: взрослее бронежилет
желез: железа
установк: неправильные
мальчишек: мальчишек
добавля: добавляет
лисицын: павел
хейт: здоровьем
професс: выборе
список: длинный
ссср: ссср
езд: психологами регулярно
посылк: доставляя поспешил
пыт: пытаясь
след: следующего общаться
дежур: размещения
джексон: питера
нашел: нашел травмирующей
подвал: просидели подвале
трофе: охотой
параллельмо: параллельмоя
лекц: длительных
так: таких
общен: открытого
нормальн: попадали
семейств: семейства
выясня: методикам
техническ: тактические
блогерш: внешности
назва: пригожин
собира: собирают
синдр: посттравматический
получш: обстояли
рутин: выйти
некотор: поступить
отряд: спасательный
нужност: членами
утыка: машину
собеседник: напоминает
добав: добавился
поним: понимая
спорт: спорт
выпа: горячей
специальн: служил новую специальной специальную
стрельбищ: оцепление
методик: проективным
солнц: солнца
мариупол: мариуполе мариуполю новостью
стро: занять
голода: надолго голодали
друг: квартирах другим двумя другую
питер: фильмам
зон: встреча жизнью
приход: конкретно
оперштаб: оперштаба
сбор: участвующих
садик: учреждениями детскому знаменитый
поня: удивлены
железн: перескочили
успокаива: нужность
рассказыва: опасность заниматься объяснишь
прокрадыва: любил
компан: иностранной
донецк: главы непременно
программ: россией
вчер: вчера
получа: успокаиваются строю
голодн: голодные
главн: главное
действ: действия обстановке действий
кислород: поступление
разбира: волонтерами бросили
непремен: возможно
покида: отказалась
фамил: украинскую
привел: итоге
взросл: общения взрослых средств взрослому вопросов
рац: рации
методическ: обеспечивая
неправильн: формировать углу
посильн: посильную
сестр: двоюродную
стоя: профессии
энергичн: энергично
филон: иван
мишен: расположенное
рад: правило
присыла: приносят
магазин: магазин
колодц: воды
улыба: джексона
объясня: детей объяснял
помн: сверстников
нижн: нижнего вскоре
муниципальн: связано формировался
деревн: доме
выполн: напротив
интернет: интернет специальность
ковал: спасателя
всеобществополитикапроисшествиярегионымоскв: всеобществополитикапроисшествиярегионымосква
завяза: внезапно
штаб: штаб
привычн: выдернуты
пришл: студентке
бед: разбираться
знат: дают
питал: питалев
питан: памперсы
знан: технические
знал: знали
комментар: заключил
беженц: беженцев
физик: геометрии
прощ: поэтому
сидевш: сидевших
адрес: отправлявшиеся
работа: безвылазно июня ковалев работали
нанесен: блогерши
малютк: матери
долг: большую
долж: необязательно
чумаз: чумазые
телефон: дежурил
пособ: методическими
необходим: необходимые
биолог: химии
числ: назвал
подозрева: арестовало
просидел: знать
сотруднича: захотел
комнат: комнату
восьм: восьми
дров: обогреться
снижа: психологическая
выйт: рады
птср: синдром
виде: видео
подход: рекомендую
положен: опасное
выдернут: выяснялось
возник: психологов
попада: адресам риск
обстановк: ориентироваться
явн: руками
ростов: социальной
реб: потребность
спасател: мечта устроился
оста: оказывать
быстр: мирной
спрос: спросила
типичн: типичная
предмет: биологии
набра: дровами
тих: гулять
подсказа: нашелся
реш: правам решили
окончан: жителями
знаменит: печально
пригожин: политике
обитан: обитания
недел: учебный
обернувш: обернувшись
кусочек: лакомый
сред: среда информационной
социальн: городской центре
семилетн: военного
чувств: чувствуют
погибл: летом
мног: многие получается
титр: список
нулев: середине
наблюда: бруствером
ковалев: александром
люб: груше мальчиком любом
похуден: уколов
избежа: точно
язык: удалить
фот: фото
тушенк: тушенкой
упаковыва: ночи
поспеш: родственницы
похвал: делом
взят: усердно
гот: любой
разн: разных
взял: практически
элеонор: информацию
взяв: взяв
люд: помогать людей
разб: каникул
отвеча: отвечает
изуродова: изуродованный
максим: рассказывала максима
конкретн: опыт
предостереч: старается
девочк: младшей погибли
зачаст: колодца
физическ: экстримом
малыш: малышам
поступлен: ограничивающей
особ: другом
удовлетвор: ребят
супруг: новгороде
вывоз: вывозят
мариупольск: интернета
одн: одни одних одним
блин: промазывали
мам: месяцев помогая
задержива: центр
продаж: выставил
настольн: настольные
улиц: улице
потребн: соответствующая
инструмент: дал
маск: бронежилете
объединя: объединяются
апрел: апреля
мусор: мусор
заслужен: получают
предупрежда: педагогов
ограничива: маске
луковенковпсихолог: бесполезным
удивлен: удивленный мариуполь
регион: самых
испытан: дополнительным известно
войт: войти
завтрашн: ждать
глав: советнику главе
эмоц: понимает определенные
бутылк: бутылки
подтягива: кислорода
питьев: раздавать
сраз: сразу
систематическ: переключились
макарон: макароны
поступа: поступали
григор: григорием
болезн: смертельной
украинск: украинском перевели процесса
ракет: гиперзвуковой
вполн: связи
тактическ: усвоил
новост: приятной новости
нижегородец: рассказывает
перв: лицее
шьют: шьют
приня: готова принялся принялись
добр: деактивирована выступает добра
поиск: поисках
запомн: критически
сваливан: снижает
упрека: волонтера
тро: троих
бьет: кольцах
образовательн: перестройка
определ: определили
матер: сестру
обстоя: дела
напомина: девочка
гул: гулу
родствен: дружеская
площадк: площадке площадки
фильм: титрах
встреча: школам
прошл: ребятами
памперс: куплены памперсов
реальн: пожаловать
тяжел: дорожку
земляк: присылают
асфальт: асфальта
точн: мальчику
риск: страх ребенок
сфер: программе
форм: физической
мер: соблюдении
продукт: продукты продуктов
рекоменд: многих
быва: проводника
учеб: взяться
консерв: консервы банку
готов: маме живет
заявк: приобретенные
затиш: затишья
влиян: оценили
студентк: похудения
информацион: привычной
уазик: уазика
зазул: анны зазулей фамилию
вызов: серьезных
советник: федоренко
конц: оставшимся
дорог: железную дороге попадаешь
маленьк: маленькими
ребенок: средства
приобретен: упаковывала
случа: максиму доброволец помнит
удал: пришлось
шестилетн: запомнил
практическ: обросла педагог
вернут: вернуться
наряд: работу
незнаком: незнакомому
четырьм: четырьмя
неравнодушн: неравнодушных
принос: посылки
александр: консультации улыбается
добра: добраться
ожида: ожидал
личност: раскрыли
проективн: рисовали
показа: вакансии
поэт: военными
квартир: живущих
футбол: футбол
шефств: взял
мир: мир
мальчик: спас шестилетнего куденко семилетним
укол: популярных
знают: знают
внешност: удивились
безопасн: мер
травмир: индивидуальную
порошок: стиральный
вагнер: чвк
соблюден: лекциях
скор: случаев
нажм: опечатку
ива: примеру
формирова: огонь нулевых
бронежилет: найденный тяжелом
экстрим: силовым
выраз: трудно
обед: утра
новгород: новгорода нижнем
усердн: вновь
боев: боевых боевые получил
получ: русский сделать родном подразделениях
оправда: заезжают
чудовищн: перенести
разрыв: разрывов
фронт: ситуацию
город: город города городе
раскладыва: раскладывать
рук: едва прямо
украин: украине украины
гранат: соседа
сектор: частном
встает: компании
раскр: сша
детск: детский школами помогают детское детские вспомнилась
выстав: лидер
прям: консервов
движет: движется
прилет: садик
могл: могли
макеевк: садику
дипл: получив
больш: проводить инженером избежать
мест: место месте
ждат: устроена
инженер: работа
длительн: нуждаются
игр: игры
сопровожда: сопровождающий
попаст: попасть
доставк: оперативная
отда: отдают
доставл: донбасс
эффективн: оценил
видет: видеть
доставля: доставляют
редк: бывать
испытыва: разбирали
редакциярекламаконтактыпресс: всу
вспомн: уровне
представлен: устоявшихся
жизн: связанный жизни
самодельн: самодельной
солдат: мишенями положение
зашедш: зашедшему заявили
чвк: уничтоженных
индивидуальн: долгую
разыска: удалось
проводник: перевозчика
момент: опасный некоторые
растеря: растерян растеряны
перестройк: стала
завезт: донецк
основн: организована
обросл: работе
необязательн: сваливания
щербин: щербиной
оставлен: привело
психологическ: скорая психологическую
утечк: подозреваемого влияние
решен: сторону
мгновен: мгновение
удив: сети
всерьез: москвы
провод: птср
живет: оказалось
личн: дело продажу
нужн: нужна
отц: совета
чиновник: планировал
светлан: разыскать
ощуща: родителям
вылож: личность
опыт: опыте
павел: питание
донбасск: предостеречь
усво: хватало
ваканс: отряд
луковенк: александр
дал: инфраструктуры разъяснил
принесл: случай
документ: секретные утечке
мечта: школьных
увер: спокойно
вдохнов: людям
побеседова: побеседовала
афишир: владивостока
дан: личные
лихв: формы
раскрыт: рекорд
народн: донецкой
живш: жившей
донбасс: донбасса ездить отмечает
гиперзвуков: новой
медицинск: еда
перевел: смеялись
пожалова: добро
федоренк: элеоноре
штабн: спутать
отказа: семья
очк: умных
брал: брали
заран: визите
галер: галереи
оцен: очков врач
дво: двое
восток: востоке
политик: тупик
вмест: вместо бедой
уаз: танком
отгоражива: свойственно
покупа: покупают
увидел: увидели
тупик: зашедшей
обнов: манхэттене
потянул: потянулся
жил: аренды
уверен: уверенным
стара: силами
начал: мая
перепрыгив: перепрыгивая
заня: готов
руководств: зоны
танк: покататься
наступлен: зеленского
добровольц: другими выпала добровольцев
медиа: документов
высш: первое
офицер: стоял
кра: переднем
протерет: помог
уклад: получше
ориентирова: проще
итог: поражало
вспомина: зовут
минут: минут
совпаден: зазули
дел: отношении объясняет заслуженную
вопрос: вопрос ряде
бесполезн: ощущает
игра: играть играющих
вскор: возможную
размер: размеру
вилк: протереть
никт: ним
москв: отцов
срок: раскрыты
смея: мамой
территор: территории
уда: бендусу
дет: установки детям дети
перескоч: сдуру
поднима: похвалу
угл: сидеть
отношен: словам
мчс: военных
обща: правилом
ан: девочке малютки анна
квалифицирова: квалифицированную должен
продл: далее
кита: испытании
район: районе
ряд: безопасности
последн: последний отключены
переключ: основном
хим: физике
месяц: анне
сам: стрельбище нижегородцы
бендус: лисицын бендус бендуса
захотел: иран
жми: жми
детьм: детьми
возвраща: окончания
инач: знания
вырос: пуль
организова: мчс
нашедш: приехавшие
переда: вспоминает переданные
школьн: рутинной ситуаций
бо: завязаться боев бои
школ: садиками шефство ездили мариупольских
оказыва: оказывают добровольцем иначе
образован: высшее
подручн: собранной
обогрет: возможность
длин: получится
управлен: муниципальным
ира: макияжа
неожида: диплом
стресс: справиться чудовищный
нашл: ооо
женщин: женщина
передн: оказались
смысл: практическим
предполага: деревне
сдур: патриот
популярн: эффективность музыки
развоз: помогал
соцсет: комментаторов
смертельн: язык
област: херсонской
пентагон: документы
сво: действует уклад
исчезл: исчезли
воткнул: пулю
распределен: распределению
нача: началось
реша: решают
лежа: признает
россия: россиян
груш: бьет
парн: нижегородец
рекорд: обновила
нужда: трофеями
вещ: вещи вещей
щур: щурятся
сгружа: сгружать
обеспечив: школой
алгебр: пособиями
консультац: тренинги
родственниц: семью
переж: инструменты
груд: груда
уничтожен: число
происход: происходит
тренинг: прошли
зеленск: объяснили
поеха: поехал
хвата: лихвой
трет: третьи
ценност: ценности
мыл: завезти
подразделен: специальных
ед: вода
виз: предупреждать
гоня: гоняют
ел: явно ели
вин: неправильно
зовут: ребенка
двум: недели
пробл: проблем
психолог: психолог добровольцами стать относятся вызовов взрослым
сем: вырос разрушенный семьей принять удивлению семьи
оцеплен: прокрадываться
представител: предметам данные
сет: наступлении
налаж: бой
внов: помогло
доброволец: пережить
печальн: макеевке
естествен: голодал
стиральн: мыло
нескольк: несколькими
наук: наука
позволя: рассказывать
городск: порошок
многоэтажк: многоэтажки
дом: своем
дон: ростове
поката: крайний
поддержа: подсказал
известн: фронте
нижегородц: земляки
горяч: телефоне
постав: детвору
сторон: отодвигать
шоколад: шоколад
призна: частая
обстрел: подвалах обстрел
тысяч: тысячи
глубок: наталья
дня: завтрашнего
родственник: расспрашивал
родн: чиновником
хорош: хорошие
двоюродн: светлану
стоимост: медианная
ил: илья
мяч: мяч мячом
республик: народной
патриот: уаз
сил: нашедшие противника
умн: выпуска
сир: сирена
арестова: фбр
оперативн: военным оперативный
регулярн: продолжает
эпизод: упрекали
гроз: волонтерам
нат: представителей
гуманитарн: гуманитарной
информац: редакциярекламаконтактыпресс передал
спута: вполне
ворот: ворот
строительн: строительный
земл: воткнулась
противник: артиллерии
россиян: россиянами
забра: откопать
каникул: работать
двор: двор дворе
живущ: живущим естественно
размещен: временного
собра: кухне
закрыт: закрытый
младш: заезжал
спас: уверен
гвардейск: гвардейской
проползт: интересным
отвлеч: парня
отправля: бытовых срочно
правил: понятным
самостоятельн: самостоятельно зачастую
забот: забота
страх: свой
понятн: простым
промазыва: разумеется
соответств: проблемы
приеха: приехал зоне приехали
сми: сми
лад: российский
ма: конце
музык: громкой
познаком: которым
вод: воду набрать водой солдата
самооценк: поднимает
отодвига: ситуации
стран: страна регионов
аренд: стоимость
вол: доброй
уровн: бытовом
перевозчик: качестве
громк: громко гранатой
местн: местных
сидет: тихо
артиллер: кусочек
спасательн: муниципальный
бегов: встает
упорств: семей
качеств: воли
участв: афиширую
лаком: штабной
выбор: землю
посттравматическ: возник
наскольк: быстро
владивосток: филонов
свойствен: психолога
проблем: областей
поража: упорство
стрессов: психологии
заяв: сфера
херсонск: запорожской
сверстник: серьезнее
относ: моменты
операц: операция операции
крайн: дорог
оо: информация
возможн: решил наличие насколько
интересн: самым блинов
оп: боевой
дальн: дальних
всу: бойцов
разъясн: поддержал
огон: рискует
уголк: уголков
открыт: простого руки
брос: россиянин взрослые
утр: шла
хочет: выразить
все: всей
комментатор: хейта
бруствер: лежать
сюжетспециальн: сюжетспециальная
увлечен: увлеченно
меша: якобы
круп: крупы
бойц: вагнер
выпуск: сроки
наверн: наверное
воспитател: воспитатель
прежд: прежде
бывш: бывший
бытов: оказывал решения
мечт: заранее
фонтанчик: наблюдать
выступа: собеседник
ребенк: получилось момент
геометр: алгебре
июн: начале
ри: риа
наход: сигналы находился
импровизирова: готовившей
учрежден: взаимодействие
никак: никак
killnet: killnet
ctrl: ctrl
metro: metro
appl: apple
enter: enter
