обрат: закончится
готов: прошлого
финам: аналитик
оценк: согласны
говор: оснований
банк: вырос рублях займы
рф: еврооблигациям
экспорт: рублями
рэ: профессор
оказа: бкс партнеров
отдыха: поехать
инвестор: отметил
конц: ожидают
дорог: отбивать
предлага: данилов
дорож: селянин
случа: таком
рекламн: гендиректор
частичн: полное
арх: технологии
предел: проектам
правов: реклама
привлеч: виновные
сокраща: изменятся экспорт
торговл: внешней
александр: финама
сто: вечеру
скакнул: добычу
сошл: удачно
основан: каких
д: ретейлеру
вообщ: миллиардов
лет: весной
потреблен: сокращать
ожида: капитал непредсказуемо
р: д
снижен: опек
структур: изменений
дава: давали
ч: кровные
поэт: валюта
мин: мин
вывест: британской
мир: инфляции
продава: минфин
крепч: значительно
прав: основные редакции оказались
бакс: увидим
отмет: запозданием
уч: аналитиками
скор: увеличивается жди
опрошен: экспортеров
либ: джиоев
нажм: текст
проект: долю пересмотрим
резк: резко
ива: автор
весн: наблюдали
подорожан: повышения
получ: валюту
верн: конца
публик: торговле
констатир: кризису
увеличива: импорт
книг: образование
национальн: полтора
владисла: первая
актив: российских подбирает
традиц: ошибаются
укрепля: развернулся
рубл: платит курс сидеть чиновников рубль констатирует рублей
позиц: текущих
предупред: вые
движен: спекулятивное
повышен: вероятность
нов: начале поднимали россиян юаней
перекладыва: сложнее
нарушен: обнаружения
внешн: данные
миллиард: десятков
вшэ: инвестбанкир
цб: выводами
устро: школы
слов: поступает
журна: архив
пересмотр: трех
профицитн: наблюдается
отзыв: книга
сложн: сдержанным
надея: эксперт
совет: головы
энциклопед: энциклопедия
примет: биржевая
кит: текстиль
выход: иностранцы
полноцен: привели
отмеча: покупок
выдвига: аналитики
торгов: структуре
пошл: газ
мор: секунд
запоздан: некоторым
джио: движение
основн: помощь
закреп: увеличением
курс: сказываться происходило
константин: экономист
текущ: представим закрепится
немедлен: необходимости
развернул: дн
квот: снижении
ослаблен: дальнейшее
надолг: слабый
решен: оценкой
владельц: разрешения
средн: устроено
нужн: компаниям
удачн: видимо
чиновник: экспертов
секрет: коллаж назвал опрошенные
рынк: предложение
вечер: укрепляться
помощ: первую
выш: известно
секунд: объясняем
валют: покупают валюты нужна
жди: рублю
центробанк: вырастут
текст: выделите
альф: компании
данил: владислав
предложен: увеличения отзывов продают
будущ: повышать
укреп: месяцев
наоборот: пишут
потребительск: объясняет
шит: узбекистана
инвестиц: инвестиции
дан: точные
сказыва: начн словам
евр: евро
отключ: кузьмин
иностранц: среди
спецпроект: редакция
импортн: случае
кога: евгений
минфин: р
станет: мире
полтор: последний
росс: вывести валютные
кож: волосами
сократ: рынке
газ: стоил
фирм: секрет
эффект: следовательно
причин: пару фундаментальных
цел: коммерческих
цен: цене выше
старш: банков
ошиба: надеяться
увид: ожидал
опечатк: нашли
вынужд: неизбежно
российск: покупает активы выходят законодательством
политик: использования
финансов: надолго
зарабатыва: ч
коммерческ: материалов
спекулятивн: сказывается падения
покупа: банки татнефть
понаблюда: остался
иностра: иностранные
формиру: контракты
паден: скоро причинах
начал: низкие
подросл: марте
предположен: разные скорее
высш: зарабатывают
сказа: подросли
импорт: сокращается
инфляц: соотношением понятно
комисс: правительственная
выдел: опечатку
повыша: немедленно
отраз: точно
след: течение
рассказа: зейтц
переход: потребление
коротк: высшее
так: спешить пишет профицитным
письмен: возможно
течен: позициях
копирован: частичное
редакц: журнала телефон
измен: дороже
британск: разрешила
назва: потавин
материал: копирование
деш: качественные
товар: импортные перекладывать
поднима: пиццерий
подбира: нефть
аналитик: обсудили фото рисков
пишут: неоправданным
обсуд: магазинах производственником
некотор: курсе
последн: забывать упал
кредит: подорожают
солнц: морем
месяц: нескольких
услов: информация
качествен: переходить
вырос: спрос
школ: правила
образован: среднее
вероятн: ограниченный
компан: российским рассказал управляющей
длин: пользу
ограничен: переноса
нашл: конфиденциальности
фундаментальн: говорить
вед: национальная
низк: причин
привел: факторы
займ: дорогие
млрд: россии
вс: вс
мрочковск: николай
начн: фактор
магазин: ценники
агентств: производственного
вы: деш
объясня: объясняют динамику предложений
ным: уч
нача: начал
текстил: импортирует
слаб: длинном
профессор: инвестор
забыва: смотрят
россия: спекулятивный
значительн: рубля
прода: поэтому
волос: ухаживать
докуп: банкам
деревя: падение
производственник: ным
татнефт: например
законч: деревянного
полн: защищены сми
затянувш: кошельках
представ: сюрпризам
непредсказуем: вед
сайт: владельца
дн: правы
инвестбанкир: текущий
кошельк: пределах
технолог: истории
происход: нового
комментар: новостей
трех: следующих
сотрудник: форму
поеха: солнцем
обесценива: обесцениваться
сильн: диапазон
оптимистичн: финансовые
пиццер: сети
пар: секрету
капита: альфа
селянин: константин
следовательн: товаров
телефон: нажмите
необходим: цб
истор: видео
спеш: предлагает
ещ: ещ
кризис: валютному
вниман: обратили
коллаж: заднюю
одобр: сахалин
экономист: отмечал
автор: источник
сдержа: прежнему
сет: крупной
конфиденциальн: политика
виде: коротко
ухажива: отдыхать
разрешен: письменного
доход: нефтегазовые
диапазон: тся
юан: продавать
оста: таким
евробонд: вообще
нескольк: горизонте
подорожа: ставку подорожает подорожал
эксперт: комментариев предупредил эксперты
спрос: цены
бизнес: продукты российский
виновн: нарушений
задн: включит
разреш: комиссия
дне: последние
прибав: прибавили
дол: млрд
еврооблигац: выплаты
известн: сотрудников сказалось
ретейлер: продажу
сторон: предложения
смотр: оптимистично
включ: традиции
защищ: права
сред: предположения
плеханов: рэу
наш: отразится
наблюда: баланса пике
люб: готовым
плат: россия
сюрприз: любым
доллар: доллар докупить
фот: обсудить
фактор: скакнула совокупности
евген: вшэ
информац: правовая
разн: выдвигают разному
бкс: утром
ключев: поднять траектория
выгляд: ослабление
видим: крепче
контракт: новые
законодательств: соответствии
неизбежн: центробанк
упа: сильно
ставк: ключевую ключевой
вывод: такими
отбива: прид
неоправда: выглядит
например: активов
производствен: рекламно
продаж: одобрила
правил: бюджетному
согласн: секретом
никола: плеханова
транслирова: насколько
увеличен: формируем мере
реклам: спецпроекты отключить
вырастут: товары
прид: бизнесу
понятн: станет
соответств: ответственности
соотношен: понаблюдать
сми: примета
импортир: компания
польз: инфляция
подня: вынужден
апрел: апреля
ответствен: привлечены
федерац: российской
стран: новая
десятк: рф
траектор: будущая
использован: условия
сидет: доллары
покупок: наших
март: доходы
войт: войти
кровн: советы
выживан: выживание
пик: бакс
динамик: транслироваться
валютн: евробонды полноценному
совокупн: точке
наскольк: зависеть
правительствен: сократилось
обнаружен: сайта
поступа: страну
баланс: торгового
зависет: ставки
сахалин: проекте
горизонт: наоборот
узбекиста: китая
пишет: коган
об: обе
новост: новости полно
кузьмин: иван
перв: старший оказать
управля: мрочковский
добыч: квот
зейтц: агентства
интересн: интереснее
нефтегазов: правилу
изменен: либо
возможн: целях
дальн: пошли
биржев: рубл
ценник: повлияет
голов: кожей
утр: внимание
перенос: эффект
как: дней
крупн: известной
опек: решения
повлия: ним
кримина: криминал
санкцион: публикуются
тся: верн
прошл: лета
гендиректор: подорожание
нефт: газпром
точн: предположение затянувшееся
риск: санкционных
прежн: потребительский
точк: сошлось
партнер: рекламу
пада: падает
выплат: получили
экспортер: стороны
потавин: александр
форм: шить
мер: укрепиться
продукт: кредиты
бюджетн: новому
источник: фирмы
газпр: бизнес
massimo: massimo
dutti: dutti
ctrl: ctrl
natasha: natasha
tyre: tyres
nokian: nokian
east: east
zeytz: zeytz
rss: rss
chebanu: chebanu
ferreira: ferreira
bear: bear
enter: enter
petroleum: petroleum
aa: aa
new: news
inditex: inditex
nior: nior
zara: zara
salym: salym
pull: pull
unsplash: unsplash
anatoli: anatoly
lomohov: lomohov
shell: shell
