леонид: континент
ру: ру
кассир: средств
банк: выявлять банки операционистки секунду сумма банков банками
похит: похитить одобрены
рф: получателей
криптограф: мошенников
оттуд: юта
лев: дословно
стат: статьи
воен: впк
обычн: обычную
оказа: разговор перечислить оказалась
европейск: обратился
стал: убыточное правда труда
мнен: кредиты
правоохранител: перми
объясн: минут лнр
получател: отправителем отправителей
отметк: совершались
последств: триллиона
работ: сбой работы имитировали
центр: центра
заход: графе
показыва: дня
проводк: осуществляя
арт: руководителя
арх: архив
экономик: экономика
привлеч: ответственности
килограмм: сотнями
сто: платили
манхэттен: жилья
человек: правам
коллапс: коллапса
возглавля: терлоев
охот: безопасности
специализирова: деятельность
поступ: подтверждение ноября
финанс: специализировался
лет: слабый
каса: приговором
макияж: нанесения
разговор: отвечал
леч: смоленский
эстонск: людей
ста: возбуждении
кирпич: внутри
структур: структуры представители
суд: районный
публикац: сожалению
новосибирск: челябинска
миллиардер: миллиардер
крепк: группой
человеческ: являлся
имитирова: линию
котор: бюджете
денег: денег
владелец: экс
засмея: машину
обманыва: тюрем
силов: силовые
осен: пришелся раскрыли
секретн: выложившего выполнению
клеп: анатолий
приостановк: здоровье
признава: банкир
связа: ста отметить
участвова: рф
прав: европейский
обратн: возвращалась
спецслужб: иностранные
барбар: барбаре
проверя: выдал проверялись
отмет: могу
карман: оседали
нургал: рашид
связ: нарушившей
ушл: прописью итоге
отмен: извещение
красноуральск: назрани
дела: делает собирается
сут: касается
причастн: скрывал опровергли
кварц: урал
раствор: переведены
пресненск: скрывавшегося
верс: официальная
некогд: поддельным
центральн: начальником
украд: мошенничества
прост: получателем
сделк: удачной
свест: решил
лин: телетайпов
позвол: позволили грозного
анекдот: появился
россиянин: болезни
рубл: рублей
зал: телетайпном
авизовик: борьба войну
сосед: бросил
заявля: заявлял
занима: объединение
криминалистическ: технико
дыр: черной огромная
родин: настоящая
отбыва: заключения
позвон: утром
нов: тысячи китаем клеповкриптограф михалев
придума: думают историческую
нож: мужчин
почувствова: группировки
приговор: удовлетворен пресненский хищении
цб: отделениями
тишин: матросская
подделк: факт обвинение
устро: телефону
журна: москва
слов: безнаказанность тексте
повальн: вело
усовершенствова: принято
якоб: октября
чекуев: отбывать громким
системн: вызывали
сдела: первых услуге
зелимхан: шаман
выдава: кассир
особен: особенную
деактивирова: нажмите
юферов: леонидом
мошенническ: сократили
молодец: смешным
активн: арестованным
русск: боевиками
сверк: вплоть
операцион: центрального
ноч: выходят
ведом: банк
расчет: электронные
криминалитет: охоту
обманул: мошенники
авизовк: длинную
систем: смеялся защиту система местом
выход: москву теме
самолет: самолетами грузовики пассажирских
степашин: учителям
подложн: хищениями
срочн: требовали
государствен: коммерческих
летн: внешности
всеследств: всеследствие
частн: частных
отмыван: финансах
труд: составляло безрассудство
путешеств: путешествия
сожален: высказывал период
незамечен: оставалась
курс: курсу
старик: село
сша: сша
немедлен: стоял
машин: увидев составляли
лидер: ракеты
аппарат: аппарата
групп: группы номеров
изобрет: давай
шел: вписывал
махинац: состояние причастность повторил махинаций папках причастности
техник: техника подтвердила
дружк: вернулась
требован: отправлялось
доказательств: отсутствием
бесследн: адресу
хотел: комментировать тасс
подготовлен: числе
культур: культура
ибрагим: али
лнр: популярные
додон: додонов
номер: джип
ибрагимов: зелимханова
букв: отсутствует
вечер: летом фуфел
рынк: черном
купл: занимался
неизвестн: остается
помощ: помощью
хищен: пик масштабные эпизодов ленты банковскими
врач: нато
прекращ: доказательств
обменя: предложили
приложен: бумажка
нахманович: лев доверяла льва
секунд: самую
здоров: проблемы ухудшающемся
тверск: бизнесмена забрали
центробанк: председатель
текст: внимание
разброса: сразу
сигнал: перебивали
будуч: жердев
интерва: й
дубликат: изготовлял
спокойн: утерян
задержа: нечаева первым
показан: давать
заочн: экспертиза
опровергл: латвию
гувд: управления
средств: переведенных
свобод: условно
потребова: еспч
евр: преследование
отключ: комментарии
борьб: интервью
отделен: грозненского информацией
спецпроект: спецпроекты
связыва: росло
протяжен: протяжении
свердловск: гу тверское
осуществля: осуществлялись
следствен: отдела провел
ситдиков: равилем
росс: россии россия россию взятые
фбр: пентагона
подкуп: апреле
отправлен: число документ
четырех: четырех
росл: шифраторов
логос: каскад
выявля: фальшивые
мотор: мотор
ситуац: усугубились политическую
фирм: дней например растворились
выдач: операция обе
посыпа: сторону
налож: машины
отсутств: кратковременного слове отсутствие отношении
причин: вопросов
бизнесмен: карманах
цел: целый
непризна: президент
возбужден: возбуждение отчитался
лент: ленту прим лента американское
кажд: кода каждом
финансирован: дудаева
руководител: умерли прельстило
переспрашива: нахмановичу
опечатк: ооо
шла: выдать
российск: российские российских шел
мозгов: нарушением
множеств: множество
политическ: социально
коммерческ: руководства
директор: приятелями
администрац: посланиях
везл: везли
грипп: лечился
иностра: вели
неважн: шли
спецслужбыпреступн: спецслужбыпреступная
запрашива: спокойно
генпрокуратур: оглашения
воодушевлен: никто
клеповкриптограф: просуществовала
юс: арт
михал: игорь
ют: кварца
судкриминалполиц: судкриминалполиция
шли: дела
злоупотребля: старались
настоя: страна
список: входил
джамбульск: председателя
кадр: машинка
ссср: ссср
кабинет: земляки
лимузин: стрейч
посылк: оплатил
след: показания вышли
слев: дудаев
нашел: рассказал
неплатеж: повальным
бюджет: дыра
изощрен: пошли
соучастник: ушел
попыта: конфликт
клиент: платежные
коротк: снимались
так: ежедневно структур
яшенкоадвокат: кирилл
арифмометр: большие
перевест: перевести
пятниц: закрытием вечер
течен: июля
техническ: изощренные
условн: мягким
оплат: платил
блогерш: летней
назва: активам пригожин назвав
приближен: бизнесменов
посыла: регионов
товар: сельхозпродукции
собира: переспрашивать
банкир: партнера президента влияние
суицид: версия
умерл: следом
некотор: многократно криминалитет
игор: александр
попа: сентября
остава: оставалось махинация
кратчайш: кратчайший
спорт: спорт
специальн: специальные специального
содержан: подчистила
кредит: займы
представля: компьютеры
анатол: криптограф
виртуальн: дело
друг: перевела
приход: подложным
госпитализирова: феврале
ошибочн: возврата
пунегов: сергея
возбужд: руками
маркл: маркл
поня: дали получил
народ: поезда
компан: компаний
рассказыва: российский
программ: сотрудничать
получа: тонкость переводили немедленно
ежедневн: банках
луга: городе
главн: главное главного примитивным
воздух: делать
безрассудств: перешел
фамил: казахстане
пят: задержании
фальшив: фальшивых цыцына закупки ситуацию
октябр: долю
займ: международные
подтверд: подделки
кратковремен: замечала
гришин: махинациям гришин гришина
состоян: сделал
стоя: поступало
челябинск: ставрополя
отдел: отвечали начальника чечня
рад: признание
похищен: похищенное провернул
пропаст: пропасти
кирилл: сепаратистов
улад: угрозы
помн: трудом
нижн: суммой
процвета: стало
интернет: путать интернет
мега: меган
московск: имени декабря доставляли
учител: военным
соосновател: сооснователь
еспч: человека
извещен: поддельное извещения
вступ: готов
сбежа: возможности
колоссальн: последствия
заслуж: отношения
тем: материалы
официальн: мертвым
пришл: чекуеву смену
полн: показывали
легенд: переводу
винтик: января
знал: возвращались
коррупц: исследованию
комментар: палей
телетайп: телетайпу телетайпы происходил вклинивались
рамк: заходит
сотрудник: новых подкупил
адрес: другому
приступ: женщина
компьютер: интернета
работа: нургалиев предавали работала
запрет: ввел
нанесен: блогерши
прос: подробности
долг: срочно
долж: очередные
десятилет: десятилетий
услуг: попросил
оставля: оставляли
телефон: россиян
руководя: пяти
числ: ближайшую имеем
гришинв: напоминают
провернул: чеченец
период: помню
подозрева: арестовало
присво: колобаевым
вниман: обратить
отвад: технологий
сотруднича: захотел
одобр: тверьуниверсалбанка
видн: выдаются
автор: автором
восьм: годам
возврат: требование наличности
вида: засмеялся
выйт: напрямую
овчинник: региона
перевезл: мешках
виде: видео
геращенк: виктор
изготовля: эстонских
объясним: ошибки
недостач: миллиарда
доверя: сделать
разрешен: добился
придет: понять
казахста: национального разрешения
историческ: заявил
обжалова: вскоре
гришиниз: вырос
сепаратист: поддерживал
оценива: фсб
выпущ: государству
оста: использованием
хозяйк: счет
терлоев: позволил долг
заключен: месяцам ночью
быстр: отпустили дал
взяточничеств: участии
бизнес: бизнес
виновн: чеченца посылались
вышел: быстро
осложня: неплатежам
объединен: легенде кооперативное
расчетн: расчетно
распространен: источником
реч: понял
реш: купе
гарр: гарри
международн: россией расследования
объ: имела
залог: выпущен
подтвержден: алгоритм получал
пригожин: политике
перечисл: должен
обитан: обитания
высказыва: ленте
аферист: аферистам
поддержива: дудаевым
возросл: местных
дьячк: слева
серг: сергей
профессиональн: технически подготовленными
обм: носителе
изолятор: следственном
повод: сожаление
оператор: основывалась хозяйки
сред: найти среда
переведен: ошибочно
социальн: осложняло
разбирательств: судебные
распад: распада
оседа: чечню
жерд: соучастник
мног: подхватили
похуден: уколов
язык: удалить
останов: хищение
заместител: словам мая
фуфел: изобретем
снял: прекращено
фот: фото
фактор: человеческий
взят: утекали
тверьуниверсалбанк: жилсоцбанке фирмах
правд: республика
гот: среди
разн: оказывались деньгами
взял: роли выйти
адвокат: заявления
люд: нужных
промстройбанк: отделения
отвеча: разные группировке
год: двум годы
пакет: продать
жилсоцбанк: агропромбанке поступило
экспертиз: криминалистическая
фигурант: работали
конкретн: пределах
мистер: кое
интерв: палаты
физическ: боевиков взял
фсб: работавший
телетайпн: оператор
удовлетвор: отказались
вывод: молдавской
прич: сотни
каскад: карина
смоленск: нахманович александра смоленского
привоз: взамен
одн: космос виновным объединив прерогативой
мал: некое
пистолет: ножами
продаж: выставил куплей
задержива: правоохранители
прим: ельцина
казахстанск: лугано
согласн: одних
бумажк: поддельная отправляли
настольк: огонек
бумажн: оформляли
потребн: объяснили
рассыла: мошенничеством
масс: вывезенная
выда: выполнял поступили банке
кошмар: государственных
мвд: органы
итал: прилетел
команд: клепов
насчитыва: насчитывалось
достоверн: подтверждения
объединя: расчетов
справк: аналитической
апрел: украсть апреля
электрон: наличными внутрирегиональные
участ: обвинили
наличн: получавший выдавал выдача
высла: мистер
удивлен: приговор
безнаказан: почувствовали
использован: документа точная
ичкер: республики власти
регион: конкретного руководители
поскольк: поскольку
войн: наказаны информационная
сентябр: проводилось страны
март: марта
возникнут: могло
испытан: известно
войт: войти
существова: существовали существовала
дудаевпрезидент: мешками
глав: неизвестной руководящих
деятельн: организовывал
бухгалтер: отсутствия юферовым
сраз: оттуда
обвин: ситдиковым
ркц: ркц
порядк: присвоил
примитивн: кодирование
подробн: выслать
поступа: поручение информация дудаевпрезидент
болезн: смертельной
перм: красноуральска
ракет: гиперзвуковой
ограблен: ограбления
украст: задумал
гениальн: простой гениальная
шахтер: невыплат
новост: новости
принц: принцу
печатн: печатной превратилась
существ: порядок
перв: одним австрии ибрагимова работу уголовное
ухудша: адвоката
добр: деактивирована добра
общероссийск: работе
кодирован: телетайп
короч: оказался
ушел: способом
повер: чеченцы
тро: основали
рюпичеваэкономист: графы
напомина: разбирательства
роботрон: машинке
освобод: роботрон
род: ошибке
реальн: пожаловать
земляк: заметили
авизовск: го
точн: катастрофы психологически быстрые
рол: распределили
корреспондентск: открытии
партнер: мошенничестве
сфер: программе
мертв: спасли
способ: вслед
форм: форма
признан: запрашиваемую
илон: возрасте
отправител: банка задерживали связь
напрям: отделена
смешн: покажется
жертв: первые
обрат: казахстан могла
найт: сотрудников
готов: предприятий
защищен: связывали
влиян: проблем
разойдут: коллеги
студентк: похудения
информацион: первая информационного
кооперативн: возглавлял
америк: любви
успел: обжаловала
конц: могли
появ: популярны появилось появились
удал: студентке
жердев: тверской подконтрольные
практическ: практически
доступ: доступ
вернут: вернуться вернуть
вернул: получить
чечн: поступавшие сетью чечне
блохнин: зале
предел: объединяли
тщательн: тщательно
конфликт: уладить
александр: уголовного банкира
мятежн: чеченские
схем: винтик придумали схемы схема
швейцарск: попался
й: буква
преврат: перевода пятницы
потреблен: народного
пензенск: губернатора
н: осознавала
валер: москвы замначальника
личност: последние
поезд: самолеты настроении поездами скорых
дава: начал ингушей
коммерсантъ: коммерсантъ
экс: вспомнил
х: х
утеря: оригинал
сообщ: мвд
поэт: проверяли
оформля: клиенты
отправ: хусейна
иерарх: иерархия
мир: мир
укол: популярных
предприят: директором подельников малое шахтерам
шифратор: сто
исследован: международного
внешност: удивились
шама: след чекуев
екатеринбург: пунегова отправили
безопасн: ради
орга: июне
подписыва: смоленским
вагнер: чвк
скор: кошмар самолетах
нажм: опечатку
феврал: гришинв следствия
бланк: бланки
сообщен: сообщения
получ: получила ним отпущен терлоеву махинацию
власт: задержания
начальник: заместителя главе
нечаев: фамилии
перевод: отмене переводах фирмы содержание цифры фирма
фронт: утечки
провел: казахстанский
город: городами швейцарской
опг: авизовскую
экономическ: молодой
национальн: ушла
декабр: размере
рук: развели
укра: схему
час: запрет
украин: очков
гранат: соседа
внутр: посылку
раскр: рюпичеваэкономист
актив: крупнейших
компенсац: потребовал
выстав: лидер
прям: заключенные
грузовик: московских килограммов
льва: поручения
могл: проводку исчезновение смерти
подписк: обвинения
непрерывн: защищенной
нарушен: госпитализирован
больш: одно представляли
грозненск: сотрудника
миллиард: идти порядка ушли похитила
мест: освободившемся слабым
лайнер: борту
счет: счета корреспондентских обратно свели счетами видны
порядок: полный
послан: гришиниз гражданстве
карьер: карьере
вход: росевробанк
дуда: джохар
ждал: аэропорта
геннад: бухгалтером
граф: нижней рамки
гипертон: гриппа
перелет: короче
замначальник: брифинге
назран: новосибирска
счетн: степашин
эффективн: оценил
видет: видеть
доставля: вес
мягк: удивление
чеченец: молодец
редакциярекламаконтактыпресс: всу
вспомн: вспомнила неожиданно
машинк: печатная машинки допечатала
жизн: свести жизни
триллион: триллионы ущерб триллионов
идт: речь
отработа: моменту
солдат: русских
оригина: рассказывал
зашедш: заявили
чвк: уничтоженных
петрухин: перевезли
мог: хотелось
сотн: рассылать миллионами
отм: отмены
момент: счеты ведома
джохар: чри
мошенничеств: признался крупная злоупотреблять
пошл: часа
особняк: особняк
джип: черный
преступн: вступить организованной
вышл: спустя
хусейн: чеченцев задержали
основа: опг
скрыва: нальчике дьячков
перебива: преступниками
психологическ: арифмометры
почт: обманули
ленинск: екатеринбург
утечк: подозреваемого оценили
решен: физическое
закупк: дружок
передава: передавались
допрос: н
удив: сети
кредитор: сумму
комментирова: обвинений
провод: операций
личн: продажу попытался ситуацией
задержан: сообщили шамана
нужн: нашел
советск: советское
удачн: воодушевленный
смерт: причине
подхват: придумал
носител: бумажном
сельхозпродукц: продажей
меня: розыск
вылож: личность
молдавск: замешан
ввел: геращенко
равил: операционного
аналитическ: согласно
выполня: знал
банковск: крупнейшими банковской банковскую банковского
вызыва: изъятия
полож: лимузин
любв: признавался
подавлен: придется
пропис: указывается
дал: поверили вопросы
тасс: овчинников
документ: документы подделке утечке фальшивый
исчезновен: заметить
глуп: родина
захвачен: обменять
расследован: фигурантом
жен: гражданство
розыск: стражи
изъят: крупные
имел: операторы масса
дан: преступности личные
следовател: гойты
имен: якобы
раскрыт: рекорд
перевед: жилсоцбанка
код: новый достоверности
народн: товаров
тюр: прямо
сократ: авизовиками
поручен: платежное секретного
посягательств: мошеннических
объяснен: перелет
гиперзвуков: новой
разруш: разрушила
перевел: объединения свой ошиблась
пожалова: добро
авиз: авизо
деньг: деньги виртуальными
отказа: местные
брифинг: объявили
вклинива: сигналы
огонек: журнал
очк: умных
наруш: дырой
предлож: счетов ичкерии
ошиба: ошибается
добровольн: ареста
увид: старик
возраст: кровообращения
галер: галереи
границ: сбежал
оцен: украине врач
незакон: компенсацию
ошибл: операционистка
организовыва: банкиров
политик: тупик
вмест: вместо миллиардах
финансов: финансовая финансовой
уход: фактор
полиц: боятся
операционистк: ошибкой оказалось
ошибк: глупой объяснить пятницу
увидел: взялись
тупик: зашедшей
чеченск: прозвали махинации поддельными
име: увидели
обнов: манхэттене
покажет: анекдот
настроен: подавленном
разработа: командой
жил: аренды
имуществ: выяснилось
начал: начале
стара: осень
руководств: исключили превратился
отчита: цыцын
наступлен: зеленского
медиа: документов
сынок: видать
кра: краю
итог: выяснить
обеспеч: профессионально
минут: короткий
масштабн: спецслужбы
вошл: кабинет
стрейч: купил
карин: жердеву
дел: имели потребления
вопрос: образованием суицид
ближайш: ответы
рассказа: украдено обещал
жит: жить
вскор: генпрокуратура
пришел: хищений
размер: заочно
дружок: предприятие
допечата: переводе
проход: сверки
губернатор: схеме
ответ: точные
москв: поездах москве гувд поехал
никт: искать
преступник: профессиональными
несмотр: несмотря
срок: срок раскрыты
смея: открыто
росевробанк: владелец заслужил
следств: предварительного
преследован: незаконное
уда: удалось
алгоритм: криптографический
бизнесм: екатеринбурга неважно
фальшивок: распространения
материал: дружка
ставропол: приходили
передов: системы
смен: сходить
снима: заметил
отношен: такого использовании
иска: бросился
куп: домой похищенные
австр: гипертонии
арест: вышел наложить
сант: санта
ал: зелимханов
аэропорт: выходе московском
интерпрогрессбанк: передал
кита: испытании
район: ленинский
молдав: выводу
последн: отключены
заявлен: тишина поводу
месяц: логос пару месяца восьми
сам: наличные авизовку взяточничестве эстонии
захотел: иран
жми: жми
фантастическ: причем
возвраща: виде выдачи
вырос: родился
организова: коррупции
переда: промстройбанка
захлестнул: захлестнули
бо: почте
оказыва: отметки
образован: экономическим
называ: называли называют
выполнен: приступила
длин: запустил
управлен: следственного
ира: макияжа
зелимханов: чекуева
принят: руководством
неожида: хотел
стресс: личной
нашл: дома
записа: лайнера
сбо: сбоев системный
женщин: домам
космос: уходили
руковод: крепких
замеша: данным
афер: народе афера аферой назвать
оглашен: свободе
вел: война общероссийской
лезв: допросе
тонкост: риа
очередн: отработанной
вер: аферы
вес: объем
популярн: настолько эффективность популярность музыки
кровообращен: мозгового
мужчин: бородатых
смертельн: язык
област: пензенской
усугуб: здоровьем
пентагон: секретные
сво: свердловской вместе
исчезл: бесследно
пассажирск: мешков
нача: активно
слаб: контроль главным
подчист: лезвием
замеча: копеечки
территориальн: территориальных
россия: миллионы
го: сентябре
прода: гришину продал
исключа: миллиарды
чри: непризнанной
гу: направила
рекорд: обновила
явля: системе
нальчик: залог
виктор: центробанка
бородат: некие
своз: грозный
вслед: возникнуть
платеж: платежи
уголовн: уголовных возбуждено справке приостановке
гибрид: гибриду
казахстан: джамбульского
гражданств: американском просить
контрол: объяснимы
многомиллион: обещание
уничтожен: назвал
технолог: передовых
происход: цб
рашид: глава
выясн: большое получилось
зеленск: потребность
папк: разных
поеха: лично
хвата: отмывании
чеку: хусейн
прилетел: аэропорту
поддельн: интерпрогрессбанк махинациях миллиардов поддельные кадр
континент: предприятия
пал: илона
ценност: ценности
подразделен: подразделений
спасл: жизнью
влиятельн: трое
пар: солдат
видеоролик: записал
задума: терлоева акций
платежн: уровнях момент
истор: историю
дословн: предложил
двум: приговорил
цифр: месте
прельст: сумм
пробл: решение
факт: осенью
довел: довел
сел: родном родное
подельник: хватало
вид: электронном
мошенник: кирпич отвадить
сет: непрерывной наступлении
представител: данные некоторые
телеграфн: телеграфного
защит: усовершенствовать
ноябр: месяц
боевик: финансирование захваченных
вплот: незамеченной
ельцин: мнению
ущерб: оценивал
эквивалент: фальшивыми
задолжа: бизнесмен
повтор: сделкой
договор: подписывали
обеща: америке
наук: наука
наказа: виновны
дне: проходила
сумм: многомиллионных интервала крупную фантастические эквивалентен переводилась
прерогатив: яшенкоадвокат
калифорн: калифорния
скорост: скорости
дол: жердева
дом: разойдутся области поезде
осознава: воздухом
известн: фронте известный
сторон: поэтому исчезли
взам: бумажки
пута: поступала
указыва: приложения
предостав: готовых
сговор: преступный
призна: италии суд
тысяч: получили грузовиках
тогдашн: сумме
дня: конце
доб: невыезде
принцип: принцип
родн: приехал скрыться
хорош: хорошие
стоимост: медианная
внутрирегиональн: пришли
невыезд: подписку
зашифрова: зашифрованы
подконтрольн: разбросали
денежн: денежных
обвинен: сути новое сняли
агропромбанк: московского недостачу
республик: мятежная чеченской
зелихманов: месяцев
дудаев: приближенных связан
цыцын: валерия валерий
плат: рынке нашли
чеченц: признал объяснениям влиятельных
колобаев: геннадием
умн: выпуска
обяза: евро
переня: переняла
приятел: своими
борт: росевробанка
доллар: доллара долларов
вывезен: физически
образова: суммы
арестова: будучи фбр
эпизод: одном эпизод
нат: представителей
составля: сговор имущество
информац: правилам обмен
основыва: гениальности
группировк: образовались руководил
развел: тверьуниверсалбанке
сход: хищения
замет: бухгалтер стороны процветать
гойт: селе
скрыт: успел
возмест: добровольно
забра: следователи
спуст: петрухин
объяв: полицейские
предварительн: отсидел
грозн: отправленный некоторое
требова: кредиторам
наказан: пришлось
объедин: свердловское
ко: рассказать
черн: код стали ждал
закрыт: выбрано
катастроф: выплатить
дожда: задержалась
например: отделы
кассов: кассовых
отправля: отправителя системой
правил: существующим
коллег: дождавшись
предава: верю
забот: забота
запуст: сынок
утека: которую
ура: перевел
отпущ: февраля
президент: фальшивок администрации послания
попрос: позвонил
терло: предприниматель
председател: скоро заместитель
приеха: положено
акц: пакет
сми: сми
огромн: каждого
ма: вечером
страж: отпущенный
музык: громкой
ответствен: уголовной
копеечк: получала
невыплат: тогдашних
стран: странами стране менял жены
аренд: стоимость
январ: устроен
уровн: обеспечена
отсидел: наказание
отпущен: границу
четк: четкая ибрагимов
громк: гранатой самым
перешел: стресс
местн: отправленных арест
сист: систему
свел: жертвы
осуществл: казахстана
распредел: четко
пик: самый
многократн: возросло
вычислительн: вычислительного
предпринимател: чеченский
сюжеткурс: сюжеткурс
государств: возместил
впк: предприятиям
проблем: заявлений
соверша: возврат
исключ: посягательств
заяв: видеороликов сфера
угроз: посыпались
нек: вошли перевело
об: счету
владимир: владимир
матросск: изоляторе
латв: молдавию
дума: многие
сконча: скончался
операц: шла таких операции
оо: редакциярекламаконтактыпресс
возможн: первой
ингуш: привлечены
всу: бойцов
молод: пистолетами
вписыва: дубликат
американск: задумался президенту
выбра: точно
брос: течение россиянин
открыт: ичкерия договор
буквальн: буквально
обещан: предоставить
направ: агропромбанка
просуществова: остановить
госбанк: госбанка
утр: нахмановича
палат: счетной
крупн: связанных самая задолжал колоссальными крупнейшего крупнейшей список
лазеек: лазеек
мешк: мешки привозили тысячами исключали
судебн: публикации
прозва: аферу
убыточн: некогда
серге: юс
бойц: вагнер
отпуст: зелихманова
выпуск: сроки
бывш: бывший
миллион: миллиона обманывают свозить
июл: полиции
выплат: обязали
полицейск: авизовикам
июн: участвовавших
эстон: украл
ри: блохнин
криптографическ: разработал
источник: стала
maw: maw
sgpremier: sgpremier
ctrl: ctrl
appl: apple
occrp: occrp
gulfstream: gulfstream
photoxpress: photoxpress
youtub: youtube
rosevro: rosevro
killnet: killnet
fedex: fedex
wikimedia: wikimedia
enter: enter
