быва: бывают
чувствова: чувствовать
ру: ру
пенс: пенсии
лев: леву
пятнадцатилетн: пятнадцатилетнюю
стат: стать статьи
леж: лежит
обычн: обычную
алет: алет
ждет: ждет
конц: конца
окн: окна
конч: кончится
обгорел: обгорело
дорог: дорогие дорогих дорогое дорогая
стал: стали стала
предлага: предлагал предлагали
маленьк: маленький маленькая маленького маленькой маленькую маленькому
ребенок: ребенок
поцелу: поцелуя
шестилетн: шестилетнего шестилетняя
разрушен: разрушения
удар: удар
вернут: вернуться вернуть
мозг: мозга мозг
арх: архив
экономик: экономика
рожков: рожкову
та: тае
перенес: перенес
стремлен: стремление
встат: встать
стекля: стеклянный
леш: лешу
должн: должны
структур: структуры
дыша: дышать
двухлетн: двухлетнего
подел: поделится
ангелин: ангелину ангелина
денег: денег
диагноз: диагнозом
мир: мир мире
мальчик: мальчик мальчика мальчику
наполовин: наполовину
силов: силовые
благ: благо
клиническ: клиническую
печен: печени
выдержа: выдержать
шаг: шаг
знают: знают
этаж: этажа
оторвет: оторвется
слабел: слабела
уч: учится
скор: скорее
нажм: нажмите
проект: проекта
феврал: февраля
совместн: совместно
конец: конец
заб: забыла
лиз: лиза
дела: делают
получ: получила
сух: сухие
крича: кричать кричал
сыночек: сыночек
выбер: выберемся
травм: травмы
декабр: декабря
подушк: подушку подушки
кров: кровь крови
выльет: выльется
рук: рука
ужаснул: ужаснул
столкнул: столкнулась
отец: отец
шанс: шанс
больн: больных
ивл: ивл
мишк: мишка
дыр: дыра
родим: родимого
заработа: заработать
вспыхнул: вспыхнуло
нов: новый нового
ног: ногу нога ноги
дедушк: дедушка
эндопротез: эндопротез
ждат: ждать
медсестр: медсестра
счет: счет
борет: борется
инфекц: инфекцией
пятилетн: пятилетнюю
перевернул: перевернул
кристин: кристину
постоя: постоянно постоянной
сдела: сделай сделали
отда: отдается отдал
видет: видеть
бабул: бабуля
деактивирова: деактивирована
сложн: сложный сложная
редк: редкого редкое редкие
терап: терапия терапии
родител: родители родителей
редакциярекламаконтактыпресс: редакциярекламаконтактыпресс
страшн: страшно страшном страшной страшную
видел: видел
восьмимесячн: восьмимесячного
денис: денису дениса
кип: кипит
жизн: жизни
терпет: терпеть
подар: подарили
наташ: наташи
девятилетн: девятилетнего
мог: могу
пыта: пытаюсь
срочн: срочная срочно
куса: кусал
щедрост: щедрость
летн: летнего летнему
прята: прятаться
момент: момент
выж: выжил выжить
ше: шея
развива: развивается
трудн: трудные
путешеств: путешествия
курс: курс
сможет: сможет
аппарат: аппарат
скрыва: скрывать
сознан: сознание
техник: техника
парентеральн: парентеральное
культур: культура
русфонд: русфонд
заглушк: заглушку
почк: почку
провод: проводят
нужн: нужна
ужасн: ужасное
отц: отца отцу
смерт: смерть смерти
помоч: помочь
помога: помогают
бесплатн: бесплатно
двенадцатилетн: двенадцатилетнюю
неизвестн: неизвестным
помощ: помощь помощи
врач: врачей врач врачи
протон: протонная протонной
результат: результат
умира: умирай умирает умирал
дочк: дочка
жизнен: жизненно
здоров: здорового здоровой
дал: дала
кроват: кровати
сын: сына сыну сын
грустн: грустных
вначал: вначале
средств: средств
позвоночник: позвоночнике позвоночник
дан: даню
спецпроект: спецпроекты
импортн: импортное
даш: даши даша дашу
полтор: полтора
росс: россии россия
помог: помоги помогите
едв: едва
петров: петрова
роддом: роддоме
обследован: обследования
танкист: танкистом
повред: повредят
медицинск: медицинский
мотор: мотор
кот: кота
пожалова: пожаловать
медлен: медленно
цикл: цикл
надав: надавишь
отказа: отказала отказаться
четвер: четверо
цел: цель
цен: ценится
многодетн: многодетному
тян: тяну
задыха: задыхался задыхаться
лент: лента ленту
мук: муки
спасет: спасет
опечатк: опечатку
лекарств: лекарств лекарство лекарства
галер: галереи
российск: российскую
полин: полину
вмест: вместе
русла: руслана
новорожден: новорожденный
приживет: приживется
жив: жив живая живой
увидел: увидела
серьезн: серьезной
паден: падения
продолжен: продолжение
погибнут: погибнуть
ван: ваню
ссср: ссср
вытащ: вытащили
синел: синел
растека: растекалась
слез: слез
яд: ядом
вспомина: вспоминаю
след: следует
вопрос: вопрос
невозможн: невозможно
стремительн: стремительно
жит: жить
вернет: вернет
вар: варю варя
параллельмо: параллельмоя
пятн: пятна
ваш: вашей
так: таких таким
капельниц: капельницы капельница
обществ: общества
тан: тани
нормальн: нормальной нормальную
новогодн: новогоднюю
мучен: мучения
опухол: опухоль
ослепн: ослепну
станц: станцую
мамин: маминой
дет: детей детям
август: августа
тая: таяла
вздохнут: вздохнуть
умрет: умрет
савел: савелию
лечен: лечение
ад: ад
илюш: илюша
саш: саши сашу
ал: алена
злат: злата
твор: творить
ан: аню
спорт: спорт
мысл: мыслей
специальн: специальный
посмотрел: посмотрела
последн: последним последний
друз: друзья
внук: внуку
сам: самое
жми: жми
лыткин: лыткина
дим: диму
сбор: сбор
благотворительн: благотворительного
тяжелобольн: тяжелобольным тяжелобольных
сдвига: сдвигаются
лезт: лезть
отрав: отравили
главн: главное
нашл: нашли
внутривен: внутривенное
четырехлетн: четырехлетнего
потолок: потолок
заболеван: заболевания заболевание
страда: страдает
пят: пятого
елк: елку
октябр: октября
меда: медали
предполага: предполагала
начина: начинаются начинал
отдаст: отдаст
вер: веру
стоя: стоять
инвалид: инвалидов
смертельн: смертельная
уверя: уверяли
начн: начнем
исчеза: исчезает
лапушкин: лапушкина
раз: раза
цвет: цвета
рак: рак
мучительн: мучительной
инвалидн: инвалидности
кирилл: кирилла
спин: спина спине спинной
помн: помнит
отдельн: отдельных
нача: начал
занов: заново
авар: аварии
горб: горб
факел: факел
лежа: лежал
трехкамерн: трехкамерное
интернет: интернет
нужда: нуждается
макар: макар
всеобществополитикапроисшествиярегионымоскв: всеобществополитикапроисшествиярегионымосква
тел: тело
дорогостоя: дорогостоящая
теря: теряет терять
спаст: спасти
питан: питание
паш: пашу
рассудок: рассудок
трехмесячн: трехмесячного трехмесячную трехмесячной
хвата: хватает
запрет: запретили
ценност: ценности
отмуч: отмучился
спасл: спасли
вылечат: вылечат
пап: папа папе
перел: перелом
виж: вижу
дадут: дадут
необходим: необходима необходимо необходимы
одиннадцатилетн: одиннадцатилетнюю
ход: ходить
зрен: зрение
пожелтел: пожелтел
сем: семья сему семьям
бабушк: бабушка
сдержа: сдержать
произошел: произошел
очеред: очереди
налад: наладится
легк: легких
вид: вид видишь
виде: видео
захар: захар захара
чуд: чудом
температур: температура
ноябр: ноября
науч: научилась
необход: необходим
естествен: естественно
шейн: шейные
обеща: обещаю обещал
наук: наука
олес: олесе
памя: память
хоч: хочу
дни: дни
дом: домой
реч: речь
реш: решили
вальс: вальс
убьет: убьет
сереженьк: сереженька
обитан: обитания
пройдет: пройдет
хорош: хорошие
дож: дожить
глеб: глеб
никит: никита никиты никиту
организм: организм
гимнастк: гимнастку
сред: среда
ил: илью
позвонк: позвонки
наш: нашего
погиба: погибает
грамм: грамм
наст: насте настя настю
семилетн: семилетнего семилетнюю
уста: устала
плач: плачь
люб: любой
закат: закатив
восьмилетн: восьмилетнего восьмилетнюю восьмилетней
плат: платье
солен: соленого
умр: умру
обязательн: обязательно
егор: егора
ослепнет: ослепнет
прибор: прибор
генетическ: генетическое
информац: информация
уваркин: уваркину
правд: правда
уня: унять
гор: горя
разр: разрыв
гот: готов
испуга: испугалась
чудовищ: чудовище
гош: гоша
семимесячн: семимесячную
выживет: выживет
люд: людям людей
расколол: раскололась
внучк: внучке
выдерж: выдержит
открыва: открываешь
девочк: девочка девочки девочку девочке
маш: маше
упа: упала
малыш: малыша малыш малышу
потеря: потерять потерял потеряла
реанимац: реанимации
собра: собрали
маргарит: маргарита
спас: спасем
идет: идет
антон: антона
спасут: спасут
одн: одна
отвлеч: отвлечься
мам: мам маме мама
артем: артемия
рит: риты
забот: забота
дтп: дтп
приж: прижилась
страх: страх
забор: забором
нагрузк: нагрузки
надежд: надежду
сми: сми
ма: ма мая
степ: степа степу
справл: справлюсь
апрел: апреля
вов: вову вове
лопнут: лопнуть
стран: страна страны
участ: участие
январ: января
свет: света свету
побед: победила
зашкалива: зашкаливала
владик: владика
сне: сне
сентябр: сентября
испытан: испытание
март: марта
войт: войти
марк: марка
глаз: глаза глазах
счаст: счастье
кост: костю кости костя
холодн: холодным
макарон: макароны
алис: алисе
бор: боремся
болезн: болезнью болезнь
морожен: мороженое
прооперир: прооперируют
матве: матвея
хлеб: хлеб
новост: новости
небольш: небольшой
борот: бороться
дума: думать думал
посел: поселилось
операц: операция операцию операций операции
владислав: владислава
нечая: нечаянный
бол: боли боль болью болит
неч: нечем
добр: добрыми добро добра
талантлив: талантливая
оо: ооо
возможн: возможность
упуст: упустить
запомн: запомнить
открыт: открытом
шест: шести
повес: повесить
обещан: обещание
голов: голова голове
сон: соня соню
утр: утром
сердц: сердцами сердце
колен: колену
боя: боялась
хочет: хочется хочет
лютик: лютика
как: какое
гляд: глядя
болет: болеть
нестерпим: нестерпимой
плака: плакать
кат: катю
бывш: бывший
угаса: угасает
реальн: реальный
тяжел: тяжелое тяжело тяжелейшие
лома: ломаются ломаться
ребенк: ребенку ребенка
риск: рискует
прежн: прежней
откр: открыть
июл: июля
миллион: миллиона миллион
костн: костный
июн: июня
избав: избавить
погиб: погиб
ctrl: ctrl
enter: enter
