ру: ру
говор: говорить говорим
влиян: влияние
студентк: студентке
понима: понимать
назов: назову
образ: образуют
занят: занятия занятие
стат: статьи
леж: лежа
обычн: обычную
износ: износ
рабоч: рабочих рабочий
стал: стало
окажут: окажутся
мнен: мнению
локт: локтями локтей локтях локти
объясн: объяснили
локтев: локтевом локтевых
случа: случае
удал: удалить
работ: работа работы работе
вернут: вернуться
йорк: йорк
арх: архив
экономик: экономика
килограмм: килограмм килограммов
александр: александр
пол: пола
сто: стоя стоит
манхэттен: манхэттене
головок: головок
й: й
каса: касается касаемся
макияж: макияжа
личност: личность
должн: должна
ошибок: ошибок
структур: структуры
дава: давать
коммерсантъ: коммерсантъ
макс: максим
пальц: пальцев
показа: показаться
поэт: поэтому
благодар: благодаря
карл: карло
котор: которое котором которым
провест: провести
опуска: опускается опускаем опускаемся
вариант: вариант
мир: мир
запяст: запястьем запястья
укол: уколов
силов: силовые
секретн: секретные
шаг: шаг
внешност: внешности
вагнер: вагнер
нажм: нажмите
лиг: лига
формирова: формировать
классическ: классические
всефутболанглийск: всефутболанглийский
отмеч: отмечу
дела: делаются делается делаем делайте
вдох: вдохе
получ: получится
французск: французский
лопатк: лопатки
фронт: фронте
важн: важно
вытянут: вытянуты
нагибин: нагибин
увеличива: увеличивать
травм: травмам
центральн: центральная
рук: руки рук
украин: украине
гранат: гранатой
раскр: раскрыли
выстав: выставил
лин: линию
прям: прямо
россиянин: россиянин
рубл: рубл
зал: зале
чередова: чередовать
сосед: соседа
занима: занимается заниматься занимаемся занимаетесь
движен: движений
придума: придумать
нов: новой
ног: ногами ноги
сверх: сверху
повторен: повторений
наклон: наклоне
андр: андрей
футболбокс: футболбокс
сдела: сделайте сделаете
эффективн: эффективность эффективной
видет: видеть
развернут: развернуты
деактивирова: деактивирована
прорабатыва: прорабатывает
редакциярекламаконтактыпресс: редакциярекламаконтактыпресс
совет: советы советую
плавн: плавно
активн: активно активное
жизн: жизни
вперед: вперед
эспандер: эспандер
коламбус: коламбус
зашедш: зашедшей
систем: система
чвк: чвк
юнайтед: юнайтед
пыта: пытаются
уингз: уингз
разгибан: разгибанием
спортивн: спортивном
летн: летней
накача: накачать накачанные
момент: момента
поверхн: поверхности
похудет: похудеть
персональн: персональный
фаворит: фаворитов
путешеств: путешествия
рейнджерс: рейнджерс
мизинц: мизинцы
сша: сша
лидер: лидер
групп: группы группой
техник: техника технику технике
приведен: приведенными
привест: привести
утечк: утечке утечки
европ: европы
фина: финала
культур: культура
градус: градусов
удив: удивились
провод: проводить
тренир: тренируют
лнр: лнр
личн: личные
домашн: домашних
мэйпл: мэйпл
подряд: подряд
вылож: выложившего
врач: врач
посетител: посетителей
рукоятк: рукоятками рукоятки
лучев: лучевой
выполня: выполняют выполнять
результат: результата
красив: красивые
виск: висков
округля: округляем округляемся
дал: далее дал
боков: боковое
мышц: мышц мышцами мышцы мышца мышцам
упражнен: упражнения упражнениям упражнении упражнением упражнение упражнениях упражнений
документ: документы документов
вспомогательн: вспомогательных
соединя: соединяются
нуж: нужен
грамотн: грамотного грамотный
мск: мск
дан: даниил данные
джекетс: джекетс
грудн: грудной
тренажер: тренажера тренажере
дат: дать
указа: указанного
спецпроект: спецпроекты
раскрыт: раскрыты
сустав: суставе суставов
хват: хватом
видылетн: видылетние
рост: роста
росс: россия россией
лебед: лебедев
фбр: фбр
толк: толку
сзад: сзади
мелк: мелких
лифс: лифс
гиперзвуков: гиперзвуковой
задействован: задействования
мотор: мотор
ситуац: ситуацию
пожалова: пожаловать
тренер: тренера тренер
супинирова: супинированным
функц: функции
белк: белка
свиса: свисают
цел: цель
новичк: новички новичкам
очк: очков
лент: ленте лента ленту
нхл: нхл
кажд: каждом
опечатк: опечатку
галер: галереи
оцен: оценили оценил
питтсбург: питтсбург
глобальн: глобального
политик: политике
множеств: множество множества
тяг: тягу тяга
отличн: отлично
параллельн: параллельны
кпд: кпд
тупик: тупик
лавк: лавке
обнов: обновила
серьезн: серьезно
жил: жилья
жим: жима жим
точечн: точечную
стара: стараться
руководств: руководством
пронац: пронацию
примерн: примерно
наступлен: наступлении
добавля: добавлять
медиа: медианная
ткан: ткань
ссср: ссср
принесет: принесет
выдел: выделю
корпус: корпусу корпус
след: следим
клетк: клеткой
отвед: отведены
дел: деле
рассказа: рассказал
студ: студии
тамп: тампа
игра: играет
заверш: завершен
так: такого
трицепс: трицепсе трицепса трицепс трицепсом
полност: полностью
сниз: снизу
срок: сроки
собствен: собственной
оптимальн: оптимально
дозирова: дозировать
мощн: мощные мощными
трехглав: трехглавая
держа: держать
раст: расти
добива: добиваются
блогерш: блогерши
назва: назвать назвал
поднима: поднимаем
восстановлен: восстановление
обсуд: обсудить
отношен: отношению
ширин: ширине
отжиман: отжимания
количеств: количество
хачан: хачанов
остава: оставался
кита: китаем
спорт: спорт
последн: последние
скам: скамье
услов: условиях
сам: самое самых
скаж: скажу
представля: представляет
анатом: анатомии
захотел: захотел
жми: жми
кист: кистей кистью кисти
друг: друг другу
возвраща: возвращаемся возвращаем
инач: иначе
правильн: правильно правильную
подобн: подобные
выгиба: выгибаемся
длин: длинную
программ: программе
ира: иран
главн: главное
характер: характера
нашл: нашли
бэ: бэй
передн: передней
нервн: нервная
фитнес: фитнес
смысл: смысла
губительн: губительна
начина: начинаются начинает
вес: веса вес
популярн: популярных популярные
углевод: углеводов
смертельн: смертельной
област: области
раз: раза
чемпионат: чемпионат
пентагон: пентагона
спин: спины спину спиной
сво: своему
помн: помнить
нижн: нижней
отдельн: отдельно
медиальн: медиальное
забыва: забывать
интернет: интернет
нью: нью
резинк: резинку
плеч: плеча плеч плечо плечами плечом
рекорд: рекорд
рельефн: рельефными
тел: телом
основател: основатель
рацион: рацион
пришл: пришлось
питан: питание
груд: грудью
худощав: худощавого
достигнув: достигнув
детройт: детройт
уничтожен: уничтоженных
бер: берем беремся
оборудован: оборудования
рамк: рамках
зеленск: зеленского
работа: работают работать
сильн: сильнее
нанесен: нанесения
ценност: ценности
блок: блока
исключительн: исключительно
виж: вижу
уменьш: уменьшить
числ: число
тренирова: тренироваться тренировать
скамейк: скамейка
манчестер: манчестер
сгибан: сгибание
верхн: верхнего
спеш: спешить
подозрева: подозреваемого
клуб: клубов
сложност: сложности сложность
сотруднича: сотрудничать
лежат: лежат
тренировк: тренировки тренировке
сет: сети сет
представител: представителей
виде: видео
локальн: локальные локальную
положен: положении положение положения
выпрямл: выпрямлены
подход: подхода подход
ред: ред
мышечн: мышечную мышечного
наук: наука
прогресс: прогрессу
задн: задней
штанг: штангой штангу штанга штанги
принима: принимает принимаем
распространен: распространенных
приседан: приседания
дом: дома
реш: решил
известн: известно
постав: поставили
ладон: ладонями
обойт: обойтись
перетренирова: перетренироваться
пригожин: пригожин
сид: сидя
импульс: импульсы
видыхоккейавтоолимпиадазож: видыхоккейавтоолимпиадазож
сгиба: сгибаем сгибаются
обитан: обитания
состо: состоит
недел: неделю
хорош: хороши хорошую хорошие
спешк: спешка
стоимост: стоимость
лайтнинг: лайтнинг
пуст: пустой
неподвижн: неподвижно неподвижностью неподвижным
подтягиван: подтягивания
сред: среда
двуглав: двуглавая
грамм: грамма
пингвинз: пингвинз
мног: многие
разнообразн: разнообразной
бицепс: бицепс бицепсом
сочета: сочетается
люб: любой
похуден: похудения
язык: язык
умн: умных
фот: фото
обязательн: обязательно
попроб: попробую
арестова: арестовало
телосложен: телосложения
регулярн: регулярный
упор: упор
нат: нато
выдох: выдохе
информац: информация
предостерег: предостерег
завтр: завтра
всевозможн: всевозможные
дневн: дневной
люд: людям
отвеча: отвечает отвечающих
звер: зверев
матч: матч
ко: ко кое
вста: встаем
избега: избегаем
шагн: шагните
супинац: супинацию
например: например
одн: одну одно
блин: блины
продаж: продажу
монт: монте
вращен: вращение
увеличен: увеличения
забот: забота
нагрузк: нагрузку нагрузкой нагрузки
потребн: потребность
предплеч: предплечья предплечье
сми: сми
огромн: огромное огромную
петл: петли
блю: блю
подня: поднять
музык: музыки
апрел: апреля
ммазимн: ммазимние
находя: находящиеся
участ: участие
соблюда: соблюдать
аренд: аренды
использован: использованием
уровн: уровне
гантел: гантелями
мо: моему
кача: качаем
громк: громкой
включа: включать
горазд: гораздо
испытан: испытании
войт: войти
исходн: исходном исходное
качеств: качестве
участв: участвуют
медвед: медведев
конечн: конечной
присутствова: присутствовало
веша: вешают
торонт: торонто
кост: кости
сраз: сразу
дум: думая
заяв: заявили
болезн: болезни
скотт: скотта
ракет: ракеты
жела: желаемого
вполн: вполне
новост: новости
лучш: лучших лучшие
сперед: спереди
достижен: достижении
относ: относятся
лбу: лбу
добр: добро добра
гриф: грифа гриф
оо: ооо
возможн: возможностей
всу: всу
севил: севилья
выбра: выбрать
брос: бросил
держ: держим
голов: голову
дает: дает
колен: колени
хочет: хочет
как: какие каких
дмитр: дмитрий
кар: карен
меша: мешают
возмож: возможен
бойц: бойцов
выпуск: выпуска
бывш: бывший
реальн: реальный
мечт: мечта
втор: вторым
тяжел: тяжело
рол: роль
наверх: наверх
держат: держат
точк: точке точки
сфер: сфера
пада: падает
мер: меру
наход: находится
никак: никакого
рекоменд: рекомендую
zoran: zoran
fotodom: fotodom
milich: milich
ctrl: ctrl
appl: apple
fornand: fornander
getti: getty
unsplash: unsplash
shutterstock: shutterstock
killnet: killnet
microgen: microgen
ez: ez
john: john
imag: images
trx: trx
enter: enter
live: live
