нейрон: нейронов
максимальн: максимальной
чувствова: чувствовать
замедля: замедляющие
безвредн: безвредные
ру: ру
влиян: влияние
студентк: студентке
садовод: садовод
стат: статьи
обычн: обычную
омолажива: омолаживающих
стал: стала стало
жительств: жительства
объясн: объяснил
гибкост: гибкости
старен: старение
удал: удалить
успех: успеху
последств: последствиях
работ: работу
удар: удар
вернут: вернуться
мозг: мозга
арх: архив
экономик: экономика
пож: пожить
поз: поза
перевоспита: перевоспитать
концентрац: концентрацию
принос: приносит
обостря: обостряющихся
эмбрион: эмбрионов
преврат: превратило
арм: арми
неприятн: неприятных неприятностями
личност: личность
шлак: шлаки
провоцир: провоцирующие
структур: структуры
крепк: крепким
заморозк: заморозки
миллиардер: миллиардеры
подел: поделилась
сезон: сезонов сезонную
клещ: клеща
звезд: звезды
обманыва: обманывающих
мир: мир
укол: уколов уколы
пасхальн: пасхальных
предательств: предательстве
силов: силовые
секретн: секретные
кард: карди
миф: миф
идеальн: идеальной
неутолим: неутолимый
внезапн: внезапно внезапной
девушк: девушкам
нажм: нажмите
резк: резко
связ: связь
весн: весной
появля: появляются
феврал: февраля
сдвг: сдвг
томат: томатов
думскроллинг: думскроллингом
дела: делать
бэрримор: бэрримор
модн: модные модный
обнажен: обнаженной
терапевт: терапевт
тошнот: тошноты
фронт: фронте
одиночеств: одиночество
член: члена
подушек: подушек
травм: травмах
беремен: беременности
декабр: декабря
украин: украине
гранат: гранатой
ежегодн: ежегодно
прост: простые
раскр: раскрыл раскрыли раскрыла
выстав: выставил
лин: лина
уизерспун: уизерспун
россиянин: россиянин
сосед: соседа
справ: справиться
вред: вреде
предупред: предупредили предупредил предупредила
отек: отеки отек
симптом: симптомах
удержа: удержаться
сомнолог: сомнолог
встрет: встретить
весел: весело
весен: весенние весеннее
повышен: повышению
разбогател: разбогатела
орв: орви
нов: новом новый новой
ног: ног
женск: женской
мест: месте
кристиа: кристиан
порядок: порядок
традицион: традиционно
борет: борется
токсичн: токсичных
карьер: карьеру карьеры
гинеколог: гинеколог
выписа: выписали
полезн: полезные полезным полезны
сопровожда: сопровождающиеся
сдела: сделать
определен: определении
пространствоментальн: пространствоментальное
овощевод: овощевод
эффективн: эффективность эффективно эффективные эффективностью
особен: особенности особенностей
видет: видеть
англ: англии
деактивирова: деактивирована
испытыва: испытывают
родител: родителям
редакциярекламаконтактыпресс: редакциярекламаконтактыпресс
вспомн: вспомнили
нормализова: нормализовать
фигур: фигуры
совет: советы совет
жизн: жизнью жизни
гвинет: гвинет
сексуальн: сексуальность сексуальные
ноч: ночам
футболист: футболист
хирург: хирург
актер: актер актера
систем: системы
бесполез: бесполезен
пыта: пытающимся
прослушиван: прослушиванием
узна: узнать
похудет: похудеть
слепот: слепота
выж: выжить
менопауз: менопаузе
путешеств: путешествия
клан: клана
укус: укусе
сша: сша
лидер: лидер
перезапуст: перезапустила
скрыва: скрывается
свойств: свойство
подготов: подготовиться
техник: техника
стриптизерск: стриптизерской
неудач: неудачами неудачу
проигнорирова: проигнорировал
утечк: утечки
окружа: окружающих
хотел: хотелось
культур: культура
кулидж: кулидж
нутрициолог: нутрициолог
средн: среднего
личн: личные
живет: живет
домашн: домашних домашние
каннибализм: каннибализм
спуска: спускаться
сонуход: сонуход
смерт: смерти
секрет: секретом секрет
помоч: помочь
дольш: дольше
вылож: выложившего
нрав: нравится
йоханссон: йоханссон
везет: везет
врач: врач врачи
посетител: посетителям
полов: полового половых
орешк: орешком
скандал: скандалы
сном: сном
вызыва: вызывающие
здоров: здоровье здоровому здоровья здорового
красив: красивые
любв: любви
попытк: попытка
вышедш: вышедшую
опасн: опасные опасных опасность опасным опасности опасная опасно
обнаруж: обнаружена
кулич: куличей
шашлык: шашлык
дал: дали дала дал
упражнен: упражнениях
мастурбац: мастурбации
документ: документы документов
пчелин: пчелиных
будущ: будущих
желан: желание
корректн: корректные
бизнесвум: бизнесвумен
опровергл: опровергла
прерва: прервал прервала
свобод: свободы
дан: данные
вейп: вейпов
борьб: борьбе
спецпроект: спецпроекты
дизайнер: дизайнер
скандалист: скандалист
сенсац: сенсацией
раскрыт: раскрыто раскрыты
психик: психики психику психикой
росс: россии россия
заканчива: заканчивается
процент: процент
гиперзвуков: гиперзвуковой
мотор: мотор
вредн: вредный вредными
аспирин: аспирина
ситуац: ситуацию
пожалова: пожаловать
похмел: похмелье
цикл: цикла
скупа: скупать
отсутств: отсутствия
причин: причина причины причину
отказа: отказалась
психлечебниц: психлечебница
группов: групповое
клубник: клубнику
собойокружа: собойокружающее
очк: очков
брак: браков
запо: запои
вирус: вирусу
лент: лента ленту
кажд: каждой
наркотик: наркотики
возраст: возраста возраст возрасте
опечатк: опечатку
лекарств: лекарств
галер: галереи
оцен: оценил оценили
дженнифер: дженнифер
сохран: сохранить
остров: острове
вмест: вместе
любовн: любовными
скарлетт: скарлетт
объект: объект
уловк: уловки
серьезн: серьезным
некроз: некроз
жил: жилье
жир: жира
абьюз: абьюз
привычек: привычек
бессонниц: бессонницы
пост: пост
ссср: ссср
вегетарианств: вегетарианство
яв: ява
климакс: климакс климакса
диет: диеты диетах диета
дел: деле
рассказа: рассказала рассказали рассказал
андерсон: андерсон
размер: размер
брюс: брюс
тал: талии
насмешек: насмешек
новогодн: новогодних
несмотр: несмотря
срок: сроки
выясня: выясняем
гликемическ: гликемический
адаптирова: адаптироваться
красот: красоты
изнасилован: изнасилование
дет: детей
отказыва: отказывать
назва: названы назван названа назвала назвал назвали
расширен: расширенных
смех: смеха
аптечк: аптечке
материал: материалы
потлив: потливости
минус: минусы
психиатрическ: психиатрической
суицид: суицида
привлекательн: привлекательная привлекательной
смен: смена
некотор: некоторыми
отношен: отношениях отношений
ад: ад
отреагирова: отреагировать
становя: становящихся
актрис: актрису актрисы актриса
кита: китаем
спорт: спорт
мысл: мысли
вылеч: вылечить
последн: последние
скал: скала
возлюблен: возлюбленных
услов: условиях
сам: самый самая самых самые
жми: жми
би: би
крах: крах
выглядет: выглядеть
правильн: правильно
восстанов: восстановить
бо: боятся
переохлажден: переохлаждения
называ: называли
иммунитет: иммунитету
рассказыва: рассказывает
длин: длину длинные
спортза: спортзала
чудодействен: чудодейственное
главн: главное главные главных
неожида: неожиданным неожиданная
действ: действий
нашл: нашли
изменник: изменников
женщин: женщинам женщины женщин
японк: японка
снек: снеки
заболеван: заболевания
страда: страдают
велик: великий
неправильн: неправильных
октябр: октября
обострен: обострение
начина: начинающим начинается начинать
вен: вен
состоян: состоянию
постел: постели
вер: вера
популярн: популярных популярной
мужчин: мужчинах мужчины мужчинам
смертельн: смертельной смертельная
развод: разводе развод
рад: ради
магазин: магазине
яичн: яичных
рак: рак
предостерегл: предостерегла
пентагон: пентагона
имеющ: имеющихся
сво: свой
специалист: специалисты специалистов
интернет: интернет
россия: россиян
необычн: необычных
волос: волосы
потрясен: потрясений
диетолог: диетолог
калечат: калечат
сбежа: сбежать
появлен: появления
привычк: привычки привычках
дуэйн: дуэйн
пришл: пришли пришлось
ягод: ягоды
развит: развития
переж: пережить
отвращен: отвращение
питан: питании питания
груд: груди
истяза: истязает
происход: происходит
стоматолог: стоматолог стоматологов
трех: трех
неочевидн: неочевидные неочевидная
адрес: адрес
сильн: сильной
ведьм: ведьмой
ценност: ценности
услуг: услугой
джонсон: джонсон
пром: промо
телефон: телефона
индекс: индекс
худет: худеть
перекус: перекусы
переоцен: переоценили
праздник: праздников
голливуд: голливуда голливуд
модел: модели
пробл: проблем
зрел: зрелом
психолог: психолог
курортн: курортной
онколог: онколог
представител: представителей
вид: виде
виде: видео
сопра: сопрано
девствен: девственности
москвичк: москвичка
науч: научив научиться
возникновен: возникновения
счастлив: счастливой
быстр: быстрый быстрого быстро
эксперт: эксперт экспертами
фрукт: фрукты
зуб: зубов
отуч: отучить
наук: наука
фетиш: фетиши
влия: влияет
распространен: распространенный
подсказа: подсказала
всепитан: всепитание
известн: известно известной
знаменит: знаменитых
сторон: стороной
депресс: депрессия депрессии
перечисл: перечислил перечислены перечислила перечислили
шоколад: шоколад
обитан: обитания
соседств: соседства
призна: признался признали
дырочк: дырочками
тысяч: тысячи
ненавист: ненависть
сажа: сажать
отраст: отрастить
принцип: принципов принципа
хорош: хорошие
повод: поводы
любим: любимого
сред: среда
обвинен: обвинения
улучш: улучшили
здоровьеотношен: здоровьеотношения
темн: темной
полюб: полюбили
ретр: ретрит
успешн: успешной
токсин: токсины
похуден: похудения похудение похудению
нагреван: нагревании
плат: плата
снят: снять
язык: язык
избежа: избежать
большинств: большинство
умн: умных
хаммер: хаммер
уиллис: уиллис
попроб: попробуйте
вонг: вонг
удачлив: удачливых
мяс: мяса
нат: нато
информац: информация
больниц: больницы
распозна: распознать
правд: правда
способств: способствует
планет: планеты
риз: риз
люд: людях людей
прокомментирова: прокомментировал
россиян: россиянам россияне
отвеча: отвечают
пен: пены
отталкива: отталкивающие
объяв: объявила
груст: грустить
предотврат: предотвратить
сборн: сборной
переста: перестает
рыбалк: рыбалке
вывод: выводит
катастроф: катастрофа
развея: развеял
дрю: дрю
черт: черта
продаж: продажу
миров: мировой
забот: забота
рекомендац: рекомендации
страх: страх
улиц: улицу
надежд: надежд
пив: пиве
наркозависим: наркозависимостью
сми: сми
убива: убивающих убивает
курен: курения
плюс: плюсы
молчан: молчание
музык: музыки
польз: пользу пользующихся
чеснок: чеснок
апрел: апреля
стран: стране
январ: января
побед: победить
овощ: овощами овощах
громк: громкой
кариес: кариеса
сентябр: сентября
март: марта
испытан: испытанием испытании
песн: песни
войт: войти
яиц: яиц
марк: марк
глаз: глазами
питьев: питьевая
выбор: выбору
наскольк: насколько
напитк: напитка
проблем: проблемы проблемах
бодрост: бодрость
данэм: данэм
секс: секс сексе секса
уолберг: уолберг
обжорств: обжорства
бэйл: бэйл
болезн: болезней болезнь болезнях болезни
ракет: ракеты
уборк: уборке
жела: желающих
новост: новости
перв: первых первые
сну: сну
орган: органов
достижен: достижения
посет: посетила
памел: памела
аллерг: аллергии
бол: болен болью
добр: добро добра
неизлечим: неизлечимо
оо: ооо
изменен: изменения
желтк: желтков
молод: молодости
брос: бросились бросил
увелич: увеличить
голод: голод
неопровержим: неопровержимые
оргазм: оргазма
сон: сон
календар: календарь
боя: боящимся
сот: сот
мешк: мешки
молож: моложе
голос: голоса
меша: мешающих мешающие
зубн: зубной
сперм: спермы
выпуск: выпуска
бывш: бывший
пэлтро: пэлтроу
либид: либидо
реальн: реальный
приближа: приближающих
рол: ролей
дням: дням
ребенк: ребенка
дешев: дешевые
партнер: партнеры
способ: способы способе способ способах
миллион: миллионы
июл: июля
избав: избавиться
справля: справляется справляться
продукт: продукты продуктов
признак: признаки
пищев: пищевые
потер: потерей потери
killnet: killnet
ctrl: ctrl
appl: apple
tiktok: tiktok
wildberri: wildberries
enter: enter
