обыча: празднуют
слух: слухи
ру: ооо
пенс: офицера
банк: комиссию подконтрольного
казан: казани
экспериментальн: выступили
стат: статьи
воен: военного
обычн: обычную бег
оказа: арктике желудке
стар: массовые
рабоч: потеря
стал: стали стало
горожа: задолго
кадыр: кадыров
объясн: белгороде
си: лидера
гибкост: стриптизерской
последств: печальные
центр: районов
парикмахер: нескольких
арх: архив
предсказа: мвф
экономик: крупнейших экономика
призывник: реестр
сто: стоит
манхэттен: манхэттене
слома: сломал
макияж: нанесения
арм: призыва республиканской оборона
хасбик: хасбик
снижен: предсказал
структур: структуры
суд: предстанет суд
подел: шуфутинский
черномырдин: виктор
котор: ваз
карл: коронацию
уб: убит гагарина
силов: силовые
секретн: детям утечку секретные сидел
кард: судом
ящик: нашли
кара: работодатели
прав: лишили принять кризиса
спецслужб: спецслужбам
переоформлен: россиянам
визит: европы
отмет: политолог
нараста: заявили
совместн: экспериментальным
вперв: сократилось
подводк: глаза
норвег: посольство
верш: украины
причастн: мелитополе
верс: версия
одева: планируют
вывел: подросток
книг: красную
грандиозн: мегаполисы
россиянин: россиянин жанейро приготовления
рубл: америке рублей
сосед: соседа
постро: товары
занима: правильно
предупред: предупредили
заработа: инвестиций
лиш: сироту
хх: наводнение
нов: москву новой гранатометом состоянии проезда новая
теракт: причастных
ног: ног
приговор: вынесенный приговорили
госдум: функция
капсул: скромные
устро: устроивший самолета
журна: бойцов
дугин: дарьи
недвижим: переоформлении
выписа: актрису
отказ: последствия
сдела: партнеры
воровств: пойманный
деактивирова: нажмите
цар: русским
совет: роспотребнадзор дал
пут: кратчайших
нос: текущую
русск: стыдно руинах
самолет: норвежским пассажир
шеф: днюху
летн: врачей ареста внешности
накача: бренд
покор: россиянка
подросток: царем
проезд: неоплаты
путешеств: путешествия
шо: участницы
текущ: увидела
сша: сша
лидер: китайского лидер
укрепрайон: укрепрайоны
миха: летний
техник: техника
стриптизерск: упражнениях
ненавидел: ненавидели
ослаблен: нарастающем
европ: ослаблении
фина: грандиозный
культур: культура
противн: паспорта
лнр: конфликта
флагманск: новый
бесплатн: совершенно
опаса: опасаться
нрав: места
неизвестн: крутые
еврокомисс: китай
помощ: какую
современ: финал
врач: врач ужаснул
протон: спасет
праздничн: блюда
выступ: рэпер
отчаян: отчаянием
малик: дмитрий
христианск: главного
опасн: россиянкам
мышц: мощные
жител: дней людей
револьвер: убивший
суперкар: доработать
будущ: отцами
задержа: мамонта
замуж: вышла
инвестиц: инструментов
вкусн: приготовить
свобод: лишения
пожар: девушке
спецпроект: спецпроекты
генера: генерал
слит: подробности
закон: вор приняла детали
росс: россии россия россию сотрудничать
помог: помог
фбр: фбр
джейм: актера
мотор: мотор
универсал: неизвестные
ситуац: ситуацию
арктик: побывать
скупа: скупать
отсутств: заявила
роналд: экономик
мужик: кризисом
переломн: ревности
маршалл: план
лент: лента ленту
мирн: мирные
опечатк: ру
российск: российского российские юноша военнообязанных бороться бикини
накрас: женщина
пачк: брата
искусствен: детей
кассел: касселем
стыдн: маск
использова: предложили
небрит: небритых
африк: союз
юр: космонавта
коронац: приехать
список: месси
ссср: ссср
комисс: платить
ввест: идея
шуфутинск: михаил
лимузин: секретного
нашел: мужчина
высылк: раскритиковало
зареза: турции
вулка: извержение поражают действующий
поменя: россиянки
событ: фокусе
концерт: совместным
мощн: самое угрожает накачать
блогерш: летней блогерша
назва: независимость пригожин назвала бесплатно
ведр: жену
товар: ввезти
психиатрическ: выписали
фабричн: наличник
космонавт: первого
употреблен: изучено
актрис: сериала обнаженной
попа: скандал
остава: оставалось
кратчайш: отсутствии
пластик: заподозрили
спорт: спорт
рэпер: маликов
друз: аэропорту
зна: мужики
возлюблен: осудят
беспроводн: потерянный
кроссовер: флагманский
интеллект: искусственный
вруча: армию
автомобильн: китайский
госпитализирова: фокса
израил: создал
правильн: выбрать
отдохнут: бюджетно
тайн: планировании
занест: москвичек
маркл: меган
донецк: донецком
программ: россией
спортза: посетителям
заворож: наследники
главн: главное обычаи главные
действ: покорила
привел: привели
состоян: автомобили
изуч: нужна
отстоя: израиль
чемпионат: теста
созда: стран империи
помн: никто
паспорт: вместо
стол: праздничного
сохранен: секретами
деревн: построить
интернет: интернет
мега: отказа
московск: таможне
диас: кэмерон
скинул: суперкар
разозл: истории
волос: отрастить
безработн: признать
оригинальн: стола
уклонист: повестки
пришл: пришлось
знат: н
бел: выпадение
праздн: москвы
сотрудник: высылку
нанесен: блогерши
копейк: забытая
бег: челночный
эконом: рис
подписчик: подписчиков
кендалл: диас
доработа: быстры
пособ: дома
числ: концертом
осуд: россиянина
жидкост: черную
гагарин: юрия
подозрева: подозреваемого
кризис: мощнейшим страну
ревност: чувства
раскритикова: норвегии
сотруднича: захотел
петербуржец: бизнеса
курортн: житель курортной
милохин: даня
мечет: мечети
виде: видео
привез: кнр
прилавк: российских
москвичк: исчезающих
историческ: звездах
обжалова: призывников
быстр: недостаточно способы лапши
челночн: интересное
заключен: романах
подорожа: падает
владл: владлена
виновн: виновных
бизнес: сферы
мамонт: бивней
альтернативн: создать
наушник: беспроводной
упряжк: собачьей
возросш: возросших
прокат: прокате
пригожин: ес
честн: честный
обитан: обитания
федор: москвичках
побыва: мечтают
включ: журнал умрут
отраст: быстро
медведев: медведева
оформ: незаконно
сред: среда
чувств: девушки
похуден: похудения
язык: язык
планирован: заподозрила
снял: жаль банку
фот: ягодиц
рейсинг: дрэг
правд: исторической
взял: законе
дожд: белого
люд: влиятельных
москвичек: века
год: заворожили
лют: люто
фокс: джейми
шенг: выдать
фсб: фсб
супруг: недвижимости
потеря: нашел
трамп: трампу
самозанят: самые
клюшк: возили
одн: уничтожить
продаж: продажу
рис: пластиковый
ампутац: ампутаций
венгр: свободы
улиц: вышедшую
потребн: лнр
столиц: жители
инструмент: самых
выда: отказалась
маск: илон
апрел: апреля
наводнен: мощное
россиянк: взгляд хирург история
электрон: правила
смотрет: смотреть
задолг: сумки
неведом: отдали
регион: терактам
пьян: пьяный
войн: нюрнберг
камчатк: вулканы
подмосков: подмосковье
испытан: испытании испытания
войт: войти
яиц: окрашиванию
массов: капсулы
интересова: интересоваться
тон: повестку
аккаунт: использовать
марк: актер
дета: минцифры
глаз: накрасила
роспотребнадзор: играет
сраз: ввп
гражданин: обычный
мвф: пожар
убийств: убийстве убийства убийство
подробн: новые
рецепт: пасхальные
барн: живет
болезн: болезни
воин: воин
украинск: украинским украинскому регионе
ракет: ракеты
предстанет: полицейского
республиканск: национальной
новост: новости
бог: горожан
перв: событий
руин: лежала
юнош: еврейский
приня: госдума сотрудников
добр: деактивирована добра
запомн: афоризмы
планир: ухода
пепл: накрыло
шест: намерение
выйдет: венгрия
отставк: роналду
безумн: федерацию
пассажир: воровстве
как: безработным черномырдин
турист: русских
отставн: избил
недостаточн: рейсинга
участниц: страшно
повлия: утечка
кат: катится
переговор: переговоры
фильм: режиссер
род: сидим
реальн: пожаловать
рол: африкой
риск: рисках
кэмерон: съемок
сфер: москвичей программе
партнер: друзья
разведк: разведка
мен: варианты
извержен: коричневый
способ: одевать раскрыл
форм: хорошей
илон: боится
днюх: скинулся
бюджетн: способ
диверсант: украинских
обрат: обратилась
готов: доля
хлынул: бренды
лапш: пачки
влиян: влияние
студентк: студентке
америк: латинской
независим: отстоял
учет: воинском
дорог: гольфа
вторичк: покупку
приобретен: раскрыто
удал: удалить
появ: камчатки
вернут: вернуться
конфликт: конфликте ход
бикин: фото
д: д
москвич: самозанятых
макрон: визита
н: милохин
личност: личность
скромн: праздника
х: х
показа: показали
звезд: войне книгу
квартир: грузии ворвался
вариант: оригинальные
мир: мир
укол: уколов
пасхальн: правде
мальчик: летнего
продава: кроссовер
рассчитыва: помощь
совершен: земли
внешност: удивились
воинск: закона
организатор: организаторов
вагнер: чвк
девушк: возлюбленного бывшей
нажм: опечатку
приготовлен: быстрого
выраз: киев
оон: генсека
мегаполис: адского покинуть
боев: армата
получ: получил россиянину
власт: слежка деньгах
модн: турецкие
обнажен: улицу
перевод: экономить
фронт: фронте
важн: армия
город: курортного
разведчик: самолетом
реестр: запустят
национальн: диверсии
рук: мышцы руку
украин: украине колонии
гранат: гранатой
чат: секретном
ужаснул: обследования
внутр: деревню
гранатомет: ящик
раскр: парикмахер раскрыли раскрыла
актив: арест
выстав: выставил
венсан: венсаном
покинут: готовых
поселок: пеплом
алкоголизм: алкоголизме
приготов: рецепты
нарушен: предотвратила
месс: мбаппе
миллиард: миллиардов
китайск: лимузина продавать
мест: незабываемые
блюд: вкусные
иде: оценена
пожизнен: пожизненный
госуслуг: аккаунт
мелитопол: детьми
длительн: длительным
гонщик: ирландский
дональд: дональду
автомоб: старые
отда: душу
эффективн: эффективность
видет: видеть
терап: протонная
редакциярекламаконтактыпресс: чемпионатом
страшн: противно
работодател: чате
жал: вышло
жизн: жизни
кит: население
триллион: триллионы
импер: российской
хирург: банка
населен: потомство
актер: популярные властей
чвк: уничтоженных
несовершеннолетн: несовершеннолетний
сотн: подорожает
адск: внутри
момент: переломный
дрэг: сделано
авторитет: вершил
бренд: автомобильный модные
вышл: жиль замуж
съемок: госпитализировали
неоплат: пенсии
пойма: армии
выявл: насра
патрис: снялась
изб: кондуктор
зацепер: зацепер
утечк: умышленной утечке утечки документах
удив: сети удивила
личн: личные
живет: мегаполиса
артиллерист: артиллеристы
нужн: терапия
отц: алкоголя
секрет: поделился
вылож: выложившего
корейск: копейка
молдавск: маршалла
генсек: уклонистам
посетител: начинающим
скандал: скандалу
собач: вулкан
результат: оружия
турецк: турецком супруга
корнил: корнилов
распоряжа: хочет
артанья: артаньян
вышедш: упряжке
дал: уолберг
упражнен: рассказала рассказал
документ: документы слитых документов
мечта: тысячи
фокус: оказался
повестк: вручать обжаловать
кнр: председатель
жен: жене утопивший
дан: данные помнит
дар: макияжа
дат: названа
раскрыт: карла раскрыты
суров: суровый
сирот: российскую
сократ: китая
обследован: результат
гиперзвуков: гиперзвуковой
разруш: разрушила
угрожа: ним
пожалова: добро
тренер: отставку рук
таиланд: армению
функц: появится
деньг: современного распоряжаться
отказа: популярная
брат: зарезал
очк: очков
экзотическ: самая
гольф: клюшки
предлож: жидкость
спасет: мальчика
галер: галереи
границ: нарушение
оцен: гибкости оценили оценил
нафтогаз: нафтогазу
незакон: города
костомаров: костомарову
вмест: госуслугах
финансов: финансовая
умышлен: назвал
уход: хлынули
британ: таиланд
военнообяза: электронные шенген
увидел: подводкой
обнов: обновила
броневик: новейший
жил: жилье права жилья
ваз: экзотическая
ворва: петербуржец
маловероятн: маловероятными
наступлен: зеленского
танк: боевые
медиа: медианная
офицер: отставного
кра: оказаться
заподозр: дженнер ведре
преимуществ: преимущество
незабыва: ребенком
минут: минут
афоризм: какие
рассказа: тренер ждули би
жит: жить
игра: роль
мбапп: включил
ответ: ответ
губернатор: правит
москв: москве центре неведомо привез
никт: которую
срок: сроки срокам срок
покупк: покупкой льготы
измен: интеллект
белгород: дождя
лишен: годам
ввп: снижение
дет: включая нравятся
рассвет: приговор
уничтожа: уничтожают
ад: ад
арест: дата снял
отреагирова: оппозиции
турц: отдохнуть
стрельб: стрельбу
аэропорт: московском
ал: тренера
кита: китаем макрона
район: барных
месяц: месяца
сам: акции пережила корейски выявлены
мушкетер: мушкетеров
захотел: иран
жми: жми
детьм: семьях
пластиков: прилавках
би: карди
школ: школе
бо: изменит
бондарчук: федоре
ира: заработать
неожида: неожиданное
нашл: объяснили
каас: патрисия
женщин: броневик
армат: волосы
век: хх
афер: афера
начина: совет
пасх: яиц меню
ирландск: активов
популярн: диверсантов популярном популярное популярных популярной формы
вс: рубль
режиссер: каас
смертельн: смертельной
мужчин: разозлили
ягодиц: пластике
исчеза: актрисы
коричнев: рассвет
пентагон: пентагона
уеха: поменяла
утоп: больницы
прилета: прилетает
посольств: военнообязанному
лежа: запомнила
россия: россиян
оруж: поставок
тест: гонщик
ждул: шоу
рекорд: рекорд
наличник: спасали
виктор: родился
появлен: появлении
татарск: татарского
груз: россиянами
де: рио
переж: пережившему москва
оберег: оберега
гражданств: внж
контрол: взял
уничтожен: число
происход: происходит
зеленск: потребность
трех: трех
спаса: столицы
забыт: пасху
ценност: ценности
ев: евой
влиятельн: список
истор: туристов заключенными
еврейск: важнее
ход: повлияет
ес: путей
праздник: христианского
слежк: оон
ввезт: гражданин
сем: президента семьи
кондуктор: российский
выпаден: землю
представител: представителей
сет: сфера
дженнер: кендалл
потомств: будущее
красн: занести
печальн: названы
ищут: ищут
нескольк: сразу
армен: уехала
наук: наука
дне: собрали
сумк: дорогие
дол: пасхе
дом: фабричного
известн: известно
галяв: галявиев
сид: знаем
жанейр: де
призна: безработице
тысяч: наступлении
родственник: гектаров
хорош: сохранения хорошие
стоимост: стоимость
колон: контроль
подконтрольн: выйдет
безработиц: пособие
обвинен: обвинению обвинения
оборон: разведчиком
школьник: школьника
наср: аль
плат: перестать
выгод: момент
большинств: переводах
умн: умных
гектар: оформил
обяза: обязали
план: надежду
доллар: долларов
арестова: арестовали арестовало
нат: нато
гроз: грозит
информац: редакциярекламаконтактыпресс
курорт: курорте
больниц: психиатрической
сход: бондарчуке
призыв: правилах
земл: краю секретных
столкновен: столкновения
россиян: россияне заниматься приобретенных
сканда: устроил
нюрнберг: фильма
предотврат: танки
ки: вторички
переста: деньгами
оппозиц: молдавской
сериа: звезда
черн: носа
бивн: тонну
собра: сотню
военкор: военкора
правил: закон
обожа: обожали
внж: получить
взорва: взорвать
увеличен: опасность
забот: забота отметил
запуст: учете
вор: губернатор
надежд: выразил
президент: заботу
роман: рассказали
председател: цзиньпина
приеха: маркл
акц: спортзала
поставок: тайных
сми: сми
огромн: огромной
музык: музыки
цзиньпин: си
федерац: альтернативную
союз: выгоден
воз: универсалы
аренд: аренды
стран: страна шести стране вывел
диверс: дугиной
громк: громкой
льгот: ввести
душ: душе богу
сидел: шефа
наследник: власти
поража: поселок
уолберг: марк
намерен: увеличения
заяв: британии еврокомиссия
латинск: гражданство
умрут: авторитетами
вынесен: отреагировал
борот: карают
окрашиван: советами
оо: информация
интересн: знать
всу: всу
политолог: квартир
брос: бросились бросил
выбра: упражнения
грин: грин
хочет: большинство
крупн: одну
дмитр: попал
крут: рассчитывать
желудк: наушник
взгляд: безумная
тюрьм: тюрьмы
бойц: вагнер
выпуск: выпуска
накр: вулкана
бывш: бывший квартиру
ребенк: сходить
уничтож: рабочих
пада: вс
алкогол: употребления
выплат: выплатить
таможн: задержали
норвежск: границы
полицейск: револьвера
ри: новых
потер: впервые
погиб: погиб
минцифр: родственников
whatsapp: whatsapp
st: st
kia: kia
uniqlo: uniqlo
ctrl: ctrl
appl: apple
lamborghini: lamborghini
iii: iii
tiggo: tiggo
iba: iba
zara: zara
cherri: cherry
killnet: killnet
panamera: panamera
porsch: porsche
cayenn: cayenne
huracan: huracan
time: time
enter: enter
volkswagen: volkswagen
hongqi: hongqi
