встал: встал
случ: упустили
ру: ру
говор: результата говоря годам сидели
оценк: неоднозначной
впоследств: крест
понима: подобное
грабеж: грабеж
стат: статьи убийство
обычн: обычную
оказа: оказалось соседей считают
служ: служит подъем
стал: неоднократных романтические
поддерж: страхи
подскажет: отца
мнен: возмущаются
объясн: лнр
стаж: стажем
чья: отношениям
последств: каким
работ: трудится
дополнительн: дополнительном
показыва: вообще обязательно снимаете
арх: архив
экономик: экономика
впечатлен: стало
получен: здоровье
сто: ждулях
манхэттен: жилья
человек: считаю внимание
тв: российское
лел: леля
слома: полусмерти
макияж: нанесения
встат: помог
присутств: определить
знакомств: рассказывают деминым
структур: структуры
суд: ситуации ставка суд
нест: нести
карт: карту
попрост: попросту
перспект: кучей
котор: котором заключенных согласно
денег: денег
времен: муже
уд: удо
пор: дети
обманыва: обманывают
влюб: влюбилась
силов: силовые
благ: благих
секретн: выложившего
признава: сети
связа: решили отчаянной
съемк: участвуют
визит: преступление
отмет: злоупотребил осужден
внезапн: внезапно
проект: правды комментируют проекта
совместн: какое нескольких
вперв: демин
весн: промовидео
появля: знакомые
про: церкви
дела: делают
драк: изолятор
пользовательниц: проект
сцен: план
иванов: шапарева
режим: режима
партнерш: вторая
злоупотреб: коровкиной
неприят: пройдем
беремен: вроде
комментиру: ждулей
прост: находится
россиянин: болезни
сосед: ограбил бросил
свободн: аэродромом
светл: светлом
встреч: встречи
лиц: связаться
отбыва: статьям отбывал отбывает оставалось
подруг: подруги подруга подруг письма
весен: объяснял
мороз: заявил
позвон: позвонил
нов: сезон нового новым китаем новое
равкович: равкович
убежд: проступках
приговор: приговора квартире оказался
полусмерт: избил
част: часть предостеречь
слож: перенесен сложился
опубликова: свадьбы сентябре
слов: словам
сдела: сделал
внимательн: бойфренды
феном: критике
отзыв: тысячи
воровств: впервые
особен: зрителю
деактивирова: нажмите
судьб: переживала
демонстрир: заключенном
родител: числе
пожен: дождалась
совет: советом советует
пут: путь страшное
нос: сломал
пример: положения
штук: дал
перевоспитыва: взялось
выход: отказали
пропаганд: пропаганде
травматичн: пережили
постановочн: рассказывала
узна: тюрьме
летн: летняя летнего внешности
прята: приходил
отмеча: листа многие
труд: общежитии
путешеств: путешествия
шо: шоу
бесед: беседе
детектив: критики шла
сша: последние
лидер: тройке ракеты
групп: групп группах
молодеж: токсичное
произошедш: разрушилась
техник: техника
напрот: напротив
хотел: хотелось
подготовлен: специально
культур: культура
противн: противно
зек: конченной кусок воспевать зеков
абьюзивн: неудачных
лнр: популярные
господ: теме
номер: номер
обраща: обращалась
помощ: помощи
врач: нато
раздира: раздирает
здоров: подрывая
заключ: рассталась
попытк: попыткам
враг: дом
подад: заявление
опасн: боже передачу
рекордсм: отбывать
фанат: бить
светла: рассказала
окса: доить
будущ: необходимо будущем будущего
желан: вера
спокойн: перестала
шапарев: вероника
задержа: наркотиков
прочита: заключила
портал: фотографии различных
интерес: детективов
замуж: выйти
агрессивн: агрессивно
свобод: встать выйдет свободы
спецпроект: спецпроекты
беспрецедентн: беспрецедентное
росс: россия сотрудничать
помог: воровство
фбр: пентагона
заканчива: история
мотор: мотор
автомобил: угон
убед: убедить
ситуац: утечки сложившейся
каза: казалось
исправительн: режим исправительных свадьбой
счита: бывшего оппоненты
заменя: нужды
цел: ждулям
спецоперац: эфире
покров: коровкина
лент: лента ленту прим
сообща: сообщает
кажд: возила связать
наркотик: сбыте сбывал
опечатк: ооо
пройд: героиней
шла: присутствует
романтическ: пропагандирует романтических
российск: показывать
канал: критику
подрыв: тяжелые
улыб: улыбаясь
параллельн: кувалдиной
сидоркинапользовательниц: оксана
налич: помимо наличия
серьезн: убеждая
довод: признавалась
использова: использовать
юл: поругает говорила отец
уточня: уточняется
достаточн: заботливый
благополучн: благополучная
злоупотребля: злоупотреблял
поясн: смехом
настоя: господи должен
жених: нынешним отмечают жениха
список: пьянкове
кадр: кадр нашли опубликованным
ссср: ссср
знаком: знакомого близкие близких знакомят возлюбленными
телешо: телешоу
строг: строгого
помим: участниц
башкирц: дмитрий
так: таких таки драк
гадалк: обратиться
общен: общения демонстрируют
нормальн: нормальная нормально нормальный
выясня: выясняется супругом
событ: событие
назнач: назначили
условн: условно
высыла: украшений
изнасилован: изнасилование
блогерш: летней
возненавидел: молодежь
назва: пригожин
описыва: впечатления
разбойн: длительных
скриншот: выложили
обернул: обернулось
обсуд: давыдов
некотор: реальной браков
любовник: заменяет
противостоян: элементов
соглаша: морозилась
такс: такси
закадров: проморолике
благородн: вполне
остава: осуждены
добав: бери
спорт: спорт
просмотр: миллиона
упомин: съемке
специальн: писари
возлюблен: возлюбленным возлюбленного вспоминала возлюбленный отношении возлюбленную
стро: эпизоды
зон: зоне
доровскихгер: доровскихгерой
приход: презрении пьяный
тюремн: тюремной
правильн: учат
крас: всей
поня: попробует ласковый
краж: кражу
рассказыва: рассказывает музыку слободскова выпуске
компан: строительной
программ: программа программе программы
получа: наслаждение
главн: главное главным
действ: инструкцию
свадебн: обнаружили
предостерега: сидоркинапользовательница
элемент: ключевых постановочных
заботлив: классный
инициатив: инициативу
поможет: подскажет
уверя: уверяла ребра
бедн: бедно
ухаживан: ухаживания
раз: разу
нападен: разбойное
бойфренд: женихи
кусок: лакомый
ран: ранее
стоп: мест
объясня: поговорить серия
отдельн: святкиной отдельных
разъяр: работниц
зарплат: зарплату
передач: передаче украине передач передачи сняли
интернет: интернет интернете
телеканал: популярности
разозл: разозлили
энтузиазм: переписки энтузиазм
вступ: знали
помещен: помещениях
тем: материалы
пришл: пришлось
оглаш: приговор
полн: заявила
фотограф: свадебную вопрос
дважд: сидевшим
зрител: близость выясняет зрителей сетуют
знал: знакомых партнер
бер: крыло штука
достатк: разного
узакон: пара
комментар: зрители просмотров
бешенств: открывалось
сидевш: избранник
работа: работающая иванова
сильн: произошедшее
свадьб: свадьбу заканчивается кадры
нанесен: блогерши нападение
клуш: роли
покр: поеду
долж: сюжет
десятилет: красоте
заинтересова: заинтересовали
драматичн: голос
телефон: телефон телефону
необходим: срок
числ: назвал окружению
чист: начну
подозрева: арестовало
рецидивист: нестабильным
рукоприкладств: рукоприкладству
вниман: сосредоточить
сотруднича: захотел
восьм: приговорили
реакц: реакцию
выйт: выражением
чита: признания
решетк: решетку находящимися
виде: видео
превраща: последствиям
предостережен: предостережение
тиш: юля
доверя: стоит
положен: достатка
попада: нарушения
намер: отмечает
хрупк: хрупких
неземн: удивлялись
звуча: цель
выйд: уснет
нынешн: демина
оста: осталось
заключен: заключенный заключенными заключенным заключением матерей мужчине список заключения
вконтакт: проводится
вышел: знакомства
бизнес: тремя свой
уточн: колонию
нян: ищет
воспринима: возможно
переписок: состояло
реч: судя
реш: решила понять
олег: комментариев
бит: правильно
унижен: рассказывал
пригожин: политике
зада: перепалки
обитан: обитания
высказыва: порой
реж: нарушив
недел: момента
поддержива: поддерживает
включ: включая
изолятор: попадал
свидан: переписок свидание
загс: подадим
сред: среда телеканале
чувств: чувства
эдуард: эдуард
мног: объясняют
посвящен: посвященное вконтакте
похуден: уколов
стих: читают
язык: удалить
снял: описывает
обязательн: дочери
похвал: осыпают
критикова: переписку
правд: искать
разн: разные возрасте
письм: писал
взял: тв
люд: людям
удовольств: получала
год: восьми
предостереч: поучительной
открыва: временами
промовиде: говорилось
поед: загс
девочк: романтизм
беспоко: беспокоится
зачаст: страницы
подогрева: аудитории
ставк: беременна
вероник: работах
создан: создание
аудитор: выдуманной оценки
супруг: супруг развелась
подъ: легкой
прич: откладывала
зрительниц: участнице уверяет
героин: героине сочувствуют героиня героини героинь каждой
видеохостинг: выпусками
одн: одна одно феномена
мам: простит
продаж: выставил
прим: человека
согласн: решениями
мат: мать
длят: длятся
обращен: порталах показано
потребн: объяснили
уголовник: написано
сообществ: одном общается сообщества
подарк: радовали
объединя: бизнес
энгельс: энгельса
апрел: апреля
предупрежда: предупреждает
находя: мужчинами
россиянк: россиянкам познакомился
избранник: быт избранников отбывают веру прося
кувалдин: анны анна
врод: неоднозначными
участ: участие
инструкц: воспринимать
пьян: зимарина
шифоньер: прятались выйдем
ввязыва: вторым
сентябр: которому
март: запустил закрытия
испытан: известно
войт: войти
расцвет: свободный
сомнен: сомнения
сраз: сразу
обвин: обвинила
крест: поставила
убийств: повреждений
подробн: подробно
поступа: зрительница
секс: редкий
отчая: рецидивистом
упомина: упоминает
поступк: детально
болезн: смертельной
похож: похож строятся
ракет: гиперзвуковой
вполн: звучала
новост: новости
перв: красе первые первым первое
комментир: зрительниц
непрост: непростая
подвод: гадалкам
бож: похвалами
близк: близкой избранником опыте
коров: ходы
достоинств: достоинствах
добр: деактивирована добра
написа: лице
изменен: идет
осужден: партнеров осужденным осужденных осужденные
ушел: полное
выйдет: жених
тро: трое
как: ценность поженились опасно
определ: пытались
участник: решение
поначал: поначалу
детств: опыт
участниц: участницы писала участница сообществах объединяет оградило
голос: закадровый голосу
напомина: напоминающих
матер: высказываются
премьер: премьера
встреча: встречается
прибега: прибегал
освобод: думаю
оппонент: действию
критик: населением родителям посвященных добавил
реальн: пожаловать участницами
зимарин: юлии светлана
тяжел: тяжело утверждает
втор: соглашалась неудачного
близост: откровения
обязательств: никаких
рол: показали
партнер: партнера будущий бывших
сфер: россией
признан: сообщения
обрат: случая
доровск: доровских
финал: избранника
влиян: оценили
студентк: похудения
вступа: вступать кадрам
образ: образом
независим: поддержим
гавриленк: оправдывала
аспект: аспекты
соглас: согласием
удал: студентке
вернут: вернуться
мозг: спинной
преда: предать
вернул: тюрьмах передача
галин: примеру поссорившись
романтик: романтики
четверт: четвертого
александр: дача
перепалк: изучение
коровкин: галиной галина
утвержда: утверждается автомобилей разбалованные
вообщ: марта
перенес: новыми
запасн: служила
личност: раскрыли
шлак: показывайте
оканчива: которыми
одиночк: одиночка
показа: сцен эпизодах показавшая открыто вернулся
сезон: весенний
ангелин: компании подогревает
ударя: энтузиазмом
отправ: отправил совместной выходе
екатерин: психологу
ю: ю
пьянков: бешенство ходу получения
квартир: задержали
сбыва: уточнила
мир: мир фанатов
укол: популярных
писа: тюрьмы зеком
обсужда: обсуждают
идеальн: верить
внешност: удивились
вагнер: чвк
девушк: ним
нажм: опечатку
резк: доходит
феврал: эфир
растая: растаяла
зимаринагероин: юлия
украшен: ювелирных
сообщен: ласковые
получ: получила получив получить
оправда: рейтингам
объявлен: скриншоты
фронт: ситуацию
уснет: папа
город: среди
аргумент: аргументом
ищет: объявления
рук: ребенка
сосредоточ: намерена
украин: спецоперации
гранат: соседа
внутр: внутри
воспева: понимаю
отец: дома
раскр: сша раскрыла
шанс: шанс
выстав: лидер
прям: прямо
больн: больно
сбыт: обвинению
зачитыва: зачитывает
разбалова: какие
нарушен: отказал
мест: местах вышел
ждат: женихом
демонстрирова: демонстрировал
андр: андрей
токсичн: мая
длительн: длительное свиданий
ждал: знакомая
макарьев: зимариной
эффективн: оценил
видет: видеть
ввид: интересует
пьянк: пьянков
редк: любовника
редакциярекламаконтактыпресс: всу
страшн: страшно страшные самое
исправлен: исправления
арабск: настоящему
возмуща: шлак
исправ: желание
окружен: противостояние окружение
жал: жалуется
жизн: жизни
эфир: изменениях вернулась
зашедш: сфера
населен: городов
чвк: уничтоженных
пыта: постом
мол: призналась
момент: момент невестах
поссор: гавриленко
съемок: съемок
вышл: феврале
привест: маму
изб: ссоре
андре: андреем андрея
ужаса: героиням
утечк: подозреваемого влияние
решен: высмеивали судебными
биограф: биография
удив: наступлении
неоднозначн: возможность неоднозначную известного
провод: расследование
живет: покрова
личн: вступали продажу участницу
отц: удовольствие
отч: алены
вылож: участники личность
нужд: деньги
ребр: нос
любл: свободу
результат: независимо
вызыва: вызывала
опыт: негативном
любв: любви
оскорбля: резкой
обнаруж: пользователи
дал: окончательно
моветон: зеками
кончен: критиковали
документ: секретные утечке
предложен: предложение
оправдыва: исправиться
расследован: зачастую
жен: данный беру
дан: личные рекордсмен оправдала
откладыва: копеечку
удивля: подругами
высмеива: порицаемых мозг
поруга: поможет
быт: показан
разделя: разделяет
состоя: состоявшую состоящим осужденными состоял находились
дач: жить
раскрыт: рекорд
детальн: ударяется августа
гиперзвуков: новой
разруш: надежда
освобожден: освобождение
пропагандир: мнению
пожалова: добро
деньг: высылали
отказа: идеально учреждения оскорбляют
брак: брака брак браке предыдущих
очк: умных
предлож: предложил
наруш: надзирателя
невест: некоторые невесты данным
возраст: россиянки
галер: галереи
оцен: очков врач
проявля: проявлять
дво: двоих
продемонстрирова: угрозы
политик: тупик
вмест: жена
уход: избивал
окончательн: обещаний
радиофактчекинг: радиофактчекинг
муж: спокойной мужа мужем муж
прилож: приложу
увидел: увидели свет
тупик: зашедшей
обнов: манхэттене
преступлен: совершает
расста: фотографию
бабочк: бабочки
позва: позвал
жил: жила аренды
расставан: учреждении
возвращен: ждать
сынов: сыновей
наступлен: зеленского
медиа: документов
изнутр: изнутри
просчитыва: зеки
девушек: девушек
пост: опубликовали
ковальчук: оканчивается
лист: чистого
итог: подводится
вспомина: шифоньера
дел: настоящий выбору
вопрос: ответить задаются
рассказа: рассказали макарьева
давыд: олег
жит: покров
тяжк: нанесение
вскор: вскоре
неудачн: отметила состояли
проход: проходят
ответ: ответила просьбой
заверя: эпизода
изучен: детальное
обществ: неприятие
усил: усилия
полност: доверять
несмотр: особенность
сталкива: приходится
срок: дважды раскрыты
переписк: переписке продемонстрировала личную
лишен: лишения
красот: популярный
держа: руках
суток: суток
дет: экране детей детях
август: разъярило
смех: освободился
материал: отправился
работниц: перевоспитывать
отверга: отвергать
пишут: неземной
снима: моветон
отношен: отношений отношения итог отношениях серьезных
иска: призывала
обща: показывают параллельно общаться
ал: юности алена
рома: романа ввязываться роман
ан: зимаринагероиня башкирцев
куч: бизнесами
угон: находился
кита: испытании
реалит: реалити
мысл: мысль
последн: обсудить последний
заявлен: закончится
месяц: месяца месяцев
досрочн: досрочное
сам: самая стала врага
ссор: первой
захотел: иран
жми: жми
наслажден: поняла
оказыва: неделю
подобн: вопросом
называ: называл невест
ира: макияжа
приятельниц: приятельниц
неожида: неожиданный
нашл: заявили
комментаторш: предостерегают
женщин: женщине двумя женщина женщин женщины женщину
рассказыв: комментаторш
юридическ: юридических
вел: вел
писар: пишут
очередн: вместе
вер: пошатнуло гавриленкогерой очередным
инвалид: няню
популярн: возненавидела эффективность лидеров музыки
соцсет: соцсетях
мужчин: мужчина знакомстве вступили доводилось романы
смертельн: язык
пошатнул: сильно
начн: закончились
святкин: екатерине
област: саратовской
цвет: подарками
осужд: участвующих ушел
церкв: молилась
пентагон: документы
спин: видимости
сво: области
реша: перспектив
россия: россиян
значительн: значительная
избива: отчим
ждул: ждуля ждули историям сталкиваться ждуль общался
плеч: плечах плечами
парн: ждала
рекорд: обновила
возникл: решеткой
юност: детстве
законч: возлюбленных заверяет
развит: общение
журнал: отметился
переж: абьюзивных
нестабильн: решает
до: корова
уничтожен: число
выясн: пояснила
зеленск: потребность
трех: трех
различн: инвалида
трет: третья
трем: молодая
ценност: ценности знал
равковичгероин: равковичгероиня
пап: тише
пар: пьянковым пару пары
поучительн: оказаться
посвящ: посвящена
истор: части историей чья истории
ход: зритель просчитывают
двум: комментируя
тепл: тепла
факт: факт
призыва: клуши
презрен: унижении
сем: семья семьи
психолог: обращение
сер: серии увидела вышло
легк: партнерша
сет: пользовательниц уголовник
представител: данные
доход: дело
печальн: детективы
водител: водителем
нескольк: мужчину
наук: наука
пережива: оглашен
дне: дней
поврежден: телесных
неоднократн: ввиду
гавриленкогер: александр
рейтинг: судить
дом: уходила привести
известн: фронте страницах
обидет: обидеть
отпразднова: отпраздновать
постав: узнав
крыл: ленты
указыва: указывает
поддержк: воспитывают
телесн: тяжких
перечисля: перечислять
призна: признался кувалдина
тысяч: видеохостинге
доб: добиться
принцип: похожему
хорош: хорошие люблю
стоимост: медианная
колон: колонии визитах
звонк: звонков
саратовск: слободсковой
любим: любимая
пребыва: пребывать
предыдущ: наличие
обвинен: пьянкова
пользовател: высмеиваемых
сыгра: сыграем
просьб: онлайн
большинств: канале
демин: выяснила дмитрием судьбу
сил: расцвете
умн: сроки
план: приехали
образова: достаточно
попроб: благородно
арестова: фбр
тройк: оказывалось
эпизод: финале серий некоторых
нат: представителей
информац: редакциярекламаконтактыпресс
судим: судимости
развел: впоследствии
строительн: гендиректором
негативн: рассказывая
ключев: развитие
видим: замуж
выдума: полностью
спуст: спустя
экран: появляются
телекана: телеканал называют
наказан: наказание
переста: совместная
поговор: интересный
закрыт: десятилетие
дожда: девушка
дочер: выбор
скандальн: скандальная
идет: речь
предстоя: предстоял
воспитыва: воспитывающая телеканала
романтизм: фарс
классн: хороший
слободсков: ангелины ангелина
забот: забота
запуст: человеком
надзирател: журнале
страх: общества
надежд: таким
попрос: попросил
роман: романах
общежит: общежитие живет
приеха: деле
сми: сми
фарс: превращают
ласков: секс скупятся
польз: пользу
музык: драматичную громкой
ма: миру
познаком: познакомилась познакомились расставанием
учат: арабские
воз: говорится
копеечк: каждую
аренд: стоимость
осыпа: отказались
вол: воле
свет: весной
громк: гранатой
сидел: шифоньере
участв: избранники заключенные
лаком: отпустит
пис: писем
выбор: критикующим ужасаются
онлайн: обращения
проблем: проблемах
соверша: держала
откровен: утверждала
намерен: намерениях
заяв: сообществ узаконила женщинами
ювелирн: цветов
порица: самых
выражен: прочитала
ограб: свободе
радова: стихи
угроз: поступали
оград: проектах
красноречив: красноречиво
дума: стоп
тороп: торопиться
проморолик: марте
крайн: крайне
оо: информация
возможн: девочки возможных несмотря
оп: травматичный
интересн: образованный
упуст: отдельные
всу: бойцов
молод: печально
скуп: внимательны
открыт: аудиторией
брос: россиянин
обещан: обязательств
пребыван: пребывания
ласк: ласки
все: показал
аэродром: запасным
сочувств: отзывов
дмитр: бывшим отправили
страниц: личных находят
судебн: портале
тюрьм: наркотики парня подготовленные
сюжет: изначально
бойц: вагнер
выпуск: большинства выпуска принципу комментариях
отпуст: пути
бывш: возвращения поддержки бывший возникли
гендиректор: работает
тянут: тянуть
изначальн: элементах
ребенк: причем
ник: сил
алкогол: алкоголем
миллион: выпусков
наход: ковальчук поступки мужчины опасности
учрежден: учреждений исправительном исправительного
проступк: упоминая
никак: никому
kinoman: kinomane
killnet: killnet
ctrl: ctrl
irecommend: irecommend
appl: apple
mediascop: mediascope
enter: enter
youtub: youtube
