обыча: обычаи пасхальному
говор: говорится
понима: века
фактическ: фактически
значен: значении
стат: стать
сравн: своими
оказа: оказался
нил: нила
федеральн: федеральным
стал: стали стало
ангел: ангелов
мнен: мнения
местонахожден: местонахождение
став: незанятым
един: единого
работ: работы работу
святител: святителя
клаус: санта
правов: рекламы
привлеч: лица
человек: человека человеком
прийт: прийти
ветх: ветхого
присутств: невидимо
должн: должна
суд: суд
ветк: ветками
готовн: готовности
означа: означает
человеческ: грехи человеческому человеческих
назван: название
царств: царстве божьего царствии
благодар: благодаря
времен: временем
провест: провести
предательств: предательстве
благ: благо
свят: святой
трактовк: иную
вест: красное
прав: правило правившим редакции
троекратн: близкие
отмет: отметят
небесн: небесном
либ: обычаю
воскрес: воскрес
дела: любые делать творожная
впред: впредь
подарок: символический
верн: верной
верс: версиях версия
некогд: некогда
император: рассказать императором
соборн: соборном
верб: вербы
врем: времена
хв: буквами
преподнесл: словами
творожн: творожной стола
встреч: встречи встрече
лиц: виновные
православн: православные православной православным украшается
лиш: лишишь
встрет: встретилась встретить
нов: нового
внешн: внешне
умертв: умертвил
част: символизируют
настоятел: нашего
традицион: блюдо колосками
благовещен: благовещения
алекс: алексей
слов: словам императору слова слово
христосова: христосоваться
дворц: дворце
пострада: пострадать
определен: определенных
ресторан: столичном
златоуст: златоуста
пут: пути путь
символическ: преподнесла
денис: антон
русск: русской
символизир: знают символизирует
ноч: ночью
распростран: христосуются
заинтерес: задумается
прида: придает придать
отмеча: отмечают отмечается
недоверчив: подозрительным
сожален: эльфы
бесед: беседе
произошедш: произошедших
истреб: истребить
заказыва: удовольствием
хотел: умер
культур: массовой
преставлен: преставления
актуальн: актуальности
господ: господом господь
букв: крестами
обраща: обращаются символа
вечер: вечере идет
перенест: христианам
агнц: агнцем
современ: современный современное
праздничн: праздничном едят праздничная сладкое праздничные
проповед: проповедей проповеди
выигра: разбилось
христианск: христианской христианского христианский
текст: выделите
божествен: божественной
сын: сына
добавок: добавок
литург: литургии
евр: евреи
отключ: мослентыподписаться
протяжен: протяжении
казн: казней
ассоциирова: ассоциирована
росс: россии
употребля: употребляли употреблять
задумыва: относят
престол: божьем
плод: плода плодов
каза: казались
счита: считается считает считают
христианств: христианства
несговорчив: несговорчивости
раздража: раздражать
цел: троекратно целую коммерческих
освяща: специальный освящает переняли
человечеств: человечества спасти
кажд: каждом каждой
опечатк: нашли
радост: приносит радостями радости
российск: законодательством
канал: каналам
серебрян: серебряных
множеств: множество
вовек: вовек
коммерческ: сайта
духовн: тысячелетнего духовной
обруш: обрушились
взошел: взошел
значим: значимыми
добавля: добавляет
настоя: церковные
завет: завета
знаком: народе
чудес: чудес
яв: явился
выдел: опечатку
след: следующую
напомн: напомнить
нашел: нашел
невозможн: невозможно
поясня: поясняет
скорлуп: делают
так: таким
письмен: разрешено
пятниц: пятницу
событ: событиях истинности
храм: храмах храма храм храме
редакц: телефон редакция
инжир: инжира
хран: хранится
воспет: воспеть
нахабин: победоносца
засохл: засохла
иудейск: иудейский иудейские
назва: назвал
приближен: приближению
символ: символом символов трактовку символ
ученик: денисов учениками учеников
собира: собираются
некотор: некоторые
противостоян: противостояния
удивительн: удивительной
служб: службы служб служба
количеств: количеством
гер: многие
специальн: ресторане удача
услов: домашних информация
натур: бывший
звон: звонить звона
кафедральн: кафедральном
моисе: моисея
евангел: евангелии евангелиях евангелий
голгоф: голгофу ассоциируют
друг: друг друга глазурью
приход: приходят
крас: красить традиций
тайн: тайной
постн: постная
агнец: агнец
выпечк: выпечку
народ: подобие народа
главн: главным главное главного главный
разбира: разбиралась
действ: соответствии
церков: церковь
велик: великая великого великий велика великую
пят: пятую
несчаст: несчастья
вкусност: другими
христиа: христиан
раб: рабом
рад: ради
подтекст: духовного
нападен: нападение
патриарх: патриарх
кирилл: кирилл
помн: ученики
стол: столы традиционного столе
чиженок: чиженок
иоан: иоанна
выполн: выполнить
шеств: шествие
младенец: герой
московск: московский
торжествен: торжественные
фараон: фараона фараонов фараону
тел: сравнил
бедняк: бедняков
победоносц: георгия
пришл: пришлось
полн: защищены
легенд: легенде легенды легенда
приглашен: приглашению
десят: десятой
бел: ответил
знак: знаком
погреб: погребен
жертвен: жертвенного жертвенная жертвенности
праздн: празднуют историей
искариот: искариота
пророк: пророка
долж: должен
разоблачительн: разоблачительную
десятилет: религиозный
оставля: собираясь
телефон: нажмите
отошл: события
евре: евреев евреям
чист: чистый
вниман: обращают
пойт: пойти
автор: комментировать
выйт: выйти
очеред: очередь
чита: читаются
богородиц: богородицы
иудаизм: иудаизме
разрешен: письменного
придет: празднует
оста: остались
виновн: нарушений
правя: правящую
взлет: взлетами
разреш: целях
угощен: праздничное угощения
реш: решил решишь
залож: заложен
украша: меда
подтвержден: воскресении
анабиоз: анабиоза
страдан: страдания страданиях страданий
недел: неделю неделя недели недель
поддержива: поддерживает
египетск: египетских египетского
рек: реки
включ: включая
пропуст: пропустить
культурн: культурный
подвиг: подвига
тысячелетн: радость
вторник: вторник
сред: среди среда
мног: последнего многих
островск: нахабино
зависим: зависимости
люб: стране
принес: спаситель
снял: сняли
фот: фото
обязательн: символика
захочеш: захочешь
искуп: христу
правд: правда
освят: освятить
гор: горит
гот: готов
храмов: принес
разн: разные
дивногорск: дивногорске
люд: людей
жертвоприношен: жертвоприношением
разб: чье
гибел: гибель
удовольств: религиозных
отвеча: встречают
огн: огня
оздоравлива: оздоравливающая
законодательств: действующим
пекут: заказывают
привод: приводит
антон: ставили
одн: одна одно
мал: малую
широк: широко
переассоциац: переассоциации
хоругв: хоругвями
мар: мария марии
тибер: тиберием яйцо
мат: мать
реклам: отключить размещение
подобра: подобрала
воскрешен: воскрешению воскрешение
выда: выдал
пресвят: пресвятой
обустро: обустроить
предшеств: предшествующая
иерусалим: иерусалиме
милост: милость
апрел: апреля
подоб: освящается
ограничива: ограничивают
соблюда: соблюдать соблюдавшиеся соблюдают
глас: гласит
использован: условия
воцерковлен: воцерковленных
подозрительн: натуре
навстреч: навстречу
испытан: испытание
яиц: яиц
существова: существовали
массов: трансформацию
счаст: сожалению
духовенств: духовенства
крест: кресте креста православными
вечн: вечной вечную
полноч: полночь
празднован: празднования празднованию празднование
яйц: яйца белому яйцами куриное
транслир: транслируется
хлеб: хлеба хлеб
новост: новости
существ: существует
перв: первую первом
бог: богом бога бог
воспита: воспитала
бож: храмовом обетованной
близк: самые
приня: принять принял
партнерск: рекламу
прихожан: прихожане
посвяща: посвящаем
застол: праздничного
мед: творога
повер: недоверчивым
прощен: прощения
как: какие какими
предрек: предрек
благодатн: благодатного
напомина: форма напоминает
встреча: коричневым
освобод: освободить
велел: велел
обход: обходится
втор: вторым второе вторая
обязательств: обязательство
точн: точно
дням: днями
мен: специальное
форм: внимание
продукт: продукты
знаменск: знаменской
страст: страсти
обрат: обратить обратился
жертв: жертвы жертву жертва
готов: готовится готовиться готовятся
причаст: причаститься
заверша: завершалась завершается
образ: образом
учен: ученых
советник: советника
ждет: выиграл
крестн: крестного
предлага: священники
призва: украшения
случа: рождеством
колоск: хв
частичн: полное
практическ: пережила
грех: грехов искупить
преда: предали
удач: большая
принос: накануне утверждают
александр: александр
иисус: иисусу иисуса иисус
послед: последующее
утвержда: смысла
наканун: украшениями
четверг: четверг
стремлен: стремление
потреблен: потребления
галочк: галочки
вольн: вольно
смоковниц: смоковницы смоковница
коммерсантъ: коммерсантъ
показа: показал
поэт: цвет
ассоциир: традиционно
двер: двери
мин: мин
вербн: вербное
одинок: одиноков
собир: момента
мальчик: мальчика
пасхальн: пасхальная пасхальное пасхального изначальному пасхальных пасхальные пасхальном пасхальный
мир: мир
писа: писал
припра: приправ
совершен: совершенных
знают: задумываются
сребреник: сребреников
христиан: призваны христиане христианами
соблюден: соблюдение
нажм: текст
украшен: украшенный вкусностями богослужения
власт: власть
перевод: переводится
важн: важнейшую важнейших
скончан: сегодняшнего
город: город городе
кров: кровь кровью
рук: берут
отец: отец
раскр: раскрыл
традиц: традиция изначальных традиции присутствует
рус: руси
подлин: подлинная
шанс: пусть
кромешн: кромешной
ярк: ярко
вкусов: вкусовых
нарушен: обнаружения
вынест: вынести
больш: ждет
мест: месту оставляли столько
блюд: блюда обязательное
проголода: проголодавшись
послан: послании
порядок: порядок
вход: входа
игр: распространена
попаст: попасть
отда: отдала
погребен: погребению
помина: поминаемые
страшн: страшных страшный
окрас: момент
жизн: жизни
колокольн: колокольного
воистин: отвечают
импер: империей
бьют: крашеному
наступа: наступающей
решим: решимости
момент: апостолам красным
апостол: апостолов апостол передал
сладост: сладости
смог: смог
основн: основных
глазур: условиях
сошеств: сошествия
мослентыподписа: интересного
подготов: подготовить
сознан: сознанию
помаза: помазать
дошл: продолжили
владельц: разрешения
затрудня: затрудняются
передава: передававшиеся
комментирова: придет
провод: проводит проводится проводятся
домашн: освящать
отц: отцом
советск: советское
смерт: смертью смерть
христов: христово христовы христова
далек: горожане
результат: результатом
жизнен: жизненная
христос: целуются христос
полож: положила
павел: павел
кулич: куличами куличи куличей кулич
анал: аналой
двенадцат: двенадцати
пониман: пониманию
последовательн: последовательно
принесл: принесла
пересел: переселились
рисунк: скорлупе
монет: монет монетой
пройдут: пройдут
молитв: молитве молитвы
возвесел: возвеселитесь
иерусал: иерусалим
суббот: субботу суббота
дат: даты дата
католическ: десятилетий
код: код
израилев: израилева
библейск: библейских библейского
народн: настоящему
египет: египет
освобожден: освобождении
сумел: сумела сумел
федоренк: федоренко
брат: братьев
эльф: клаус
дерев: дереву
магдалин: поверил магдалина магдалине
колокол: колокола
политик: использования
вмест: вместе
матфе: матфея
жив: живых живем живы
горожан: меню
обетова: земли
паден: падениями
жил: жили
начал: началом
стара: стараются
тревог: тревогами
возвращен: возвращение
отход: негативно
поколен: поколение поколения
накрыва: накрывать
сладк: престоле
заблужден: заблуждения
кра: края
воскресен: воскресенье воскресения вести воскресение
освещен: освещенными
пост: поста постившиеся пост посте поститься
произошл: произошло
итог: итогом
вспомина: вспоминают вспоминаемые
символик: застолья
стольк: напоминать
диет: диета
слышн: слышно
дел: деле
рассказа: хотела
цитат: цитату
внутрен: внутренне внутренней
ответ: магдалины
москв: москве
богослужен: богослужение богослужении обещанного
усил: усилия
поздравлен: поздравлениями
несмотр: человеческие
иерусалимск: иерусалимском
собствен: собственной
копирован: частичное
измен: изменилось
существован: существованию
расп: ним
дет: дети
материал: партнерские копирование
христ: христа христом перенести
превращен: превращение
разочарован: разочарованием
ал: окрасился
сант: человечество
младенц: младенцев
церковн: островский
сад: саду
последн: последнем случае последняя последней последние
последовательниц: последовательнице
месяц: месяцев
сам: воистину самых самым
священнослужител: часть священнослужитель
седмиц: седмицы седмицу седмица
сопереживан: сопереживанием
вырос: вырос
длит: длится
георг: настоятель
переда: своим
насеком: насекомых
называ: называют называется
вероятн: вероятность
сдвига: сдвигается
творог: делается
принят: принятия принято
нашл: конфиденциальности
смысл: смысл глубокого
незанят: место
век: скончания веков
предполага: предполагают
начина: начинают начинается
пасх: пасху пасхой пасхе пасхи пасха
вер: верить верующим верующего веры верующие верующих
жаля: жалящих
цвет: цветами алый цвета
подошел: подошел
коричнев: красно
церкв: церкви
сво: свой телом своему вечери
перспектив: перспектива
ждут: ждут
россия: россиян
истин: подтверждение
возникл: возникла
молочн: молочные
артос: артос
бабкин: бабкин
плен: плена
теря: теряют терялась
трансформац: практически
спаст: пришедший
представ: представить
переж: счастью
сайт: автор материалов
рыбн: рыбными рыбные
продолж: традицию
происход: происходит происходившего
иуд: иуды иудеи
пришедш: младенец
сегодняшн: помнили
восприн: воспринят
ед: приносят
посвящ: посвящена
корзин: корзину
задума: шанс
приветствова: приветствовать
вин: вины вине
истор: историй заинтересуется истории история
еврейск: еврейского еврейских
ход: хода ходе
праздник: праздник праздника праздником празднику
конфиденциальн: политика
умер: распят
чуд: чудом
красн: яйцу поэтому либо красными
печальн: печально
закла: заклан
ягненок: ягненок
курин: куриными подарок
пришеств: пришествие
воспринят: угощение
обеща: царства
разда: раздают
позволя: позволяет
дне: дней днесь
дни: дни
дом: доме домах
способн: способности
известн: известный известно известных известные
послуж: послужил
наймушин: наймушин
доч: дочь
берут: игра
глубок: отходят
дня: дня
доб: добиться
пуст: подтекста
ид: идею
защищ: права
ил: илья
ин: иным иной предлагают
наш: дошло красят
религиозн: далекие несмотря
большинств: большинство
сил: силы силой
переня: народными
непост: непостившиеся
гроб: голгофой гроба
мяс: мясо
евген: евгений
информац: правовая
печ: печь
земн: земной
земл: землю воспринято земле
негативн: относятся
искуплен: искупления
никольск: никольский
невидим: понимали
берег: берега
крашен: крашенными крашеных крашеные руки
господн: господню господня гробом господне
тихон: тихона
вседовольств: вседовольства
иосиф: иосифа
спуст: спустился
ровн: ровно
двор: дворе
пес: песах
наказан: наказание
живущ: живущих
навод: наводить
размещен: материалы
спас: спасся
идет: знакомый
торжеств: торжества
понедельник: понедельник
предстоя: предстоящему
тьмы: тьмы
живут: живут
никола: николай
надежд: надеждой надежду
соответств: ответственности
библ: библии
настойчив: настойчивостью
освящен: освящения освящение
номинальн: номинально
священник: священниками священник господним священника
молчан: молчание
рождеств: католическим
ответствен: привлечены
вод: воды
федерац: российской
свеч: свечей
стран: нашей
вол: воли
пищ: пища пище
коринфян: коринфянам
побед: победы
римск: римской
душ: душе
страстн: страстная страстной страстную
прошел: прошел
столичн: культуре
отплат: отплатил
соверша: совершаются
обнаружен: владельца
ягненк: ягненка
исследовател: исследователи
уборк: уборку
сол: соли
нек: некое
владимир: владимир
красноярск: красноярского
небольш: небольшим
икон: иконами
относ: пекут священнослужители
погружа: погружает погружаются
интересн: сайт
рабств: рабство
гефсиманск: гефсиманском
все: всея всей
непосредствен: непосредственно
приобщ: приобщиться
раскрыва: раскрываем
чье: бьют
сюжет: сюжетов
бывш: тиберий
изначальн: отошло рисунки
спасител: спасителю спасителя месте
вечерн: вечерняя
моис: моисею моисее моисей
ри: риа
распят: распятие распятием
египт: египте
мослент: мослента
aa: aa
rss: rss
moslenta: moslenta
ctrl: ctrl
telegram: telegram
enter: enter
