рт: рт
говор: говорить
ру: ру
астраханск: астраханского
влиян: влияние
студентк: студентке
казан: казани
лед: лед
значен: значение
стат: статьи
учен: ученые
обычн: обычную
стар: старый старейших
стал: стала стало
памятник: памятниках памятника
дорог: дорога
соглас: согласилась
детеныш: детенышем детеныш детенышей
маленьк: маленьких маленького
северн: северной северного
ахмат: ахмат
появ: появятся появится появился
удал: удалить
дятлов: дятлова
центр: центра центр
петербург: петербургом
арт: артом
поб: побила
вернут: вернуться
прогулк: прогулка
вернул: вернулась
арх: архив
чечн: чечня
экономик: экономика
предел: пределами
пож: пожила
четверт: четвертой
пол: полем
сто: стоит
высад: высадят
манхэттен: манхэттене
мил: милого
белух: белух
перын: перынь
лет: летию летие
преврат: превратят
вольн: вольные
личност: личность
мобильн: мобильное
леопард: леопардов леопарда
структур: структуры
мужск: мужском
студент: студенты
гусят: гусята
показа: показал
забег: забег
назван: названия
осет: осетии
кабанчик: кабанчика
мир: мир мире
укол: уколов
силов: силовые
секретн: секретные
осен: осенью
тюменск: тюменский
кухн: кухни
екатеринбург: екатеринбурга
безопасн: безопаснее
этаж: этажа
туристическ: туристический
отмет: отметили
скор: скоро
нажм: нажмите
спектакл: спектакли спектакль
феврал: февраля
вперв: впервые
совместн: совместный
весн: весну
слабовидя: слабовидящих
кенгуренк: кенгуренка
новгород: новгороде
прототип: прототип
фронт: фронте
город: город городе городов города
документальн: документального
национальн: национальных национальной
декабр: декабря
рук: руками
украин: украине
гранат: гранатой
метр: метров
раскр: раскрыли
просыпа: просыпаться
детск: детский
выстав: выставил
россиянин: россиянин
обитател: обитателя
сосед: соседа
поселок: поселок
отел: отели
постро: построить
пластинк: пластинки
горнолыжн: горнолыжный
иркутск: иркутска
встреч: встреча
родин: родину
весен: весенние
уровен: уровень
нов: новый новые новой
ног: ноги
больш: больших большой
китайск: китайского
мест: месте места
подростков: подростковый
капсул: капсула
послан: посланиями
кочевник: кочевники
нарын: нарын
кин: кино
биеннал: биеннале
терешков: терешковой
фестивал: фестиваль
причудлив: причудливый
сдела: сделать
субботник: субботники
эффективн: эффективность
видет: видеть
деактивирова: деактивирована
редк: редких редкие редкую редкий
расшир: расширить
калининградск: калининградский
дают: дают
редакциярекламаконтактыпресс: редакциярекламаконтактыпресс
выставк: выставке выставка выставку
камн: камня
пут: путь
мурал: муралы
жизн: жизни
русск: русский русской
культов: культовых
импер: империя
тигр: тигров
языческ: языческим
излишк: излишками
ленивц: ленивце
самолет: самолет
сотн: сотни
окун: окунись
летн: летняя
зацвел: зацвела
приглас: пригласили
торгов: торговый
особняк: особняк
покор: покорила
перебра: перебралась
путешеств: путешествия
полуостров: полуострове
старин: старинную старинный
курс: курсы
сша: сша
лидер: лидер
протащ: протащил
групп: групп группа
молодеж: молодежь
сакральн: сакральное
техник: техника
утечк: утечке утечки
блинкоин: блинкоины
культур: культура культур
лесн: лесных лесного
дружб: дружба
удив: удивит
прозрачн: прозрачный
личн: личные
комфортн: комфортнее
живет: живет
заснежен: заснеженной
бесплатн: бесплатные
вылож: выложившего
современ: современного
врач: врач врачи
археолог: археологи
альметьевск: альметьевске
собач: собачьей
красив: красивые
урал: урале
чуваш: чувашии
уныл: унылое
анап: анапе анапой
обнаруж: обнаружили
крымск: крымском
празднова: праздновать
жител: житель жителей
документ: документы документов
будущ: будущего
открытк: открытках
театральн: театральный
альбинос: альбиноса
архыз: архыз
стату: статуи
выросл: выросла
пенсионер: пенсионер
пройдут: пройдут
музейн: музейно
ожив: оживить
собак: собак
дан: данные
сельскохозяйствен: сельскохозяйственные
установ: установили
спецпроект: спецпроекты
протяжен: протяженностью
раскрыт: раскрыты
гимн: гимн
росс: россии россия
народн: народный
фбр: фбр
заповедник: заповеднике заповедника
гиперзвуков: гиперзвуковой
четырех: четырех
кон: конный
мотор: мотор
бактер: бактерии
плод: плодов
кот: кота котов
ситуац: ситуацию
числен: численность
икр: икры
пожалова: пожаловать
канадск: канадских
деньг: деньги
белк: белки
шедевр: шедевра
вахтангов: вахтангова
старт: стартует
муз: музей музее
троп: тропа
очк: очков
лент: лента ленту
опечатк: опечатку
спасен: спасения
галер: галереи
оцен: оценили оценил
российск: российских российские российского российском российский
цветущ: цветущая
энтузиаст: энтузиастов
рыб: рыба
казанск: казанский казанском
хутын: хутынь
обнов: обновила
аквариум: аквариум
пятер: пятеро
увидет: увидеть
жил: жилье жилья
фрагмент: фрагмент
куниц: куницы
пушкин: пушкина
медиа: медианная
начнут: начнут
глубинк: глубинку
ссср: ссср
уклад: укладу
вулкан: вулканов
след: следам следуют
калининград: калининграде
ночн: ночная
луч: луч
жит: жить
кавказ: кавказа
попробова: попробовать
вулка: вулкана вулкан вулканы
общен: общение
москв: москвы москвой
перева: перевал
примор: приморье
срок: сроки
храм: храма
цельностекля: цельностеклянный
мощн: мощное
крылышек: крылышек
территор: территории
краснодарск: краснодарском
проведут: проведут
рассвет: рассвет
конкурс: конкурс
собира: собирать
космонавтик: космонавтики
госансамбл: госансамбль
кур: кур
святилищ: святилищам
древн: древний древнему древним
попа: попала попало
кита: китаем китае
посмотрет: посмотреть
спорт: спорт
выпа: выпавшую выпал
магнитогорск: магнитогорске
путешественник: путешественники
последн: последние
гамзатов: гамзатова гамзатове
башкир: башкирии
сам: самую самый самое самые самых
тигриц: тигрица тигрицу
захотел: захотели
жми: жми
вдохновен: вдохновением
геолог: геолога
дик: диких дикие
зон: зону
восстанов: восстановил
махачкал: махачкале
забронирова: забронировали
сбор: сбору
цирк: цирк
липов: липовую
поглоща: поглощающие
народ: народам народов
маслениц: масленицу
длин: длинную
вселюдиприродапутешествиятрадициинародыдостижениякультураистор: вселюдиприродапутешествиятрадициинародыдостижениякультураистория
раскопок: раскопок
переезжа: переезжают
голодн: голодных
главн: главное главной главная
полет: полета
действ: действующих
нашл: нашли
санатор: санатория
женщин: женщину
космос: космос
сакур: сакура
велик: великая
снег: снег
октябр: октября
век: веками веке
никол: никола
челябинск: челябинской
популярн: популярных
смертельн: смертельной
рад: ради
област: области
нацпарк: нацпарк
созда: создала создали создал
коричнев: коричневый
пентагон: пентагона
сво: своему своими свой
нижн: нижнем
нача: начали
станов: становится
откроют: откроют
интернет: интернет
необычн: необычной
го: го
волос: волоса
рекорд: рекорд
гу: гуся
парк: парк парках парке
татарск: татарского
вещ: вещи
стрит: стрит
пришл: пришлось
гид: гид
ягод: ягод
почтов: почтовых
спаст: спасти
представ: представят
зрител: зрителей
привлека: привлекает
алта: алтае
туризм: туризму
поеха: поехать
забыт: забытую
нейросет: нейросеть
ценност: ценности
спасл: спасли
пап: папа
кабардин: кабардино
владимирск: владимирской
видеоролик: видеороликов
искусств: искусства искусство
подтолкнул: подтолкнуло
театр: театр
кошек: кошек
гастрономическ: гастрономический
истор: историю история
числ: число
обуч: обучил
кинофестивал: кинофестиваль
трасс: трассу
праздник: праздник праздники
гагарин: гагарину
подозрева: подозреваемого
маршрут: маршрут
сем: семьи
цензур: цензура
выйт: выйти
представител: представителей
вид: вид
виде: видео
тюльпан: тюльпанов
ноябр: ноября
науч: научил
историческ: исторических
ягненок: ягненок
километр: километров
башкортостан: башкортостане
курин: куриных
курил: курилах
наук: наука
возрод: возродили
конск: конского
дом: дома
реш: решили решила
упряжк: упряжке
подопечн: подопечная
способн: способны
известн: известно
международн: международная
селедк: селедки
постав: поставили поставят
крым: крыму
обитан: обитания
недел: недели
браконьер: браконьеры
пройдет: пройдет
рек: реке
дню: дню
дня: дня
дагестан: дагестане
родн: родному
хорош: хорошие
стоимост: стоимость
культурн: культурный
свидан: свидание
сред: среда
республик: республики
сожжен: сожжение
сурикат: сурикатов
морд: мордой
посвящен: посвященное посвященный
полюб: полюбили
можеш: можешь
закат: закатов
кемеров: кемерово
похуден: похудения
светофор: светофоры
татарстан: татарстане
язык: язык языка
щеглец: щеглец
умн: умных
сил: сила
робот: робот
снял: сняли
зоопарк: зоопарка зоопарке
арестова: арестовало
боксер: боксера
хулиганск: хулиганские
разва: развал
мяс: мяса
нат: нато
информац: информация
курорт: курорт курорте
пеш: пеший
земл: земля
замет: заметили
дальневосточн: дальневосточных
посещен: посещения
ворон: ворона
россиян: россияне
керамик: керамика
зоопитомник: зоопитомник
лавандов: лавандовым
ко: ко
водохранилищ: водохранилища
черн: черной
младш: младшего
калуг: калуге
волк: волков
одн: одну
мам: мамой
продаж: продажу
глэмпинг: глэмпинг
волг: волге
живут: живут
миров: мировой
забот: забота
откроет: откроется
улиц: улиц улицах
карликов: карликовый
столиц: столица столице столицы
роман: роману
автокемпинг: автокемпинги
сми: сми
чест: честь
подземн: подземные
огромн: огромные
команд: командам
музык: музыки
ма: мае
апрел: апреля
стен: стены
познаком: познакомят
россиянк: россиянка
уникальн: уникальные уникальный
стран: страна
аренд: аренды
пятигорск: пятигорске
алл: аллею
свет: света
регион: региона регионе
громк: громкой
камчатк: камчатке камчатки
историк: историко
плетен: плетения
март: марта
испытан: испытании
войт: войти
еха: ехать
всероссийск: всероссийской
тон: тонный
медвед: медведи
лошад: лошадях лошадей
комплекс: комплекс
псков: пскове
владивосток: владивостоке
пешеходн: пешеходную пешеходная
крест: крест
валентин: валентины
соверша: совершать
поража: поражает поражают
белгородск: белгородской
скачк: скачки
поступк: поступки
болезн: болезни
ракет: ракеты
ярмарк: ярмарки
балкар: балкарии
прованс: прованс
бурят: бурятии
расул: расула расуле
новост: новости
амурск: амурской амурская
владимир: владимире
перв: первое первую
красноярск: красноярске
воспита: воспитал
икон: икон
фабрик: фабрику
адыг: адыгее
корм: кормили
майск: майские
миллионер: миллионеры
добр: добро добра
оо: ооо
каш: каши
брос: бросил
поворачива: поворачиваются
пепл: пеплом
старообрядц: старообрядцев
горшк: горшка
мейвезер: мейвезера
календар: календарь
опер: оперу
турист: туристов туриста
кал: калы
все: всей
препятств: препятствие
владикавказ: владикавказе
пораз: поразить поразит
преодолел: преодолели
меша: мешает
гриб: грибы
зубр: зубрят
медвежат: медвежат
накр: накрыло
круглогодичн: круглогодичный
выпуск: выпуска
род: родилось родились родила родился
пустын: пустыня
отремонтир: отремонтируют
бывш: бывший
реальн: реальный
покажут: покажут
нефт: нефть
рекордн: рекордное
рок: рок
ночева: ночевать
монастыр: монастыре
колес: колесах
высот: высоте
риск: риски
откр: открыл открыть открылась открыли
извержен: извержение
форм: формы
июн: июне
рыбак: рыбаков
достопримечательн: достопримечательностях
приамур: приамурье
кбр: кбр
калмык: калмыкии
форт: форт
озвучива: озвучивать
killnet: killnet
ctrl: ctrl
appl: apple
xxi: xxi
enter: enter
