встал: встал
ру: ру
говор: говорится говоря
оценк: оценкам
впоследств: впоследствии
понима: понимают понимаем
оттуд: оттуда
стат: статьи
маркетн: маркетным маркетного маркетный
экспорт: экспорта
обычн: обычную
европейск: европейские европейских европейской европейский европейского
стал: стали стала стало
планиру: планируем
чутк: чутко
объясн: объяснили
ниш: нишу
гуля: гуляют
работ: работы
заход: заходим заходят
завис: зависит
центр: центров центр центры
именит: именитых
йорк: йорке
арх: архив
экономик: экономика
правов: правовой
пандем: пандемия
торговл: торговли
пол: поле
размеща: размещали размещались
манхэттен: манхэттене
улочк: улочкам
бейогл: бейоглу
торгова: торговали
макияж: макияжа
франчайзинг: франчайзинг
выкуп: выкупила
присутств: присутствия присутствии
структур: структуры
мужск: мужской
карт: карты
тц: тц
подел: поделиться
челночничеств: челночничества
назван: названия
котор: котором
владелец: владелец
времен: временем
провест: провести
пор: порах
силов: силовые
секретн: секретные
запад: западом
шаг: шаг
прав: правило права
регистрирова: регистрировать
проект: проекты
ушл: ушли
весн: весной
относительн: относительно
дела: делаешь
одева: одевать одеваться
истиклял: истикляль
поездок: поездок
врем: времена
адидас: адидасов
лин: линии линия
россиянин: россиянин
рубл: рубль
сосед: соседа
занима: занимает
лиц: лицо
нов: новые новыми новой
теракт: теракта
придума: придуманного
ног: ноги
противопожарн: противопожарные
почувствова: почувствовал
женск: женской
част: часть части частью
совладельц: совладельцев
традицион: традиционно
подделк: подделками
сдела: сделали
подделыва: подделывают
деактивирова: деактивирована
сложн: сложной сложно сложнее
состоятельн: состоятельные
пут: путей
нос: носил
активн: активно активными
отчетлив: отчетливо
деним: денимом
распростран: распространено
расположен: расположенная расположенный
систем: системы
контрафактн: контрафактными
выход: выходить выход выходе
самолет: самолет
вкладыва: вкладываться вкладывали
подстраива: подстраиваться
окуп: окупиться
дяд: дядя
летн: летней
отмеча: отмечают
торгов: торговые торговых торговый
путешеств: путешествия
сша: сша
лидер: лидер
экзотик: экзотикой
перекупщик: перекупщики
техник: техника
выпуска: выпускаемые выпускали выпускающие
европ: европе европой европу
постепен: постепенно
достойн: достойный
хотел: хотели
терзиогл: терзиоглу
культур: культура
прозрачн: прозрачно
лнр: лнр
помога: помогающей
рынк: рынках рынке рынки
нрав: нравится
помощ: помощью
современ: современные
врач: врач
климат: климата
огорч: огорчил
будущ: будущее
желан: желание
прекрат: прекратил
фэшн: фэшн
новоприб: новоприбывшим
самовыражен: самовыражения
сын: сына сын
нул: нуля
конкуренц: конкуренция
инвестиц: инвестиции
средств: средства
придумыва: придумываю
отделен: отделения
спецпроект: спецпроекты
плох: плохо
ассоциирова: ассоциировался
рост: роста
росс: россии россия россией россию
фбр: фбр
мотор: мотор
ситуац: ситуацию
фирм: фирмы фирм
ребрендинг: ребрендинг
счита: считать считает считают
отсутств: отсутствует
причин: причин
архитектурн: архитектурного
цен: цены цену цена
лент: лента ленту
изуча: изучать
кажд: каждом
опечатк: опечатку
российск: российских российские российском российской российскую российским российское российский
политическ: политические политической
люксов: люксовые люксовом люксовых
искусствен: искусственного
кабальн: кабальные
идут: идут
антал: антальи
иностра: иностранным иностранные иностранного
всяк: всяком
сегмент: сегмента сегмент сегментом
частност: частности
серьезн: серьезные
прибыл: прибыль
юн: юных
достаточн: достаточно
отечествен: отечественном отечественному
ткан: ткани
слеп: слепо слепом
челнок: челноки
импорт: импорте
сказа: сказались
ссср: ссср
знаком: знакомого знакомы
строг: строго
институт: института
знаков: знаковые
концепт: концепты
дизайн: дизайна
концепц: концепцией
отслежива: отслеживать
мебел: мебель
так: такую таких
событ: события
оптимальн: оптимальным
ретейл: ретейл
блогерш: блогерши
назва: назвал
головн: головном головного
товар: товаром товаров
собира: собирается
турк: турки
обсуд: обсудить
некотор: некоторый
потенциальн: потенциальные
стамбульск: стамбульской стамбульский
увлека: увлекаются
остава: оставаться
пересечен: пересечении
спорт: спорт
обсто: обстоит
зна: зная
услов: условия
объем: объемами
стро: строить строишь
закр: закрылась
зон: зонах
приход: приходится
джевахир: джевахир
железн: железный
компан: компаниям компаниями компания компаний компании
рассказыва: рассказывает
программ: программе
главн: главное главным
разбира: разбиралась
фамил: фамилиям
бутик: бутики
низк: низкого
фальшив: фальшивых
элемент: элементы
рад: рады ради
бедн: бедным
визуальн: визуально
агентств: агентства
магазин: магазинами магазин магазины магазинов
арендн: арендные
жалел: жалел
интернет: интернет
нью: нью
оригинальн: оригинального
основател: основателя основателей
официальн: официально
брендинг: брендинг
пришл: пришли пришлось
полн: полными
знат: знать
десят: десяти
определя: определяют
знал: знали знал
конкурирова: конкурировать
сильн: сильно
работа: работают работали работать
оптимистичн: оптимистично
нанесен: нанесения
заинтересова: заинтересованы
числ: число числе
посол: посол
логотип: логотипами
подозрева: подозреваемого
франшиз: франшизы
кризис: кризис
вниман: внимание
сотруднича: сотрудничать
стесня: стесняемся
понес: понес
курортн: курортных
виде: видео
подход: подходят
дойт: дойти
быстр: быстро
эксперт: эксперта
краснодар: краснодаре
эмил: эмиль
бизнес: бизнесом бизнеса бизнесе бизнес
однообразн: однообразные
выручк: выручка
нишев: нишевые
международн: международный международные
сбил: сбили
пригожин: пригожин
честн: честный
обитан: обитания
реж: режим
поддержива: поддерживают
египетск: египетский
демократичн: демократичные
ассортимент: ассортимента
сред: среда
мног: многого многих многие
разнообразн: разнообразно
средиземноморск: средиземноморское
похуден: похудения
гранд: гранд
импортер: импортеры
язык: язык
заглянут: заглянуть
фот: фото
разн: разной разных разный
разв: развит
трикотаж: трикотаж
производител: производители производителей
набит: набитые
год: годами
открыва: открывать
ставк: ставки
квадратн: квадратных
вероник: вероника
рассужда: рассуждает
ближ: ближе
производств: производстве производством
знает: знает
привоз: привозили
одн: одна одну одним
продаж: продажу
гудков: гудкова
широк: широко
маркет: маркет маркета
произнест: произнести
настольк: настолько
откроет: откроется
улиц: улица улице улиц
избалова: избалованный
потребн: потребность
масс: масс
одинаков: одинаковыми
акджаносновател: акджаноснователь
расширя: расширяться
сравнительн: сравнительно
текстильн: текстильных
итал: италии
выпускниц: выпускница
апрел: апреля
врод: вроде
десятк: десятка
запрос: запросить запросы
регион: регионах
поскольк: поскольку
испытан: испытании
войт: войти
спровоцирова: спровоцировал
еха: ехали
ценов: ценового
марк: марки марка марками маркам марку маркой
состав: составила
пешеходн: пешеходных
поступа: поступают
болезн: болезни
ракет: ракеты
ажиотаж: ажиотаж
вполн: вполне
университет: университет
новост: новости
перв: первых первыми
комментир: комментирует
фабрик: фабриках фабрик
добр: добро добра
кельвин: кельвин
отшива: отшивали
запомн: запомнить
планир: планируют планируется
занавес: занавес
как: какие каким какого
турист: туристы
трц: трц
окупа: окупались
переговор: переговоры
освобод: освободившуюся
прошл: прошлое
высок: высокого высокие
эришмишглав: эришмишглава
этикетк: этикетками этикетки
реальн: реальный
риск: рискуют
дешев: дешево
точк: точки
сфер: сфера
завоевыва: завоевывать
столетн: столетней
одежд: одежда одеждой одежды одежду
мех: меха
рекоменд: рекомендую
обрат: обратил
хлынул: хлынули
чувствова: чувствовал
люкс: люксе люкс
приближ: приближен
влиян: влияние
студентк: студентке
образ: образом
конц: конце
предлага: предлагают
появ: появился
случа: случае
удал: удалить
петербург: петербурга петербурге
практическ: практически
вернут: вернуться
наряд: наряду
отцовск: отцовское отцовские отцовских
предел: пределы
санкц: санкции
вообщ: вообще
единствен: единственного
концептуальн: концептуальные
премиум: премиум
ожида: ожидать ожидаем
личност: личность
санкт: санкт
дава: давать
экс: экс
х: х
навея: навеяны
поэт: поэтому
ассоциир: ассоциируют
опустевш: опустевшие
мир: мир
укол: уколов
предприят: предприятий
рассчитыва: рассчитывают рассчитывать
бум: бум
обсужда: обсуждают
знают: знают
внешност: внешности
вагнер: вагнер
обрадова: обрадовал
девушк: девушки
скор: скорее
нажм: нажмите
столкнут: столкнуться
аналог: аналог
получ: получила
модн: модного модные модных
французск: французские
вложен: вложения
фронт: фронте
важн: важнее
провел: провела
город: городов городе
национальн: национальными
экономическ: экономической
рук: руки
украин: украине
гранат: гранатой
метр: метров
отец: отец
раскр: раскрыли
шанс: шанс шансы шансов
выстав: выставил
бода: бодаться
площад: площади
индустр: индустрии индустрия
могл: могли
ярк: ярко яркое
дешевл: дешевле
кстат: кстати
больш: большая
китайск: китайским китайской
комсомольск: комсомольской
иде: идея
счет: счет
офис: офиса офис офисе
вход: вход
направлен: направлении направлений направление
пристальн: пристальнее
кузен: кузенов
эффективн: эффективность эффективную
видет: видеть
редакциярекламаконтактыпресс: редакциярекламаконтактыпресс
этник: этникой
жизн: жизни
зашедш: зашедшей
чвк: чвк
отд: отдых
мод: моды
сотн: сотнями
спортивн: спортивные спортивных
развива: развивать
основн: основных основном
идейн: идейных
бренд: брендами бренд бренды брендам брендом брендов бренда
премиальн: премиальный премиального премиальной премиальные
учредител: учредитель
неплох: неплохие
скрыва: скрывает
своеобразн: своеобразный
утечк: утечке утечки
дефиц: дефицит
полиэстер: полиэстера
владельц: владельцы владельца
закупа: закупает закупали
удив: удивились
консалтингов: консалтинговыми консалтинговой
средн: среднего
личн: личные
нужн: нужном
частник: частники
советск: советский советские советских
отц: отца отцы
ушедш: ушедших
секрет: секрет
дуба: дубай
вылож: выложившего
реконцепт: реконцепт
космополитичн: космополитичны
турецк: турецкие турецких турецкой турецкий турецком турецкая турецким турецкими
красив: красивые
опыт: опытом
рынок: рынок
джинс: джинсы
документ: документы документов
пратт: пратта
соображен: соображений
приезж: приезжая
бена: бенан
дан: данные
фейк: фейки
лимитирова: лимитированные
дизайнер: дизайнер
раскрыт: раскрыты
кляйн: кляйнов
кож: кожи
дефицит: дефицита
гиперзвуков: гиперзвуковой
спонта: спонтанно
всестильвнешн: всестильвнешний
нежелательн: нежелательно
пожалова: пожаловать
федоренк: федоренко
брат: братьев братья
пошел: пошел
очк: очков
ошиба: ошибаться
галер: галереи
границ: границу
оцен: оценили оценил
сохран: сохранили
восток: востоком
политик: политики политика политику политике
минимум: минимум
уход: уход ухода
финансов: финансовые
ошибк: ошибке
покупа: покупают
тупик: тупик
обнов: обновила
жил: жилья
марок: марок
начал: начале
заня: занять
эришмиш: эришмиш
наступлен: наступлении
медиа: медианная
освещен: освещение
инфлюэнсер: инфлюэнсеры
коллекц: коллекции
ориентирова: ориентирована
итог: итоге
дел: дело делится
вопрос: вопрос
ден: деним
рассказа: рассказать
игра: играют играю
ваш: вашей
никт: никто
москв: москвы москве
полност: полностью
несмотр: несмотря
джинсов: джинсовые
покупк: покупку
срок: сроки
собствен: собственной собственную собственные собственных собственный
унаслед: унаследую
ручн: ручной
эвиндар: эвиндар
измен: изменив
держа: держался
понрав: понравившегося
британск: британские
преследован: преследованием
существован: существование
раст: расти
драйвер: драйвер
бизнесм: бизнесмены
август: августу
этническ: этническое
материал: материалов материалами
отношен: отношениях
куп: купить
турц: турции турция
кварта: квартал
кита: китаем китай
район: районе
мысл: мыслями
босфор: босфора
последн: последние последний
синтетическ: синтетической
турок: турок
сам: самое самых
качествен: качественный
захотел: захотел
жми: жми
перепродава: перепродавались
потребител: потребители потребитель потребителей
школ: школы
называ: назывались называется называемые называют
фейков: фейковыми
управлен: управление
ира: иран
нашл: нашли
женщин: женщины
начина: начинал
стандарт: стандартами
западн: западных
популярн: популярными популярных популярные
мотив: мотивами
смертельн: смертельной
административн: административным
цвет: цветами
пентагон: пентагона
сво: своими свой
текстил: текстиль текстиля
замеча: замечали
перспектив: перспективы
россия: россиян
значительн: значительно
парт: партии
прода: продающие
рекорд: рекорд
вещ: вещи вещей
стрит: стрит
развит: развитии развития
уголовн: уголовным
владеет: владеет
видявленияроскошьличн: видявленияроскошьличности
сайт: сайтах
выруч: выручили
оруджл: оруджлу
уничтожен: уничтоженных
оборудован: оборудование
точек: точек
зеленск: зеленского
трех: трех
клеенчат: клеенчатые
пал: пал
ценност: ценности
вещев: вещевых
перейт: перейти
стесн: стесняясь
истор: историей история
ход: ходят
зрен: зрения
тепл: теплого
легч: легче
зрел: зрелые
натуральн: натуральные натуральных
сер: серые
представител: представители представитель представителей
сет: сеть сети
кадир: кадир
мастер: мастер
ищут: ищут
нескольк: несколькими нескольких
реальност: реальности
договор: договоров
наук: наука
стрем: стремятся
мост: мост
хоч: хочу
сумк: сумками сумки
дом: домов
способн: способны
покупател: покупателю покупатель покупателям
известн: известно известными известных известные
сторон: стороне стороны
смотр: смотрят
остальн: остальное
костюм: костюм
тысяч: тысячи
доб: добиться
хорош: хорошие
двоюродн: двоюродные
стоимост: стоимостью стоимость
пуст: пустующие
ид: идею
базар: базар
оборот: обороты
им: имена
наш: нашей
итальянск: итальянские
успешн: успешно
сил: сил силу
заказ: заказы
экоповестк: экоповестку
умн: умных
трансформер: трансформеры
молодежн: молодежная
план: планами
доллар: долларов
арестова: арестовало
холдинг: холдинга холдинги
нат: нато
шопинг: шопинг шопинга
информац: информация
обрета: обретаешь
сопоставим: сопоставимую
лукбук: лукбук
трат: тратиться
берег: берегов
россиян: россияне
спуст: спустя
совладелиц: совладелица
хуж: хуже
бодрум: бодрума
например: например
акджа: акджан
стамбул: стамбуле
забот: забота
ориенталистск: ориенталистской
маскирова: маскировать
соответств: соответствии
польш: польше
восприня: воспринять
шоурум: шоурумах
соотношен: соотношением
сми: сми
огромн: огромные
лад: лад
музык: музыки
познаком: познакомить познакомиться
союз: союз
стран: странах стране страны
аренд: аренды
отлич: отличие
уровн: уровня уровню
мо: моих
громк: громкой
местн: местный местные
качеств: качества качество
предпринимател: предприниматели предпринимателями
проблем: проблемы проблемами проблема
соверша: совершать
баланс: балансе
заяв: заявили
владимир: владимир
лучш: лучшее
узнаваем: узнаваемость
управля: управлявшая
небольш: небольшие небольшом
умеют: умеют
корн: корнями корней
крайн: крайне
пойдет: пойдет
оо: ооо
возможн: возможность возможно
интересн: интересно
всу: всу
молод: молодыми
выбра: выбрали
открыт: открытия открытии открытие
брос: бросил
буквальн: буквально
наследств: наследству
сердц: сердца
хочет: хочет
крупн: крупные
соч: сочи
ориентир: ориентируется
принадлеж: принадлежит
бойц: бойцов
растет: растет
выпуск: выпуска
бывш: бывший
портфол: портфолио
изначальн: изначально
обрел: обрели
держат: держат
экспанс: экспансию
вечерн: вечерних вечерняя
откр: открыли открыла открыть
экспортер: экспортерами
миллион: миллиона
ри: риа
наход: находилось находились
аксессуар: аксессуарами аксессуаров
резон: резонно
потер: потери
погиб: погиб
бижутер: бижутерия
каков: каковы
seasand: seasand
colin: colin
beg: beg
luxuri: luxury
erhan: erhan
hold: holding
getti: getty
selmacilek: selmacilek
globalg: globalgate
demirta: demirtas
enter: enter
waikiki: waikiki
group: group
uniqlo: uniqlo
bloomberg: bloomberg
adida: adidas
island: island
adl: adl
vakko: vakko
inditex: inditex
gizia: gizia
vuitton: vuitton
zara: zara
chanel: chanel
fusion: fusion
maraton: maraton
gucci: gucci
ihkib: ihkib
rr: rrs
sportwear: sportwear
ctrl: ctrl
appl: apple
zupcev: zupcevic
cebir: cebir
orka: orka
topshop: topshop
expo: expo
loui: louis
giyim: giyim
climber: climber
damat: damat
tween: tween
fast: fast
killnet: killnet
mavi: mavi
qimu: qimu
perspect: perspective
lc: lc
koton: koton
vakkorama: vakkorama
khan: khan
ferhat: ferhat
imag: images
river: river
kubra: kubra
fashion: fashion
