говор: говоря
драйв: драйв
тридца: тридцать
велосипед: велосипедами
понима: понимаем
экспериментальн: экспериментального
сравн: сравнил
стат: стать
оказа: оказалось оказался оказаться
имитир: имитируют
мыслен: мысленно
стал: стало
правот: правоту
реализова: реализовано
обошел: обошел
работ: работы работах
центр: центром
омологацион: омологационную
рекламн: рекламные
просторн: просторный
правов: правовая
привлеч: привлечены
сто: стоя стоит
пробег: пробегом
лет: летие
арк: арки
самодостаточн: самодостаточное
структур: структура
студент: студенты
переосмысл: переосмыслил
макс: максом
двухлитров: двухлитровой
затрепета: затрепетало
многофункциональн: многофункциональным многофункциональный многофункциональность
запас: запас
благодар: благодаря
котор: которое
силов: силовая
эксперимент: эксперимент
стоков: стоковый
прав: права
спортуниверса: спортуниверсал
веск: веское
либ: либо
проект: проектов
мягковат: мягковат
подарок: подарок
комфортабельн: комфортабельный
читальн: читальный
некогд: некогда
центральн: центральных
каноничн: каноничный
призрачн: призрачный
багажник: багажника багажник
самоделк: самоделкой
лин: линии
зал: зал
изготавлива: изготавливали
занима: занимался занимали занимает занималась
свободн: свободное
заинтригова: заинтриговал
лиц: лица
разумеет: разумеется
очевидн: очевидно
выжима: выжимал
нов: новый новому
рэймонд: рэймонду
нож: нож
приговор: приговор
игрушечн: игрушечный
част: часть части
поршевск: поршевских
наклон: наклона
традицион: традиционным традиционном
слож: сложа
устро: устроился
слов: слова слово
завод: заводе
определен: определенно
сдела: сделала
рожден: рождение
стационарн: стационарные
судьб: судьба судьбе
капот: капоте
фургончик: фургончик
трансмиссион: трансмиссионным
пример: пример
фигурир: фигурирует
расположен: расположением
дружелюб: дружелюбен
природ: природе
немц: немца
строительств: строительством
выход: выхода
прида: придает
отмеча: отмечает
крейсер: крейсер
сожален: сожалению
читател: читателей
облада: обладал
ресурс: ресурсах
машин: машину машины машина
экзотик: экзотикой
пуска: пускать
хотел: хотел
турер: турера турер
шикарн: шикарный
агрегат: агрегат
рынк: рынка
неизвестн: неизвестные неизвестном
материа: материал
выступ: выступил
завален: заваленными
безупречн: безупречном
лос: лос
боков: боковых
промышлен: промышленного
текст: текст
наоборот: наоборот
извилист: извилистых
вертикальн: вертикально
напечата: напечатал
оппозитн: оппозитной
фар: фар
почетн: почетное
тоннел: тоннелем
нул: нуля
брошюр: брошюры
лоу: лоуи
лангенбург: лангенбурга
гипотетическ: гипотетический
отключ: отключить
спецпроект: спецпроекты
шин: шин
съеда: съедающими
легендарн: легендарным
универсал: универсалы универсалами универсалом
мотор: мотора мотор
автомобил: автомобиль автомобилей
фирм: фирму фирме фирма
гигант: гиганта
счита: считать
цел: целях
выдвижн: выдвижных
субкультур: субкультура
отлича: отличающегося
разработок: разработок
шутинг: шутинг
опечатк: опечатку
винегрет: винегретом
российск: российской
анджелесск: анджелесских
взаимодейств: взаимодействия
отнюд: отнюдь
слепл: слеплен
директор: директором директора
коммерческ: коммерческих
отличн: отлично
параллельн: параллельно
бисембин: бисембин
страшилищ: страшилище
кажущ: кажущихся
туринск: туринскими
перекройк: перекройки
юн: юных
достаточн: достаточно
знаком: знакомил
мастерск: мастерская
сара: сарай
чудес: чудес
выдел: выделите
напомн: напомним
дизайн: дизайна
ател: ателье
сконструирова: сконструированный
яс: ясен
коротк: коротко
зелен: зеленый
мебел: мебелью
неказист: неказистый
так: таких таки
отыщ: отыщи
воздушн: воздушного
письмен: письменного
разов: разовой
недавн: недавних
переделк: переделка переделку
редакц: редакции редакция
баз: базе базы
условн: условностям
хран: хранится
мощн: мощный
передела: переделан
стойк: стойками
заметн: заметно
грузн: грузным
двадцат: двадцати
висконсин: висконсин
обсуд: обсудить
обернул: обернулся
покорн: покорны
прожектор: прожекторы
удивительн: удивительный удивительной
количеств: количество
гер: герой
транспорт: транспорт
услов: условия
объем: объема объемом
скаж: скажем
стереотип: стереотипам
стро: строившее строил
метаморфоз: метаморфозам
колесн: колесные
приход: приходят
листа: листай
поня: понял
ферр: ферри
компан: компании
ограничен: ограниченным
получа: получают получать
переодет: переодетый
действ: действующим
поклонник: поклонниками
пят: пяти
фонар: фонари фонарям
состоян: состоянии состояние
стоя: стояли
голуб: голубой
созда: созданный
передач: передач
сохранен: сохраненному
конструкц: конструкции
необычн: необычной
интернет: интернет
прослав: прославилась
тег: теги
оригинальн: оригинальный
привычн: привычном
официальн: официальное
полн: полная полное полным
спинок: спинок
зерка: зеркал
аплодирова: аплодировать
десят: десяти
фургон: фургона
штат: штата штат штаты
поставл: поставлена
рамк: рамках
жесткост: жесткости
позаимствова: позаимствованы
сотрудник: сотрудники
среднемоторн: среднемоторная
сильн: сильной сильный
детал: деталей
работа: работал
услуг: услугам
телефон: телефон
интерьер: интерьера
подходя: подходящего подходящей
числ: числе
модификац: модификации
трасс: трасс
логотип: логотип
модел: модели
сотруднича: сотрудничал
одобр: одобрить
форсирова: форсирован
автор: автор автора
восьм: восьми
очеред: очередь
виде: видео
подход: подходил
пойд: пойди
попада: попадалось
разрешен: разрешения
партн: партн
километр: километров
оста: осталось
быстр: быстрый
панамер: панамеры
виновн: виновные
задн: заднего задними задних задние задней
разреш: разрешено
тих: тихо
прочност: прочности
удобств: удобства
реш: решил решило
лаборатор: лаборатория
генеральн: генерального
общ: общее
объ: объем
противореча: противоречащее
сравним: сравнимый
сознательн: сознательном
вариац: вариации
тестов: тестовых
отдален: отдаленных
альбрехт: альбрехт
мног: многих
импортер: импортером
фон: фон
останов: остановиться
нарисова: нарисовал
фот: фото
гюнтер: гюнтера гюнтер
стил: стиль
поразительн: поразительных
разн: разных
содержим: содержимое
планет: планеты
ставш: ставших
образн: образная
производител: производитель производителя
год: годом
открыва: открывающие
законодательств: законодательством
особ: особым особых особое
клюшк: клюшки
одн: одно одном одни одних
продаж: продажу
вираж: вираж
металлик: металлик
неутешительн: неутешительный
реклам: рекламы рекламу
гамм: гаммы
стеф: стеф
петл: петлях
подарк: подарка
кожан: кожаные
экземпляр: экземпляр
подня: подняв
апрел: апреля
пристро: пристроил
багажн: багажный багажным
беннетт: беннетт
уникальн: уникальной
участ: участием
использован: использования
задолг: задолго
войн: война
нечт: нечто
глав: главе
глаз: глазах
арсена: арсенала
артц: артца артц
совпа: совпало
тираж: тиражом
жела: желающим желающие
вполн: вполне
боб: боб
новост: новости
существ: существующих
перв: первого первую
седок: седоков
треков: трекового
приня: принять
нефтегазов: нефтегазового
состряпа: состряпать
плачевн: плачевное
основ: основой
ушел: ушел
исполнен: исполнения
калитк: калитки
как: какого
подкапотн: подкапотного
герман: германии
великолепн: великолепных
фердинанд: фердинанду
рассматрива: рассматривался
ров: ров
род: роде родов
рол: роли роль
точн: точнее
предвосхищ: предвосхищая
точк: точки точка
установлен: установленной
апгрейд: апгрейдам
псевдоуниверса: псевдоуниверсал
продукт: продуктом
распахива: распахиваются
найт: найти
готов: готовы
охлажден: охлаждения
влиян: влияние
успел: успел
образ: образом образе
герц: герц
учет: учет
дорог: дорогие
тюнинг: тюнинг
поспор: поспорить
предлага: предлагать
линейк: линейки
маленьк: маленькие
обзор: обзоре
случа: случае
частичн: частичное
четверк: четверкой
доступ: доступ
преда: преданы
предел: пределах
грем: гремят
мил: милю
вообщ: вообще
джон: джоном джон джона
единствен: единственный
л: л
основательн: основательно
вместительн: вместительным
скромн: скромный
комб: комби
х: х
диксон: диксоном диксон диксона
показа: показаться
сообщ: сообщила
двер: дверью дверей
мин: мин
вариант: варианте
мир: мире
усмотрел: усмотрел
писа: писал
репортаж: репортаж
внешност: внешностью
маслкар: маслкара
скор: скорее
нажм: нажмите
джентльм: джентльмен
классическ: классический
получ: получился
ноздр: ноздрей
прототип: прототипе прототип
публик: публику
шутц: шутца
замысл: замыслу
образчик: образчиков
рук: руки рук руку
брейк: брейков брейк брейку брейка брейки
рул: руля
выпущен: выпущенную
электрорегулировк: электрорегулировками
шанс: шанс
издан: издания издание
выстав: выставила
нарядн: нарядная
движен: движения
действительн: действительности
нарушен: нарушений
кстат: кстати
потенциа: потенциал
мест: место местами
начин: начиная
иде: идея
спрашива: спрашиваете
вход: входа
направлен: направлении направления
асатур: асатур
пятилитров: пятилитровым
полезн: полезного
попаст: попасть
шрадер: шрадер
бесспорн: бесспорно
гран: гран
испытыва: испытывала
представлен: представлениям
фольксваген: фольксвагеном
литров: литровой
видел: виделся
выдумщик: выдумщика
жизн: жизни
забвен: забвению
окраш: окрашены
навс: навсего
подопытн: подопытного
пыта: пыталась
спортивн: спортивных спортивно спортивного
момент: момент
вольнодумц: вольнодумцы
идейн: идейный
заворачива: заворачивал
зашорен: зашоренным
крышк: крышкой
отб: отбыл
подготов: подготовила
решен: решение
дефиц: дефицит
владельц: владельцу владельцем владельца
биограф: биографией
шасс: шасси
комментирова: комментировать
провод: проводил
племен: племени
аккуратн: аккуратной
меня: менять
слайд: слайд
восьмерк: восьмерка
спорткар: спорткар спорткары спорткаров
результат: результат результатом
банковск: банковском
полож: положил
любв: любви
франкенштейн: франкенштейнов
благообразн: благообразного
дал: дал
глуш: глуши
пониман: понимании
предсерийн: предсерийного
карма: карман
предок: предок
эпохальн: эпохальный
фотоаппарат: фотоаппаратами
поверх: поверх
ключ: ключи
дан: данном данным
весьм: весьма
дизайнер: дизайнер
разделя: разделяем
пульс: пульс
состоя: состоявшийся
переднемоторн: переднемоторного
кож: кожей
воодушевля: воодушевляться
креативщик: креативщика
подвергл: подверглись
надстройк: надстройке
пошел: пошел
построен: построенный
муз: музее
старт: старт
гольф: гольфа
огай: огайо
двухдверн: двухдверный
возраст: возрасты возрасте
оцен: оценил
колпак: колпаке
политик: политика
вмест: вместо вместе
уход: уходом
увиден: увиденного
отсек: отсеком отсек
разработк: разработки
литр: литра
кабриолет: кабриолет
постановк: постановку
восьмицилиндров: восьмицилиндрового
заня: занял
поколен: поколения
бюр: бюро
техосмотр: техосмотр
коллекц: коллекцию
произошл: произошло
практичн: практичного
итог: итог
постройк: постройкой
вписа: вписались
дел: дело деле
вопрос: вопросы
студ: студии
внутрен: внутренний внутренняя
размер: размера
элегантн: элегантное
порш: порше
двигател: двигателя двигатель двигателем
ответ: ответим
содрогнут: содрогнуться
турбокомпрессор: турбокомпрессором
пространств: пространства
несмотр: несмотря
семейн: семейный
творческ: творческий
собствен: собственную собственного
копирован: копирование
адаптирова: адаптировали
красот: красоте
японск: японской
позад: позади
расширен: расширенный расширенные
материал: материалов
поднима: поднимается
заканчив: заканчивая
красавц: красавца
смел: смелые
куп: купе
механическ: механической
экипаж: экипажа
мысл: мысли
ряд: ряд
последн: последнем последней последних
манер: манер
месяц: месяцев
воздухозаборник: воздухозаборника
сам: самое самых
куз: кузов
детализац: детализация
жанр: жанра
инач: иначе
организова: организовал
заряжен: заряженный
неожида: неожиданное
нашл: нашли
передн: передних передняя передним
смысл: смысле
ганновер: ганновере
заключа: заключается
расстоян: расстояния
вс: вс
обивк: обивка
голландск: голландская
стоек: стоек
элементарн: элементарно
ложемент: ложементы
заднемоторн: заднемоторный
уеха: уехал
кампан: кампанию
сво: своем своим
нача: начало
жалк: жалко
порог: пороги
станов: становятся
браницк: браницки
кузовщик: кузовщикам
тест: тест
кручен: кручение
явля: являлся
появлен: появлением
законч: закончилась закончилось
благородств: благородство
заводск: заводским заводскими заводской
представ: представить
культ: культу
сайт: сайта
рельеф: рельефу
колледж: колледж
сег: сего
трет: третьей
недюжин: недюжинный
подойдет: подойдет
задума: задуман
истор: история
зрен: зрения
гонк: гонках
пробл: проблем
ещ: ещ
селектор: селектор
презрен: презрением
сем: семья
универса: универсала
сер: серо серию
вид: вида
представител: представитель
конфиденциальн: конфиденциальности
штатовск: штатовское
умен: умением
заставля: заставляет
красн: красной
одобрен: одобрение
самородк: самородка
восьмидесят: восьмидесятые
прозвищ: прозвищу
хот: хот
эстетич: эстетичен
хоч: хочу
сумк: сумки
дни: дни
крыш: крышу крыши
кастомайзинг: кастомайзинга
символичн: символичным
крыл: крыльев крылья
очарован: очарование
обойт: обойтись
пута: путать
приземист: приземистое
предостав: предоставите
босс: боссу
тогдашн: тогдашнего
родн: родной
хорош: хорошем хорошая
библиотек: библиотека
мирск: мирском
ид: идеи
защищ: защищены
вынослив: выносливость
им: имена
творен: творений
темн: темный
подрос: подрос
беспредельщик: беспредельщика
полюб: полюбуйтесь
попыток: попыток
впечатля: впечатляет
хайнц: хайнц
обяза: обязан
несметн: несметное
доллар: долларов
петер: петера
оперативн: оперативно
архивн: архивных
первоначальн: первоначально
информац: информация информации
салон: салоне салон
грузопассажирск: грузопассажирские грузопассажирский
выгляд: выглядит
спуст: спустя
дополнен: дополнения
полюс: полюсах
имитац: имитацией
мойщик: мойщиком
испыта: испытала
берет: берет
размещен: размещение
черн: черный
очерк: очерков
стилистическ: стилистической
увеличен: увеличении
запуст: запустил
родстер: родстер
соответств: соответствии
акц: акцией
автосалон: автосалона
лад: лад
номинальн: номинальными
вставш: вставший
ответствен: ответственности
зажигалк: зажигалки
федерац: федерации
воз: возили
мощност: мощностью
спорткуп: спорткупе
мм: мм
стекл: стекло
компоновк: компоновка
сиден: сидений
тщетн: тщетных
страстн: страстными
сидел: сидела
исходн: исходный
качеств: качестве качество
разделен: разделенные
хоффман: хоффманом
комплект: комплектов
аукцион: аукциона
утрат: утратил
обнаружен: обнаружения
подъемн: подъемное
раздел: разделены
обтянут: обтянутый
скажут: скажут
сок: соки
авиацион: авиационном
нетривиальн: нетривиальным
лучш: лучших
панельн: панельный
управля: управляющим
гневн: гневные
интересн: интересно интересное интересного
дальн: дальнейшем
навест: навести
ос: осями
гертц: гертц
вайсах: вайсахе
американск: американского американским
коробк: коробкой коробки
выбра: выбрал
уголк: уголках
буквальн: буквально
кузов: кузовом кузова
сердц: сердце
функциональн: функциональность
все: всей
крут: крутые
тематическ: тематического тематических
выпуск: выпуска
портфол: портфолио
пламен: пламенем
взглян: взгляните
дожива: доживал
гараж: гаражей
колер: колер
выкат: выкатила
стандартн: стандартного
наход: находятся
датир: датируется
никак: никак
kombi: kombi
turbo: turbo
hogeschool: hogeschool
american: american
dp: dp
bmw: bmw
audi: audi
porsch: porsche
shoot: shooting
enter: enter
volkswagen: volkswagen
cargo: cargo
aa: aa
van: van
avanti: avanti
lynx: lynx
ferrari: ferrari
prototyp: prototype
develop: development
fonti: fontys
turismo: turismo
quattro: quattro
brake: brake
royc: royce
studi: studie
breadvan: breadvan
driver: driver
shell: shell
rm: rm
drive: drive
schnabel: schnabel
bennett: bennett
jaguar: jaguar
nter: nter
motorsport: motorsport
motor: motors motor
engin: engineering
shop: shop
ru: ru
boxster: boxster
eindhoven: eindhoven
ctrl: ctrl
rod: rod
rx: rx
concept: concept
roll: rolls
compani: company
eurostyl: eurostyle
mazda: mazda
golf: golf
thull: thull
rss: rss
panamera: panamera
darin: darin
cayenn: cayenne
car: cars
flat: flat
peugeot: peugeot
artz: artz
event: eventer
europa: europa
nordstadt: nordstadt
six: sixes
break: break
studebak: studebaker
bentlei: bentley
gt: gt
scirocco: scirocco
topspe: topspeed
classicdriv: classicdriver
asc: asc
deliveri: delivery
xj: xjs
classic: classic
sothebi: sotheby
lotu: lotus
autohau: autohaus
sunroof: sunroof
speedhunt: speedhunters
kreuzer: kreuzer
sedan: sedan
carrera: carrera
sport: sport
