встал: встали встала
нереальн: нереально
ру: ру
слух: слухам
говор: говорят говорили говорю
бензин: бензин бензина
разойдут: разойдутся
влиян: влияние
студентк: студентке
понима: понимаю
оповещен: оповещений
лев: левой
значен: значения
стат: статьи
воен: военные военных военный
обычн: обычную обычной
оказа: оказались
пояс: пояс
федеральн: федеральная
рабоч: рабочей
дорог: дорогами дороги дорогих дороге
стал: стала стали стало
мнен: мнение
образовыва: образовываться
предлага: предлагают
объясн: объяснили
маленьк: маленькими маленький
ингаляц: ингаляции
разлож: разложили
ребенок: ребенок
появ: появилась
удал: удалить
намертв: намертво
центр: центре
ждем: ждем
реагирова: реагировали
показыва: показывал
вернут: вернуться
прорва: прорваться
арх: архив
незнаком: незнакомые
экономик: экономика
грел: грелся
пол: поле
сто: стоим стоят стоит
манхэттен: манхэттене
добра: добрались добраться
вообщ: вообще
пункт: пункта пункты пункт
макияж: макияжа
преврат: превратился
ожида: ожидайте
личност: личность
структур: структуры
суд: судя
дава: давал
макс: максим
подел: поделились
сообщ: сообщили
запас: запасы
поп: попить
мин: минно мине
ветер: ветер
мир: мир
романенк: романенко
укол: уколов
силов: силовые
секретн: секретные
писа: писали
огражден: ограждения
внешност: внешности
повезл: повезло
вагнер: вагнер
двига: двигались двигаемся
либ: либо
скор: скоро
нажм: нажмите
связ: связи
резк: резко
ранен: ранениями ранения
дела: делает делали делать делается
новгород: новгорода
боев: боевыми
едет: едет
застря: застряли
сидяч: сидячем
перекрыт: перекрыта
узнава: узнавала
фронт: фронте
провел: провели
навигатор: навигатор
отреза: отрезали
город: городов города
травм: травмы
увеличива: увеличивается
разобра: разобрали
час: час часов часа
чат: чате
украин: украине
гранат: гранатой
метр: метров метр
раскр: раскрыли
просыпа: просыпать
выстав: выставил
больн: больные
позвол: позволили
россиянин: россиянин
грузовик: грузовики грузовике
рубл: рублей
сосед: соседа
рассосет: рассосется
могл: могли
полбак: полбака
движен: движение движений движения
гавашел: гавашели
обошл: обошлось
анастас: анастасия
нов: новые новой
мест: месте
тишин: тишина
слож: сложившейся
спрашива: спрашивали
швы: швы
слов: слова
пятилитров: пятилитровые
резин: резина
якоб: якобы
сдела: сделать
отда: отдал
эффективн: эффективность
видет: видеть
развернут: развернуться
деактивирова: деактивирована
пробова: пробовать
родител: родителей
подорва: подорвался
дают: дают
мигалк: мигалками
ча: чай
редакциярекламаконтактыпресс: редакциярекламаконтактыпресс
видел: видела видели видел
чебурек: чебуреки
бутерброд: бутерброды
моментальн: моментально
жизн: жизни
вперед: впереди вперед
ноч: ночь ночью
идт: идти
зашедш: зашедшей
чвк: чвк
мог: могу
пыта: пытаются
мож: можем
прида: придали
мол: мол
летн: летней
момент: момент момента
пошл: пошло пошла
мор: морось
основн: основном
путешеств: путешествия
старик: старикам
заблокирова: заблокированы
сша: сша
машин: машины машинах машину машин машина машине
лидер: лидер
единиц: единицы
обочин: обочине
отб: отбой
техник: техника техники технику
хам: хамят
роснефт: роснефти
утечк: утечке утечки
заезд: заезда
пуска: пускал пускают
постепен: постепенно
культур: культура
удив: удивило удивились
личк: личку
лнр: лнр
личн: личные лично
нужн: нужна
номер: номер
помоч: помочь
помога: помогают помогали помогает
вечер: вечера
рынк: рынке
продвижен: продвижения
вылож: выложившего
неизвестн: неизвестно
повыс: повысились повысили
помощ: помощи помощь
врач: врач
продвинул: продвинулись
выталкива: выталкивают
результат: результате
проеха: проехали проехала проехало проехать
полож: положили
полос: полоса полосы полосу полосе
опасн: опасные
дал: дали
тасс: тасс
броса: бросала
светла: светлана
ловушк: ловушке
прижима: прижимают
богат: богаты
проезжа: проезжало проезжают проезжала проезжали
документ: документы документов
лов: ловит
спокойн: спокойно
взрывн: взрывной
снегоуборочн: снегоуборочных снегоуборочные снегоуборочную
пенсионер: пенсионеры
подъезжа: подъезжают
заведен: заведенной
дальнобойщик: дальнобойщики дальнобойщиками
большегруз: большегрузы
трубк: трубки трубку
дан: данный данные
дар: дарья
отключ: отключены
прочист: прочистили
въезд: въезды
канистр: канистрах
спецпроект: спецпроекты
раскрыт: раскрыты
плох: плохо
неподалек: неподалеку
рост: ростов
росс: россии россия россией
фбр: фбр
заканчива: заканчивается
сзад: сзади
обследован: обследование
четырех: четырех
гиперзвуков: гиперзвуковой
мотор: мотор
автомобил: автомобилей
ситуац: ситуацию ситуацией
пожалова: пожаловать
медлен: медленно
виноват: виноват
хлопец: хлопец
причин: причин
обледенен: обледенение
деньг: деньги
сантиметр: сантиметр
цел: целую
цен: цены цене
эвакуирова: эвакуировали
очк: очков
брал: брали
лент: ленте лента ленту
кабин: кабины
сдвинул: сдвинулись
шахт: шахтами
кажд: каждую
опечатк: опечатку
лекарств: лекарствами
галер: галереи
доеха: доехал
оцен: оценили оценил
дво: двое двоих
коф: кофе
политик: политике
выезжа: выезжать
перекрыва: перекрывали перекрывают
покупа: покупали
везл: везли
муж: муж
увидел: увидел
тупик: тупик
обнов: обновила
каллиник: каллиников
жил: жилья
таман: тамань
юл: юлия
вал: валил
начал: начале
заня: заняли
пройт: пройти
поучаствова: поучаствовали
примерн: примерно
подросл: подросло
наступлен: наступлении
медиа: медианная
занесен: занесенной
пробира: пробираться
километров: километровая
сказа: сказали
ссср: ссср
произошл: произошла произошло
итог: итоге
работник: работники
паца: пацаны
кустик: кустики
след: следующая следующей
клетк: клетке
ерунд: ерунда
возобнов: возобновится
дел: делились дела
вопрос: вопросы
ближайш: ближайшая ближайшую ближайший
рассказа: рассказали
невозможн: невозможно
снежн: снежной
эрик: эрик
параллельмо: параллельмоя
осадк: осадков
лопат: лопаты
так: такую таки
москв: москвы москву москва
никт: никто
картин: картина
полност: полностью
развязк: развязка развязке
срок: сроки
станц: станциями
мощн: мощный
измен: изменено
засыпа: засыпанное
суток: суток
перезванива: перезванивает
дет: детей детям
блогерш: блогерши
назва: назвал
выезд: выезда выезды
лабиринт: лабиринт
пишут: пишут
откуд: откуда
некотор: некоторые
мчс: мчс
куп: купили
подума: подумали
обща: общаются
служб: службы службам
сожгл: сожгли
попа: попали
остава: оставалось
кита: китаем
спорт: спорт
зажат: зажаты
район: районе
шок: шоке
специальн: специально
ростовск: ростовскую ростовской
обсто: обстоят
последн: последнего последний последние
поперл: поперлись
зна: знаю
услов: условий условия
сам: самые
звон: звонят звонил звонили звонила
спецтехник: спецтехники
захотел: захотел
жми: жми
закр: закрыли
детьм: детьми
друг: другими друг друга другу
сутк: сутки
поня: понял
подобн: подобное
народ: народ
рассказыва: рассказывают рассказывать
обогрет: обогреть
программ: программе
управлен: управление
погодн: погодные погодных
вчер: вчера
получа: получается
ира: иран
главн: главное главные
нашл: нашли
заправк: заправка заправки заправке заправку
женщин: женщины
передн: передних
снег: снегом снега снег снегу
обогрев: обогрева
взросл: взрослым
посильн: посильную
начина: начинает
расстоян: расстояние
стоя: стояла стояли стоять
популярн: популярных популярные
смертельн: смертельной
област: область области
раз: разу раза
магазин: магазины магазин
лазейк: лазейки
движущ: движущихся
кирилл: кирилл
пентагон: пентагона
уеха: уехал уехали
помн: помню
нижн: нижнего нижнем
нача: началась начался начали
реша: решали
авар: авария
новичковамай: новичковамайя
интернет: интернет
россия: россиян
необычн: необычно
пообеща: пообещали
тесн: тесной
рекорд: рекорд
виктор: виктория
всеобществополитикапроисшествиярегионымоскв: всеобществополитикапроисшествиярегионымосква
поселк: поселка
законч: закончилось
пришл: пришлось
пробра: пробрались
груб: грубят
культ: культю культи
уничтожен: уничтоженных
заперт: заперты
раскатыва: раскатывали
происход: происходит
комментар: комментарии
зеленск: зеленского
хвата: хватает
проч: прочих
работа: работала
сильн: сильный
нанесен: нанесения
ценност: ценности
погрет: погреться
ед: еда едой еды еду едем
тает: тает
телефон: телефона
зажа: зажали
числ: число
перекур: перекура
проб: пробиться
ход: ходили ходит
трасс: трасса трассе трассы трассу
чист: чистили чисто
пробк: пробку пробке пробка пробки
автодор: автодора
подозрева: подозреваемого
факт: факту
сотруднича: сотрудничать
сем: семи семьи
восьм: восьми
выйт: выйти
легк: легко
вид: видим
убра: убрали
представител: представителей
сет: сети
виде: видео
некуд: некуда
сигарет: сигаретами
нигд: нигде
положен: положении
хамск: хамски
температур: температурой
дойт: дойти
ростов: ростова
спасател: спасателям спасателей
километр: километры километра километре километров километр километрах
пирожк: пирожков
естествен: естественно
оста: остались
водител: водителя водители
нескольк: нескольких
быстр: быстро
расчища: расчищают
вчерашн: вчерашнего
фрукт: фрукты
лукойл: лукойл
спрос: спросить спросили
краснодар: краснодара
наук: наука
хот: хотите
платн: платно
дом: домой
дон: дон
известн: известно
общ: общем
гражданск: гражданские
сторон: сторону стороны
пригожин: пригожин
сид: сидим
поддержк: поддержки поддержку
обитан: обитания
тысяч: тысячи
глубок: глубокий глубоким
дня: дня
пропуст: пропустить
принцип: принципе
хорош: хорошие
стоимост: стоимость
перекр: перекрыли
пуст: пустую
ид: идите
звонк: звонках
неподвижн: неподвижно
оператор: оператор
сред: среда среди
предупрежден: предупреждений
предыдущ: предыдущего
наш: нашего
некачествен: некачественная
эдуард: эдуард
въеха: въехали
мног: многие
темн: темно
похуден: похудения
хвост: хвосте
кровотечен: кровотечение
язык: язык
большинств: большинство
сил: силы
останов: остановилось остановились
умн: умных
фот: фото
образова: образовалась
арестова: арестовало
автобус: автобусе
происходя: происходящее
нат: нато
информац: информация информации
обгон: обгон
разворот: разворот
эпицентр: эпицентра
больниц: больницы больницу
муковисцидоз: муковисцидоз
гор: гору
взял: взяли
видим: видимо
замет: заметить
гуманитарк: гуманитарку
соседн: соседней
люд: людям людей
дожд: дождя дождем
координат: координаты
россиян: россияне
погод: погоду
максимум: максимум
паник: паники
поговор: поговорили
хуж: хуже
особ: особо
пробива: пробиваться
закрыт: закрытии
противопехотн: противопехотной
раструс: раструсило
спал: спал спали
затор: затора затор
моральн: морально
одн: одном одну
продаж: продажу
заеха: заехали
никола: николай
забот: забота
потребн: потребность
попрос: попросил
хижняк: хижняк
сми: сми
огромн: огромные
плюс: плюс
подня: подняться
польз: пользуюсь
музык: музыки
гамбургер: гамбургера гамбургеры
вод: воды воду водой
предупрежда: предупреждали
воз: возили
врод: вроде
стран: страна
аренд: аренды
овощ: овощи
мо: мое
громк: громкой
кресл: креслах кресла
спасательн: спасательные
март: марта
испытан: испытании
войт: войти
реампутац: реампутации
еха: ехали ехать
человейник: человейниках
бутылк: бутылка бутылки
смс: смс
снегопад: снегопад снегопада
хром: хромые
направля: направлялись
сраз: сразу
выеха: выехали
заяв: заявили
обгоня: обгонять
болезн: болезни
поблиз: поблизости
задействова: задействована
ракет: ракеты
сол: солью
фур: фур фурами фуры фура
туалет: туалеты
ждит: ждите
об: обе
новост: новости
сну: сну
дума: думали
корм: кормить
приня: приняли
добр: добро добра
оо: ооо
возможн: возможных
привыкш: привыкшие
всу: всу
кида: кидают
возл: возле
брос: бросили бросил
буран: бурану
привыкл: привыкли
буквальн: буквально
шест: шести
утр: утра
боя: боялся
хочет: хочется
попутн: попутно
как: какие
детств: детстве
дмитр: дмитрий
гололед: гололед
топлив: топливо топлива
отбойник: отбойниками отбойники отбойник
бойц: бойцов
накр: накрыл
прошл: прошлого прошло
раста: растает
выпуск: выпуска
наверн: наверное
легков: легковые легковых
бывш: бывший
обход: обходили
реальн: реальный
тяжел: тяжело
изначальн: изначально
наверняк: наверняка
ночева: ночевали ночевать
встречн: встречную встречной встречные
ребенк: ребенку ребенком ребенка
ник: никого
сфер: сфера
откр: открылся открылось
ри: риа
наход: находимся находятся находится
нахож: нахожусь
никак: никаких никакие никак никакой никакого
каков: каково
непонятн: непонятно
killnet: killnet
ctrl: ctrl
appl: apple
enter: enter
