нейрон: нейронов
евровиден: евровидения
слух: слухи
ру: ру
провер: проверить
влиян: влияние
студентк: студентке
экспериментальн: экспериментальным
стат: стать статьи
обычн: обычную
найтл: найтли
оказа: оказался
трансильван: трансильвании
конц: конце
ремейк: ремейка
ущипнувш: ущипнувшего
нетребк: нетребко
стал: стали стала стало
объясн: объяснила
фашистск: фашистской
удал: удалить
призва: призвала призвали
появ: появился
работ: работу
практическ: практически
вернут: вернуться
арх: архив
роскошн: роскошная
живот: живот
экономик: экономика
общественник: общественники
получен: получении полученном
холоп: холопа
сто: стоит
пропаж: пропажи
мил: милы
пугачев: пугачевой пугачеву
кокаинов: кокаиновый
д: д
слома: сломавший
киан: киану
джон: джон
взрыв: взрыва
вселен: вселенной
хилар: хилари
отъезд: отъезда
личност: личность
валер: валерии
присутств: присутствием
снижен: снижении
структур: структуры
шак: шака
суд: суд
шал: шалев
х: х
пригроз: пригрозили
подел: поделилась
показа: показал
сезон: сезон сезона
звезд: звезда звезду звезд
отправ: отправить
ратаковск: ратаковски
достоян: достоянием
поп: поп
убийц: убийцы
футбол: футболе
звездн: звездный
памят: памяти
мир: мир
укол: уколов
силов: силовые
секретн: секретные
запад: запада
ранетк: ранетки
смотревш: смотревший
обсужда: обсуждают
кухн: кухня
съемк: съемки съемках съемкам
опроверг: опроверг
нажм: нажмите
спектакл: спектакли
совместн: совместным
отмен: отменить
митин: митин
развращен: развращенный
аналог: аналог
сцен: сцен
власт: власти
получ: получился получит
чудовищн: чудовищный
драг: драго
французск: французский
верс: версия
фронт: фронте
снимут: снимут
отравлен: отравления
книг: книга
грандиозн: грандиозный
беремен: беременности
документальн: документальный
национальн: национальным
лазар: лазарев
украин: украине
гранат: гранатой
прост: простился
грядущ: грядущем
раскр: раскрыли
венсан: венсаном
выстав: выставил
россиянин: россиянин
рубл: рублей
сосед: соседа
проверк: проверку
шакир: шакира
покинул: покинул
предчувств: предчувствии
лиц: лицо
нов: новом новый нового новой новая
улетевш: улетевшего
обошл: обошли
больш: большого
госдум: госдуме
мест: мести месть
част: части
клюкв: клюква
подделко: подделкои
спирс: спирс
андр: андрей
ким: ким
опубликова: опубликован опубликовала
кин: кино
карьер: карьере карьеры
офис: офис
русалочк: русалочки
фестивал: фестиваль фестиваля
каннск: каннский
игр: игры игр
суэнк: суэнк
могуч: могучий
стартова: стартовали
эффективн: эффективность
кровав: кровавые
видет: видеть
постельн: постельных
деактивирова: деактивирована
сложн: сложно
мурак: мураками
британц: британцы
редакциярекламаконтактыпресс: редакциярекламаконтактыпресс
страшн: страшная
фигур: фигуру
взыска: взыскал
жизн: жизни
кир: кира
культов: культовый культовой
русск: русских
заказа: заказал
сексуальн: сексуальном
кит: кит
тизер: тизер
актер: актером актеры актера
оскар: оскаров оскар
венд: венди
депард: депардье
класс: классом
полноцен: полноценный
майкл: майкла
узна: узнать
летн: летняя
американц: американце американцев
регг: регги
бритн: бритни
путешеств: путешествия
съемок: съемок
вышл: вышло вышла
сша: сша
лидер: лидер
элвис: элвис
ямайск: ямайский
групп: группы группе
ариа: ариана
техник: техника
рыцар: рыцари
утечк: утечки
дефиц: дефицит
решен: решение решения
требован: требованиях
фина: финал
культур: культура
личн: личные личным
фернанд: фернандо
советск: советский
деревянк: деревянко
смерт: смерти
суперкиллер: суперкиллера
заклят: заклятие
хаббард: хаббард
вылож: выложившего
современ: современного современных современности
айлиш: айлиш
фанатк: фанатке
врач: врач
пенсионерк: пенсионерку
результат: результате
выступ: выступили
мстител: мстителей
малик: маликов
артанья: артаньян
выигра: выиграл
офф: офф
фанат: фанаты
документ: документы документов
будущ: будущих
ссылк: ссылкам
хоррор: хоррора
крид: крид
прекрат: прекратить
сын: сына сын
альб: альбом
пнул: пнул
марвел: марвелы
замуж: замуж
конкуренц: конкуренции
свобод: свободе
дан: данные
потребова: потребовали
мыльн: мыльных
высмеива: высмеивает
спецпроект: спецпроекты
летел: летел
испанск: испанский
сенсац: сенсаций
раскрыт: раскрыты
легендарн: легендарным
вкус: вкус
кроссовок: кроссовок
росс: россии россия
джейм: джейми
задумыва: задумывался
престол: престолов
гиперзвуков: гиперзвуковой
мотор: мотор
ситуац: ситуацию
пожалова: пожаловался пожаловать
битв: битвы
перелома: переломавшую
тренер: тренера
счита: считают
скупа: скупать
причин: причины
деньг: деньгах
отказа: отказался
ахеджаков: ахеджаковой
тарантин: тарантино
киновселен: киновселенной
продюсер: продюсер продюсера
очк: очков
брак: браки
сериал: сериалов сериале
лент: лента ленту
предлож: предложили
финансирован: финансирования
атлант: атланты
опечатк: опечатку
галер: галереи
оцен: оценили оценил
эм: эмили
эн: энн
российск: российских
глобальн: глобального
двойн: двойню
искусствен: искусственным искусственный
лорак: лорак
принужден: принуждении
муж: мужа муж
жив: живыми
кассел: касселем
завершен: завершении
жил: жилье жили
увидет: увидеть
генпрокуратур: генпрокуратуру
писател: писателя писатель
мультсериа: мультсериал
сутенерств: сутенерство
настоя: настоящие
меир: меир
пост: пост
ссср: ссср
потеплен: потепления
будн: будни
ривз: ривза
след: след
джексон: джексона
мхт: мхт
дел: дело деле
рассказа: рассказала рассказал
студ: студия
вычеркнут: вычеркнуть
ответ: ответили
капельниц: капельницей
москв: москве
кардашья: кардашьян
порн: порно
срок: сроки сроке
условн: условном
концерт: концертом концерт
маньяк: маньяка
следств: следствие
преследован: преследований
дет: детей
душител: душитель
людьм: людьми
назва: назвать назвал
госизмен: госизмене
охотниц: охотницу
умерл: умерла
прокуратур: прокуратуру
джа: джа
снима: снимался
церемон: церемония
папарацц: папарацци
актрис: актрисы актриса актрис
ксенофоб: ксенофобии
ан: ани
харук: харуки
попа: попал
шнур: шнуров
кита: китаем
спорт: спорт
выпа: выпавшем
рэпер: рэпер
любовниц: любовницы
последн: последние последний
солнц: солнце
одесск: одесский
внук: внук
жалова: жаловался
сам: самый
трост: тростью
пэн: пэн
мушкетер: мушкетеров
интеллект: интеллект интеллектом
жми: жми
питер: питер
возвраща: возвращаться
госпитализирова: госпитализировали
барселон: барселону барселоны
тайн: тайный
поня: понял
дракон: дракона
бондарчук: бондарчук
вероятн: вероятности
управлен: управления
заворож: заворожили
вайнштейн: вайнштейн
главн: главным главных главное главного
поклонник: поклонников
нашл: нашли
женщин: женщин женщины
билл: билли
космос: космоса
рокк: рокки
супергероин: супергероинях
состоян: состоянии
увол: уволил уволить
израильск: израильский
вер: верят
популярн: популярных популярной
вс: вс
режиссер: режиссер
мотив: мотивам
мужчин: мужчина
смертельн: смертельной
лакотт: лакотт
созда: создать
пентагон: пентагона
спин: спин
сво: своем свой своим
жерар: жерара
интернет: интернет
диас: диас
ефремов: ефремовым
бдт: бдт
тед: теда
тел: тела
заслуж: заслужил
тем: тема
выступлен: выступления
пришл: пришлось
возбуд: возбудить
зрител: зрителей
гражданств: гражданства
культ: культ
йовович: йовович
лукьяненк: лукьяненко
оборудован: оборудование
дэйз: дэйзи
трех: трех
бойкот: бойкотом
приступ: приступил
триллер: триллеров триллере
уик: уик
сталкер: сталкеры
ценност: ценности
ев: евой
театр: театре театр
пьер: пьер
высказа: высказался
худрук: худрука
истор: истории история
плоск: плоскую
минкульт: минкульт
раскритикова: раскритиковала
призыва: призывающие
автор: автор
бабушк: бабушки
курортн: курортной
уйт: уйти
сет: сети
представител: представителей представитель
виде: видео
объявл: объявлена
умер: умер
теор: теории
козловск: козловского
боевик: боевиком
снимет: снимется
переживан: переживаниями
депутат: депутаты
краснодар: краснодара
победител: победитель
наук: наука
вышел: вышел
предмет: предмет
мэр: мэра
переезд: переезд
дом: дом
реш: решилась
генеральн: генерального
гарр: гарри
известн: известно известный известная известны
певиц: певица
дирижер: дирижера
постав: поставили
знаменит: знаменитого
прокат: прокате
украша: украшали
обитан: обитания
призна: признали
недел: недели
долетел: долетел
багир: багиров
музыкант: музыкант
изобретен: изобретении
серг: сергей
хорош: хорошие
глуховск: глуховского
никит: никитой
кинонаград: кинонаград
сред: среда
обвинен: обвинений
улучш: улучшили
погибл: погибли
эдуард: эдуарда эдуард
мног: многих
полюб: полюбил
сыгра: сыграла
абсурдн: абсурдный
люб: любые
похуден: похудения
снят: снять
гранд: гранде
язык: язык
умн: умных
снял: сняли снял
план: планами
фот: фото
сервис: сервисов
элит: элиты
безденеж: безденежья
критикова: критиковать
нат: нато
насил: насилии
информац: информация
станисла: станислав
земл: землю
санчес: санчес
замет: заметили
гош: гоша
тетрис: тетриса
прокомментирова: прокомментировали
россиян: россияне
спуст: спустя
английск: английском
куценк: куценко
фокс: фокса
элизабет: элизабет
упа: упало
сериа: сериала сериал
приквел: приквел
потеря: потеряло
катастроф: катастрофы
дочер: дочерью
одн: одна
продаж: продажу
мадон: мадонны
орбака: орбакайте
приз: призыв
забот: забота
робб: робби
дтп: дтп
ло: лоу
попрос: попросили
сми: сми
сильвестр: сильвестром
убива: убивать
команд: команду
экранизац: экранизацией
музык: музыки
апрел: апреля
стран: стране странных
суперхит: суперхитом
участ: участием
смотрет: смотреть
свет: света
мо: мое
громк: громкой
войн: война
япон: японии
испытан: испытании
март: марта
хореограф: хореограф
песн: песни
войт: войти
существова: существовало
медвед: медведь
джонс: джонс
глаз: глазами глазе
пир: пиры
наследник: наследники
кост: костей
сраз: сразу
всекиносериалымузыкакнигиискусствотеатрфотограф: всекиносериалымузыкакнигиискусствотеатрфотография
марг: марго
комед: комедию
обвин: обвинили
гражданин: гражданин
убийств: убийство
подробн: подробности
трейлер: трейлер
ужас: ужасов
заяв: заявил
перр: перри
барб: барби
болезн: болезни
бузов: бузова
украинск: украинская
джуд: джудом
ракет: ракеты
сталлон: сталлоне
переубед: переубедить
новост: новости
лучш: лучшей
перв: первая первым
прем: премию
харв: харви
добр: добро добра
оо: ооо
оп: опыт
багиров: багирова
осужден: осужденная
вручен: вручения
всу: всу
артист: артистом артистов
ласс: лассо
американск: американской
брос: бросились бросил
грин: грин
архстоян: архстояние
выйдет: выйдет
самиздат: самиздат
пиратск: пиратским
опер: оперы опер
как: каким
участник: участника
кан: канн
участниц: участница
дмитр: дмитрий
разруша: разрушает
герман: германии
фильм: фильм фильма
поттер: поттере
тюрьм: тюрьмы
выпуск: выпуска
прошл: прошла
аборт: аборту
род: родила
бывш: бывшая бывший
реальн: реальный
тяжел: тяжелое
втор: второго
сепсис: сепсиса
выпуст: выпустил
рок: рок
бостонск: бостонский
кэмерон: кэмерон
клип: клип
миллион: миллионы
rtvi: rtvi
st: st
doll: dolls
pussycat: pussycat
ctrl: ctrl
appl: apple
disnei: disney
pornhub: pornhub
netflix: netflix
pharaoh: pharaoh
shortpari: shortparis
killnet: killnet
lotu: lotus
enter: enter
