обрат: обратиться
ру: ру
рф: рф
провер: проверить
влиян: влияние
студентк: студентке
понима: понимать
информацион: информационные
коронавирус: коронавируса коронавирус
стат: статьи
обычн: обычную
повторн: повторным повторную повторной повторно повторная повторное
советник: советник
стал: стало
объясн: объяснил объяснила объяснили
случа: случаи
появ: появиться
удал: удалить
усилива: усиливающей
центр: центра центры
завис: зависит
вернут: вернуться вернутся
арх: архив
экономик: экономика
четверт: четверти
получен: получении
заморожен: замороженном
александр: александр
сто: стоит
манхэттен: манхэттене
пункт: пункты пункт
макияж: макияжа
н: н
неприятн: неприятные
личност: личность
снижен: сниженным
должн: должны должна
структур: структуры
тц: тц
график: графику
всемирн: всемирная
мутир: мутирует
перечн: перечнем
поэт: поэтому
оформля: оформляется
назван: название
котор: котором
времен: временные временем
профилактик: профилактика
вариант: вариантов вариант
омс: омс
мир: мир
укол: укол уколов
силов: силовые
секретн: секретные
выдержа: выдержать
противопоказан: противопоказания противопоказанием противопоказаний
связа: связаны
внешност: внешности
майш: майшев
противопоказа: противопоказана
вагнер: вагнер
скор: скорее
нажм: нажмите
связ: связи
ива: иван
вперв: впервые
опас: опасен
дела: делали делал делать
сут: сути
получ: получить
злокачествен: злокачественных
терапевт: терапевт терапевтом
фронт: фронте
важн: важно
побочн: побочные
город: города
вирусн: вирусные
судорожн: судорожный
вскармливан: вскармливания
беремен: беременности
декабр: декабре
национальн: национальному
ревакцинац: ревакцинацией ревакцинацию ревакцинация ревакцинации
украин: украине
гранат: гранатой
раскр: раскрыли
выстав: выставил
россиянин: россиянин
сосед: соседа
позиц: позиции
занима: занимает
однокомпонентн: однокомпонентная
отек: отек
бустерн: бустерной бустерная
лиц: лиц лицам лица
повышен: повышение
уровен: уровень
нов: новый новом новой новые
дискомфорт: дискомфортом
мест: месте
госдум: госдуме
част: часть
пожил: пожилым
алекс: алексей
госуслуг: госуслугах госуслуги
аналогичн: аналогичной
анамнез: анамнезе
стартова: стартовала
определен: определенной определенным
сдела: сделать сделана
эффективн: эффективность
видет: видеть
лайт: лайт
деактивирова: деактивирована
расшир: расширили
минздра: минздрав
министерств: министерстве
дают: дают
редакциярекламаконтактыпресс: редакциярекламаконтактыпресс
сердечн: сердечная
жизн: жизни
русск: русском
вирусологическ: вирусологической
коронарн: коронарная
зашедш: зашедшей
населен: населения население
процедур: процедура процедуры процедурой
систем: системы
чвк: чвк
индивидуальн: индивидуальному индивидуальных
отвод: отвода
летн: летней
момент: момент
натал: наталья
торгов: торговые
путешеств: путешествия
константин: константин
сможет: сможет
поликлиник: поликлиники
сша: сша
лидер: лидер
групп: группам группе
техник: техника
емиас: емиас
утечк: утечке утечки
решен: решения
антител: антител антитела
культур: культура
градус: градусов
удив: удивились
провод: проводят проводится
лнр: лнр
средн: средней среднем
личн: личном личные
нужн: нужна
выздоровлен: выздоровления
кишечн: кишечного
букв: буква
крючк: крючков
ощуща: ощущалась
вылож: выложившего
повыс: повысить
врач: врач врача врачом
циклкоронавирус: циклкоронавирус
выш: выше
приложен: приложение
гамковидвак: гамковидвак
здоров: здоровьем здоровья
обнаруж: обнаружен
тасс: тасс
документ: документы документов
интерва: интервал
почек: почек
инфекцион: инфекционные
соображен: соображений
ревакцинирова: ревакцинировался
показан: показанием
портал: портале
дан: данный данные данным
откладыва: откладывать
грудн: грудного
отключ: отключены
дат: дата
векторн: векторная
спецпроект: спецпроекты
мутац: мутаций
раскрыт: раскрыты
зарегистрирова: зарегистрированным зарегистрированной
код: код
росс: россии россия россией
иммун: иммунной
фбр: фбр
осложнен: осложнения
гиперзвуков: гиперзвуковой
медицинск: медицинских медицинским медицинского
мотор: мотор
проконсультирова: проконсультироваться
ситуац: ситуацию
пожалова: пожаловать
выдач: выдачи
цикл: цикла
счита: считается считает
эффект: эффекты
утвержден: утвержденного
диабет: диабет
очк: очков
вирус: вирус
лент: лента ленту ленты
старш: старше
кажд: каждой
опечатк: опечатку
галер: галереи
прожива: проживающим
оцен: оценить оценили оценил
продемонстрирова: продемонстрировал
глобальн: глобальной
политик: политике
полис: полис
вмест: вместе
уход: уходит
алфавит: алфавита
директор: директор
грипп: гриппа
тупик: тупик
обнов: обновила
использова: использовать
капел: капель
жил: жилья
гиперчувствительн: гиперчувствительность
спутник: спутника спутник спутником
пройт: пройти
примерн: примерно
наступлен: наступления наступлении
медиа: медианная
инфекционист: инфекционистом инфекционист
заражен: заражения
дифтер: дифтерии
ссср: ссср
рекомендова: рекомендована
кабинет: кабинете
произошл: произошли
работник: работникам
полгод: полгода
обеспеч: обеспечит
след: следующие следующую следует
минут: минут
дел: делятся
аллергическ: аллергические
организац: организация
вопрос: вопрос
параллельмо: параллельмоя
ваш: вашего
проход: проходит проходить
ответ: ответа
так: такую
москв: москвы москва москве
медотвод: медотвод
медучрежден: медучреждение
поствакцинальн: поствакцинальные
срок: сроки срок
ожирен: ожирение
хран: хранятся
мощн: мощного
август: августа
блогерш: блогерши
назва: назвал
материал: материалы материале
поднима: поднималась
здравоохранен: здравоохранения
медкарт: медкарте
синдр: синдром
некотор: некоторых некоторые
разморажива: размораживают
введен: введении введение
количеств: количество
кита: китаем
добав: добавили
спорт: спорт
район: районные
шок: шок
практик: практику
последн: последнее последняя последней последние
двухкомпонентн: двухкомпонентной двухкомпонентным
сам: самым
захотел: захотел
жми: жми
штамм: штамме штамма штаммы
друг: другим
михальчевск: михальчевский
привит: привитого
приход: приходится
длит: длится
эпиваккорон: эпиваккорону эпиваккорона
крак: кракен
называ: называют
степен: степени
иммунитет: иммунитетом иммунитета
программ: программе
получа: получают
ира: иран
главн: главное
действ: действуют действия
нашл: нашли
записа: записаться
покида: покидать
заболеван: заболевания заболеваниями заболеваний
допуска: допускают
перенесен: перенесенного перенесенный
обеспечива: обеспечивают
страда: страдающим
перечен: перечень
коновал: коновалов
смысл: смысла
обострен: обострение
рубеж: рубежом
поможет: поможет
состоян: состоянии
конвасэл: конвасэл
популярн: популярных популярные
гепатит: гепатита
смертельн: смертельной
использ: используется используют
исчеза: исчезают
аденовирус: аденовируса
пентагон: пентагона
сво: своему
тяжест: тяжести
помн: помнить
исход: исходить
паспорт: паспорт
нача: начали
прививочн: прививочный
пациент: пациенту пациент
специалист: специалист
слаб: слабым
интернет: интернет
го: го
рекорд: рекорд
кряж: кряжев
наименьш: наименьшим
сопутств: сопутствующими
явля: является
всеобществополитикапроисшествиярегионымоскв: всеобществополитикапроисшествиярегионымосква
тел: теле тела
столбняк: столбняка
рбк: рбк
применя: применять применяемые
официальн: официальные
пришл: пришлось
полн: полным
хобл: хобл
знат: знать
первичн: первичной первичную первичный
анафилактическ: анафилактический
десят: десяти
сайт: сайт
уничтожен: уничтоженных
хроническ: хронические хронических
задач: задач
комментар: комментарии
придержива: придерживается
выясн: выяснит
зеленск: зеленского
инъекц: инъекции
утвержд: утвержден
сертификат: сертификата сертификат
смогут: смогут
нанесен: нанесения
ценност: ценности
осмотр: осмотр
заинтересова: заинтересованы
необходим: необходима необходимо
подходя: подходящий
числ: число
чумак: чумаков
период: период
подозрева: подозреваемого
поленоваврач: поленоваврач
сотруднича: сотрудничать
снижа: снижается
реакц: реакции
онколог: онкология
очеред: очередь
легк: легкой
сет: сети
эффектив: эффективен
вид: виде
представител: представителей
виде: видео
остр: острые
объявл: объявлена
поленов: поленова
защит: защитой защитит защиты защитить защититься
температур: температуры температура
оста: остается
вырабатыва: вырабатывает
пептидн: пептидная
наук: наука
тип: типа
известн: известно
общ: общим
амнез: амнезия
пригожин: пригожин
специфическ: специфического
остальн: остальные
обитан: обитания
субъединичн: субъединичная
недел: недели
прививок: прививок
хорош: хорошие
стоимост: стоимость
звонк: звонку
организм: организма организм
болеют: болеют
сред: среда
предыдущ: предыдущем
ин: иным
улучш: улучшится
может: можете
титр: титр
люб: любым любой
похуден: похудения
компонент: компонентам компонента компонентом
язык: языках язык
избежа: избежать
умн: умных
фот: фото
обязательн: обязательно
арестова: арестовало
стил: стиль
здрав: здравого
инсульт: инсульт
заболет: заболеть
нат: нато
взят: взять
информац: информация
респираторн: респираторные
желудочн: желудочно
нормализац: нормализации
ломот: ломота
разн: разных
люд: людям людей
инактивирова: инактивированная
замен: заменится
минздрав: минздрава
производител: производитель
английск: английском
бессрочн: бессрочные
стенд: стенды
предварительн: предварительному
вакцин: вакцина вакцину вакцины вакцине вакциной
конкретн: конкретного
применен: применение
граждан: граждане
подп: подпись
например: например
подготовк: подготовкой
продаж: продажу
днейсоставля: днейсоставляет
омикрон: омикроне
никола: николай
наблюден: наблюдения
новообразован: новообразованиях
забот: забота
чумаковдиректор: чумаковдиректор
рекомендац: рекомендации рекомендаций
подобра: подобрать
потребн: потребность
сми: сми
выда: выдают
надежн: надежным
ознаком: ознакомиться
справк: справку
музык: музыки
воз: воз
стран: страна стране странах
электрон: электронной
аренд: аренды
январ: январе
гиперем: гиперемия
уровн: уровне уровня
отлич: отличие
тракт: тракта
четк: четкого
громк: громкой
испытан: испытании
песн: песня
войт: войти
массов: массовая
качеств: качество
прохожден: прохождения
государств: государств
наскольк: насколько
сраз: сразу
прививк: прививку прививкой прививка прививки
возобновля: возобновлять
заяв: заявили
болезн: болезней болезни болезнь
ракет: ракеты
ковивак: ковивак
вакцинац: вакцинацию вакцинации вакцинация вакцинацией
назальн: назальных
новост: новости
воврем: вовремя
существ: существует
владимир: владимир
перв: первой первую
относ: относится
туберкулез: туберкулез
добр: добро добра
крайн: крайне
оо: ооо
изменен: изменения
стопкоронавирус: стопкоронавирус
иммунолог: иммунолог
всу: всу
выбра: выбран выбрать
брос: бросил
увелич: увеличится
ремисс: ремиссии
интернат: интернатах
регистратур: регистратуру
календар: календарю
сердц: сердца
как: какую какие
все: всей
препарат: препарата препаратом препарат
недостаточн: недостаточность
молож: моложе
бойц: бойцов
растет: растет
выпуск: выпуска
высок: высоком
прежд: прежде
бывш: бывший
реальн: реальный
втор: вторым
тяжел: тяжелой тяжелые тяжелы
риск: риска риск
прежн: прежнее
сфер: сфера
однозначн: однозначного
способ: способом
навред: навредит
форм: форме
ри: риа
рекоменд: рекомендует
ii: ii
qr: qr
covid: covid
mo: mos
ru: ru
ctrl: ctrl
appl: apple
cov: cov
aurora: aurora
emia: emias
killnet: killnet
bau: bau
enter: enter
info: info
