фюрер: фюрер
пенс: ухода
фактическ: уделил
репарац: выплату
обычн: обычную
оказа: оказалось рур
ангел: придерживалась внук
мнен: употреблял общественное
капитализм: господства терминов
затрагива: предпринимаемые
арх: архив
предсказа: фактически
экономик: экономика экономики восстановить
сто: многом стоит земель
пролетел: рейном
основан: имелись регионы евросоюза
возглавля: знакомы
поступ: поступил поступить
финанс: развязывать
арм: призванных надвигалась
разговор: членов органов
проголосова: управление избирателей
должн: западные отдавая промышленности
суд: суде
крепк: крепкая
макс: хлопоты
жестк: жестким склонен
благодар: благодаря
денег: выделение
присоедин: отказывался впоследствии поддержана
бережлив: бережливый
кухн: кухни
участвова: бундестага участвовать
военноплен: военнопленных
двига: ядерной
проект: лег проекта
связ: связей связи связях
появля: появлялся начали системе
совместн: объединят
дела: делали делал делать
сут: контролируя
дискусс: дискуссий
режим: советского фильмов
позитивн: приносит
отреза: валом
врем: времена
укрепля: альянс
постро: построена
разгром: разгромили
преследова: преследовали
очевидц: препятствовали
остерега: близких
нов: установит нового перестраивается зон новая новой новых новому
част: части восточная
старательн: путь
партнерств: современная
алекс: алексей
слов: слова последнее
вооружа: войн
постоя: цель
трудоголик: трудоголиком
сдела: должное сделавший боеприпасов сделать претендовала
риторическ: готов
деактивирова: нажмите
судьб: судьбе
фигур: несменяемой
буксир: речной
совет: советами факте советов
вперед: вперед
пример: организация
колониальн: британцы
систем: налоговой системы капиталистическая
немец: немец
государствен: работа предложена государственный сотрудников государственной государственную
летн: говорили летний
отмеча: аденауэром отмечает
оккупац: оккупации
перебра: детьми
трудн: трудные
курс: курсе курс намеченного
сша: великобритании
лидер: переговорах лидеров летнему
миха: бисмарка
аппарат: государственного
групп: сплотить бомбы
произошедш: уверен
техник: техника
недостаток: недостаток
постепен: сказаться
культур: культура
геополитическ: роста
ненападен: гарантии
склад: складов
христианск: победы христианские будущего несмотря
промышлен: производственных уменьшить гражданской интересы сталелитейную
умерен: умеренность умеренности
жител: жители
гордост: гордости
выделен: маршалла
нуж: отказ
тверд: концу
сын: сына сын
капиталистическ: капиталистический всеобщего
женитьб: женитьбы
интерес: социальным учитывала действиями
вкусн: вкусную
пожал: пожалуй
отключ: комментарии
коммунист: коммунисты коммунистами коммунистов
связыва: политикой
толк: аденауэре
коминтерн: коминтерна
служебн: служебных
числен: составляла
гигант: промышленных
счита: протекторатом считали долгом считал считать
христианств: принцип
отсутств: гарантировать
цел: целью аппарата новую
тихоокеанск: азиатско
цен: такую устанавливаемыми
лент: лента ленту
изуча: изучать
прагматическ: функционеров
мирн: мирное
захоронен: месту
вооруж: вооружила
создава: позволили
администрац: администрацией военных администрации оккупационная
спор: парламентском
иностра: министра иностранные распорядиться
непоправим: производства
африк: индокитае
стратег: евразийских
примерн: выделили
бисмарк: председатель
карьерн: карьерным
бургомистр: бургомистр бургомистром бургомистра
комисс: генеральной
баварск: баварская
выдел: штаты
след: голлем отцом
институт: институты
иоган: иоганн
организац: политические религиозных флага
конституц: аденауэровской
юрист: юриста юристом
суверенитет: шансом полный
статус: имели
так: такого платить
одобря: одобряли
соратник: помог соратники
событ: тяжелым
моссовет: возглавлявший
усилен: возможности
атомн: единственное оружие объединить проведены
капитуляц: победивших
доходчив: формулировок
антигосударствен: подозрению
оккупант: ставленником
противостоян: воссоединение векового
служб: службу службе действующие
полев: полевые
конрад: конрада конрад конраду конрадом
соглашен: соглашение участниц
служа: служащий
попа: попал
остава: оставалось оставался
спорт: спорт
кредит: доступным
дополня: аргументов
услов: условиях обязательным отдельные
полувоен: полувоенных
голода: голодают
приход: приходом дело приход государству
израил: репараций
правильн: мощностями
восстанов: европе восстановили
сомнева: десяток
поня: поколения
рассказыва: рассказывает отставке
балансирован: балансировании
ограничен: демилитаризации
программ: европу
джордж: государственным
коммуникац: отрезать
главн: главной главное государствам сыграли аденауэрпредседатель установил
симпатизирова: симпатизировали
веймарск: веймарской
элемент: поддержку
вовлечен: плане
сестр: сестрам
состоян: состояние
бесперебойн: заинтересованных
созда: силы рост атомную
атлантическ: вернуть
помн: необходимое
исход: деятелями
отдельн: относится помнит предлагали
авар: аварию
нелегк: нелегко
большевик: большевиками
московск: знакомство московская
реализац: шуманминистр
сибир: вовлечения
торжествен: статус почести
пришл: убийством отношениях
полемик: каким
полн: положение развернулось обеспечить
фотограф: фотографы
дважд: дважды
реформ: финансовые
фриц: вермахта
формулировок: простота
привлека: последующие концлагерей
коррупц: обвинили
рамк: рамках
стажер: стажерам
вейер: вейер
запрет: запретили
долг: моральным долгие
репресс: волна
долж: народ
десятилет: десятилетий
довоен: производить
числ: число числе числа числом
гражда: мобилизации
период: период
вниман: привлекать
видн: охоту
экономист: старый
антифашистск: называли
очеред: первую
глобализац: ускорила
решетк: повезло
виде: видео
ликвидац: требует
подход: протестантов подходил
положен: закрепилось
антигитлеровск: союзникам
продовольств: продовольствия
явн: отмечали
сепаратист: сепаратистами
завеща: порядку
депутат: депутата депутаты
победител: союзника
бизнес: малого
принима: федерации
объединен: объединение еэс хдс
тиф: умер
отрасл: ряда
общ: общее создать
гражданск: ввели
окончан: окончания
обитан: обитания
недел: неделю
поддержива: поддерживали
включ: расширился
снабжен: снабжение
побольш: побольше
обм: приезжал
повод: повод
культурн: культурный
материальн: стремился немыслимой
азиатск: странами
сред: среда среди
социальн: рыночная политическим
мног: миропорядком многие
уста: сохранить
контакт: контактов идти
избежа: бухенвальд
планирован: комиссии
заместител: заместитель
возрожден: возрождение начал боялись
индокита: войнами
критикова: полемике
гитлеровц: бывшие
взят: готовы
пожа: пожал
разн: разных
взял: голосов
последовател: отставки
матрос: матросами
отдав: франко
пошлин: налоговые
сдержива: нато
конкретн: представляет
ожидан: превзошла
акцент: акцент
избега: глаза
производств: державы снято малых управляя
одн: родного одним
бундестаг: проводах
протестант: имени
шницел: шницели
отчаст: отчасти
пода: попытался
столиц: столица столице бывшей
действова: маршаллом
масс: немцы
антибольшевистск: нужен
помощник: помощника помощником
итал: помощи
склон: склоне известно
ведущ: позицию эрхард
насчитыва: размещенная
монопол: ликвидированы
беглец: разыскать
участ: холодной избежал
смотрет: призвал
регион: хозяйственные сталелитейным производствами тихоокеанского
поскольк: чуда
горазд: продвигается
сентябр: сентября
испытан: испытания
массов: преступлений
тон: сократилось
глав: главы главу началась главой глав
глаз: глазах либо
ближн: любовь
сраз: сразу
обвин: низложен
убийств: угрожать
бон: бонна бонне
холодн: элементом
половин: берлина
аденауэрканцлер: ушло
вполн: население
продума: ресурсами
университет: университета университет
новост: новости
существ: наднациональной
перв: установилась администрация затрагивать первому первой первыми парламентских первая тратиться
бог: завещанная
близк: боялся
приня: ассамблея
добр: деактивирована проработает добра
христианин: христианин
переплет: прочно
каш: кашу
основ: шумана добиться
отстава: отставал
отставк: накануне объявил указывает
боя: доме французы
как: группу подчеркивают
отставн: прощальной
детств: детстве детства
ярост: ярости
участниц: компании
кпсс: кпсс
герман: германия германии сделает германию
отрочеств: отрочестве
произнес: произнес
фильм: показ
встреча: визиты
прокурор: прокурора
критик: идеализм руки
реальн: пожаловать
тяжел: тяжелое экономическое поста
совмещен: совмещенной
точк: болевые
партнер: странам
установлен: установленная
преподнес: преподнес
влиян: геополитического
отколол: откололись
советник: назначили
учет: основываться
таможен: монополии
аспект: аспекты
предлага: союзу
маленьк: маленькое
соглас: согласился
гарант: угля региональной
забастовк: забастовках
успех: успехи успехам успехов новое
появ: появились
призва: сыновей режима
рейх: рейха
вернут: вернуться пленных
берлин: западная берлине
наряд: наряду
вернул: вернулись
гарантирова: должны
рейн: отправился залп
четверт: четвертым
конфликт: конфликт
перестраива: общество
наканун: сомневался
вообщ: коммунального
пролетариат: пролетариата
личност: перейти
поезд: поезд
р: город
х: х
показа: парламент
поэт: поэтому
отправ: спасителя буксир
звезд: желтых
памят: исторической
усмотрен: своему
идеальн: идеальное
безопасн: комфорт
орга: международного
зарекомендова: зарекомендовал
повезл: вновь
девушк: девушке
нажм: опечатку
коллективн: разговор взять
резк: правления
патриотизм: патриотизме
власт: власти властей власть
немыслим: францией
европеец: европеец
приобрел: приобрел
французск: отцы
ожива: постепенно
важн: важную выступлениями риторики отдавать
город: перебрался города городе
аргумент: рациональность
национальн: национальном национальной
единен: сделал
шанс: систем
еаэс: евразийского
могл: избегал могли
еэс: сообщества
переворот: переворота
опа: победителей
повышен: постоянное
подписа: главную
действительн: переплетены
выделя: выделялся
больш: большей нес большой большая
мест: создали закалки рейну
похорон: инфарктов похоронил
карьер: карьеру
ясн: ясно
пуга: пугала
видет: видеть
многотомн: выйдя
погребен: церемонии
британц: угрозу
редакциярекламаконтактыпресс: отключены
надея: надеяться
видел: присоединили
окружен: анклавом
жизн: жизни
жан: проект французский
опережа: коридоров
населен: населения ужасах область
сформирова: сформировали
угольн: подчеркивалось саарским передать
шарл: французов
разыска: сумела
пыта: пыталась усмотрению
добродетел: добродетели
американц: англичане помощь
перестройк: предсказал
смог: молодежь
митинг: митингах
сторонник: сторонники идеалистами сторонников сторонником
развернул: покаяние развернули
подготов: подготовить
боеприпас: процессе
советск: прокси советская советские правительстве группа занятая советской падение
отц: отца настоящим будущие
чиновник: чиновник
меня: менял
банковск: арестовали
вызыва: понятная
опыт: обмена
гельмут: эпохи
рынок: открытый
последовательн: развития позволяло
магистрат: магистрат
шуманминистр: робер
увер: твердо
рациональн: сухость
соображен: прагматические
пенсионер: заботился
агент: агенты
расследован: обстоятельное
жен: семью женился монастыре жену
дружествен: попытках гораздо
закалк: старой
установ: четко меркель нежели
иностранц: недолюбливал
католическ: аденауэровского католического
войск: поделена войска советских
суров: суровые
код: код
народн: большинство
сократ: производство
кол: гельмута
угрожа: стали неизбежна
вряд: вряд
кор: коров союзом
разрух: разруху
пожалова: добро
социа: социал
соединен: стадия
сумел: полиция сумел
надав: оппонента
отказа: отказался наотрез
убежден: убежденного
эрхард: экономист
очк: прибавила
граупенауэр: граупенауэром
нелюбов: нелюбовь
старш: старший
филит: филитов
асессор: асессора
возраст: опала возрасте
галер: галереи
проявля: форме
сохран: оружия думал
политик: межгосударственных политик мировую внешней политику налоговая политиками
окончательн: окончательно
чин: чина
кпг: кпг
характерн: управлении
тупик: зашла
понемног: становилось
преступлен: вину расследование
евроатом: создании
паден: поделили перестройку
жил: одно армию
воюют: воюют
вал: оборонительным
уверен: трудностей
стара: старался
возвращен: возвращение поставил
горел: иностранцев
добровольц: добровольцев
учитыва: политика
преимуществ: преимущества
впрям: осторожно
пост: посту уход пост
сухост: выступлениях
итог: итоге итогом
лидерств: лидерством усилила
европейц: считает российской
стремительн: стремительно
жит: жить
внутрен: помощью
вскор: вскоре
десяток: разменявший
пришел: пришел
элегантн: нашли
проигра: проиграла
проход: прощание
обществ: общества современное
пространств: региона
несмотр: восстановлении
национа: национал
срок: сжатые
единств: основанием
держа: союзных держать
перлов: перловую перловая
ввп: ввп
избра: сотрудничества избранного
уда: удалось
территор: лагерь отдельной падения
прусс: пруссии
минус: минусах
угл: поставках
смен: сменившихся сменили
отверга: отвергала
аэропорт: аэропорт
коммунизм: коммунизма
лавочник: лавочник
месяц: месяца
внук: коля
альянс: корее
жми: жми
пушк: покинул
тоталитарн: неприязнь
бо: смерти
диктатор: диктаторы
абсолютн: взяли
господств: безграничного
работоспособн: возлагала
нашл: монне
недолг: недолго
век: века век
предполага: предполагал
вел: вине
очередн: очередных шла очередным
вер: верующим верен легитимности
популярн: популярнее теряла
декларац: приняла планированию
показ: массовый
сотрудничеств: ожидания торгово
ускор: экономику
простот: дополняла
одноклассник: одноклассников
окажет: окажется
кампан: кампанию
уеха: закона
нача: организации одобрения гестапо оккупационной организаций
идеализм: христианский
реализ: последовательно
перспектив: перспектива
хлопот: решеткой
значительн: италия глобализацию
оруж: ядерного атомное
королевств: королевстве
рейнск: разъезжал
плеч: плечах
возникл: землях люксембург
концлагер: расчистка
речн: водрузили
вещ: риторика
плен: московских
канцлер: канцлеру канцлеры первым канцлер сбивали
де: шарлем
разъезжа: лично
груб: грубой
переж: немцем пережила
нестабильн: нестабильное
представ: какую
препятствова: члены
консерватор: консерватором
контрол: контролем промышленность возвращении
задач: задача
придержива: возможно
трех: трех
прокламац: прокламациях
трет: третьего
прилетел: прилетел
ликвидирова: соглашению предложили
развязыва: станет
достигнут: понимают равноправные
разменя: конце
влиятельн: влиятельной
ед: еду
искусств: искусством
треб: народов
задума: популярность
коммунальн: одаренного
вин: разговоры коллективную
парламентск: христианской парламентским стоять
довер: вызывала
зрен: позитивные
недолюблива: впрямь
факт: учете малоизвестном
зрел: зрела
диктатур: диктатуры
довел: довелось
имевш: имевшую
гибк: кредитам
биологическ: химического
вид: центристской
грянул: грянула
благосостоян: материального предприятий
расправ: расправе вещей
навсегд: навсегда
противопоставлен: мнению
внов: тифа
градоначальник: градоначальника градоначальник опытом
красн: красные
чуд: экономического
договор: договор зоны
повтор: успех
наук: наука
бронх: бронхит
сдпг: демократическую
эпох: эпоха характерная
мост: воздушный
сантимент: места
известн: сантиментам известный
воссоединен: надежды
сторон: госплане занять окруженным стороны
постав: прихода
эппл: николай
поток: потоки
указыва: работу
тысяч: тысячи вопрос
ассамбле: расширять
родственник: родственники родственников
претенз: неожиданными
евросоюз: прообраза
родн: родни уехав явно
принцип: заложили принципам народы
разъединя: изготовления
ид: привычный
бассейн: угольным
безработиц: безработица
ин: знаем
республик: республике республики республика демократической
сыгра: сыграть соображения неясно сыграл
обретен: катастрофы
плат: готово платили
революционер: революционерами революционеров
обяза: обязана
план: благосостояния зрения реализация
образова: образованного
публичн: лицо курса
гроб: службы
арестова: коррупции
разва: разрушений
коридор: инфраструктурных
гроз: деятельности
выгодн: настолько
поставля: самолетов
карикатур: опубликовали
ключев: притяжения ключевой
замет: заметили
идеалист: вопросам
распоряд: грамотно
трат: приходилось
трап: трапу
льна: льна
объяв: покинуть правлении объявить
трудност: реализуются
покаян: толком
накаля: блока
лейтенант: макса
шлибуш: фриц
черн: сине
черт: черты
протестантск: протестантской
гитлер: гитлером гитлера
производствен: управления
вне: состоял
никола: памяти николаю
непригодн: непригодным
понятн: доходчивая европейцам
секретар: секретарь секретарем
масштаб: масштабах
чест: честь
огромн: открывает огромного
священник: пауль
примирительн: двигаться
ответствен: ответственность
бенилюкс: поддержали
мощност: промышленными
вол: волю волей
отлич: отличие отличившийся важным
побед: администраций строитель
неприязн: объединяла
четк: уверенно
местн: ландтаг
сист: систему соперничество
ячейк: появляться
упорств: упорство
сбива: козни
корреспондент: современник
согласовыв: согласовывая
образцов: образцовым
государств: государства государств государством государство долларов прочего
собор: кельнском
бомб: атомной
хрущев: хрущевым
управленец: управленец
налогов: реформы гибкой таможенные
отплат: отплатили
несменя: адрес
проблем: проблемой
саар: земля следующем
ужас: помнящее
раздел: сторон
коммунистическ: коммунистическую противоборстве
исследовател: наследием
об: обе
унифицирова: пошлины
владимир: владимира
лучш: показала
дума: последователей
поприщ: поприще
меща: мещан
госучрежден: госучреждениях
оо: информация
возможн: верил тесной русских огромные возможной
оп: опыт
политолог: единства
молод: молодого молодым
открыт: еоус
межгосударствен: развитие
хочет: хочет
сателлит: условия
все: всей
евразийск: укрепления партнерство
меша: мешало
круп: крупа крупами крупы
присоединен: проголосовали
взгляд: иной
восстан: восстание восстания
бывш: велись невозможна бывший половина
бытов: цену
стабильн: сохранять стабильную
круг: кругах
выступа: империи
ребенк: ребенком
уничтож: риторически
спасител: беглеца
федеративн: федеративной гдр
революц: революцию революции революцией
наход: февраля находилось находилась
амнист: амнистия приказ
термин: состарятся
встал: заводы
ру: ру
говор: противники
впоследств: принимали
понима: понимал простой
лев: левых
лег: основу
стат: стать той статьи
воен: форпост лейтенанта военной управлением
строител: добрых
европейск: возникло европейской бенилюкса финансы евроатома
стар: сместить слоев
рабоч: рабочих рабочий немецкую
стал: уголь стало стала расправы
горожа: горожан
се: сей
социалист: социалистах социалистов рыночной
сосиск: сосиски
стад: действовать
реализова: невозможно
разрушен: пострадавшим встали разрушенную
центр: центра оказались опережающего
работ: работе управленческой преступления активную
оккупацион: ликвидировать оккупационные британская советником месте
замедл: среднего
пок: христиан
радикал: радикалами
инфраструктур: сроки
единоличн: единоличная
человек: человеком человека человеку
приятн: вообще
охот: начало
интеграц: экономическую интеграции
вооружен: вступления позволяли вооруженного
бюргер: бюргером бюргеры
то: присоединение
знакомств: сыграло
императив: конкретный
структур: структуры интересам
вывес: вывесить
приземл: приземлился
подел: союзники территория
котор: которую котором которым
обступ: обступили
ув: увы
изготовлен: использовались
силов: силовые
благ: благо
запад: отступить
отдава: пришло
бурн: бурных могла
кельн: кельн кельна
шаг: шаг существует
вест: стоило
самоотвержен: самоотверженности
драм: драмы
визит: международные визитом
ландтаг: первых
майор: соратник
либ: обсуждать
ушл: капитализма
весн: весной
претендова: франция
фрайкор: фрайкоров
вывел: вывел
член: амнистии ведущие
книг: эппле
прост: важнее простого
союзник: надежного армия желанием денег
альтернатив: альтернативу
позвол: задолго оживала американцев
разрознен: объединения
сосед: взаимодействие западных
справ: справился руинах процессов
свободн: рынок
лиц: критиковал лица
встреч: булганин
встрет: встретить
хх: хх
современник: европой
внешн: суверенитета
опубликова: старину
завод: урон крупных
цк: цк
пострада: коалиции
одновремен: выступал
отказ: решительный
идеолог: идеологов
родител: родители
ориентац: социальной
камн: камни
пут: пути особый путем
активн: активно продолжить
ялтинск: договору
русск: смотреть
взаимовыгодн: основании
немц: европейцем немцам немцев прошлое
строительств: строительству
гестап: зря
самолет: сотни самолет
должност: должности должность
пропаганд: пропаганда
класс: класс класса
неизмен: работающие
торгов: взаимовыгодного
частн: работали
труд: труде
контролиру: регионом
нема: немало
путешеств: путешествия
закреп: закрепиться потсдамской
старин: старинной бурной
старик: прекратил фигуры
ресурс: внутренними
процесс: нюрнбергских траурной неотъемлемой
молодеж: привлекали
напрот: отставка
европ: позволила восстанавливали интересно европы
хотел: хотели хотел
нововведен: нововведение
дружб: атлантическая
репетирова: репетировал
уступ: лидерство
продолжа: продолжал продолжаются продолжались
католик: католик католиков
помога: помогали
помощ: экономическая адресатами иностранной
современ: избрала прошлом стоила
снос: сноса
волнова: послевоенные
новообразова: новообразованной
здоров: здоровье
заключ: заключен заключили
попытк: ангела
опасн: опасными кризисом казалось
отступ: спешили
будуч: будучи
будущ: будущее ненападения ячейки будущему будущем
желан: горел
божествен: противоречит
еоус: европейское
прекрат: работоспособных
спокойн: спокойным
грамотн: работы грамотная
нацистск: справиться бывших нацистском нацистская
немецк: немецких немецкие немецкой немецкого немецкий немецким социалистическую
подчеркива: личности жана
прокс: африке
патриотическ: патриотических
веков: ликвидации
спецпроект: спецпроекты
испанск: встречался
икскюльнемецк: икскюльнемецкий
закон: вне
француз: соседи лидером
казн: казнены
рост: экономический экономических
росс: дружественные позволяет россия
помогл: помогли
жалован: жалованье
помог: свидетельствуют
употребля: принципиально
почест: событием
процент: заметный референдум
росл: росло росли
мотор: мотор
ситуац: настойчив
каза: угрожающим вооружать
выдвинут: выдвинуть
помня: современной
маршалл: план джорджем
публицист: публицист
опечатк: ооо
шла: исходе
российск: ключевых
сплот: подход
взаимодейств: расширялось
стажировк: стажировку
политическ: политических политическую политической создавать жизненным политическая
невозмутим: прочное
раздава: раздававшие
использова: прошлые
обстоятельн: началось
юн: юный
достаточн: достаточно
шли: шли
настоя: настоящие настоящий канцлером
уличн: уличных
ядерн: биологического безопасность опасностью
сказа: замедлили
ссср: ссср
знаком: встречи
закуп: закупить
яв: явился
дизайн: принципы
невозможн: отраслей материально неизменность
яр: запомнили
помим: помимо
поясня: вооруженные
попыта: попытались антисоветская
рыночн: сторонниками главный
воздушн: знаменитый
провинциальн: провинциальный
сниз: снизилась
назнач: ндорфу
мощн: мощнейшей
гдр: республикой
заметн: составляли
назва: названный
товар: общий
пекар: пекарь
церемон: соборе истребителей
залп: дали
вспышк: вспышки
нацист: нацисты нацистов
зна: всеевропейского
небывал: небывалый
функционер: нацистских
объем: довоенных
стро: строя строю строй
представля: представляющими предложение
друг: другом друг действий
автомобильн: автомобильную
зон: франции оккупационных
помеша: близившийся
предпринима: смогли противостояния
тайн: остерегался
народ: невозможной уважать народа отдельному
компан: частные
выглядел: иначе
делов: деловые
действ: действия предпринимать последовательную приехали шаги совместных
велик: великий
избирател: процента
преклон: преклонном
приезжа: моссовет
стоя: жестко
поражен: первые поражение
противоборств: интернационал
христиа: лидеру
рад: ради
региональн: остальных
раз: разы
водруз: гроб
дотошн: дотошный
сохранен: императиву
интернет: интернет
краеугольн: краеугольные
сплочен: сплоченности
привычн: вступал
великобритан: войсками воспользовались
велич: величия
соев: соевой
знам: знамена
выстро: выстроил выстроить
знал: знал
поставлен: поставленного
мюнхен: мюнхене
штат: соединенные уступила
поставк: бесперебойных
комментар: долгосрочный
сотрудник: процент
проч: благосостояние
адрес: критики
зря: полиции
решительн: вступление
работа: ценами работать работай исправно работал
сильн: устала сильные
блок: социалистического
уменьш: пытались
русл: атомные
заинтересова: позиции
англичан: христиане
необходим: поставляли
проб: пробыл
отошл: населением
евре: евреями
шум: шум
кризис: кризисы кризисе карибским кризиса
аденауэровск: аденауэровская аденауэровское статье отличием
демократическ: демократические христианско противника демократическое германской
прощан: торжественностью
подрыва: христианства
историческ: дружба исследователь
выйд: россией
оста: противопоставление
быстр: поскольку возможностью быстро
конституцион: конституционного
подозрен: репрессий
спрос: создал
популяризац: популяризация
намек: намекая
министерск: министерскую
имперск: имперской
реч: речь торжественные
реш: решили смог
многолетн: воспользоваться
международн: контроль международная совершал
генеральн: моннеруководитель
залож: объединений заложить
знаменит: наладили
гимназ: гимназии
госплан: обобществлении
центрист: центриста католических
продвига: основе
соста: конституции
чувств: чувстве
наблюда: процессией
люб: должен
восстанавлива: разрушенной
снят: оборудование
фон: фон черном
обеспокоен: головановполитолог
обязательн: собственная
фрг: фрг
гот: споре
соседн: соседних
отправл: отправлены
аденауэрпредседател: подрывает
ставш: ставший
отправк: грозила
год: годы годам годов
лагер: тысячах лагеря коммунистическим отправили
открыва: стабильность
министр: декларации совета
законодательств: унифицировано
неизбежн: ремилитаризация
создан: вплоть решения
особ: пережив
набережн: захоронения
протекц: протекции
расход: резко
ближ: силу
близ: возраст
волн: очередная
мал: гигантов появлялось
продав: израилю
настольк: сотрудничество
приб: прибыл
улиц: улицах
свидетельств: биографы
расширя: русле продолжили
инфаркт: серии
сообществ: европейского
объединя: сдпг
подня: поднялся поднялись
апрел: апреля
стен: разделили стены
вермахт: майор
нежел: взгляд
незадолг: незадолго
адольф: адольфом
франсиск: испанским
атрибут: добился
задолг: оккупантов
голосован: очевидцы
союзн: конференции
войн: войной войны возрождения войне война войнах войну колониальными
историк: историк
войт: войти
анклав: столицы
безграничн: факта
послевоен: основанным послевоенной первого послевоенного послевоенное
деятельн: антигосударственной
благодарн: благодарны
производ: должна
состар: поздно
фракц: фракции
желт: флаг
проигрыва: проигрывала
порядк: порядка божественному порядке
неясн: парня
боннск: боннского
зависет: зависеть
сталелитейн: рурским угольную угольной
похож: похожее
расчистк: режиме
избран: избрания
руин: лежащий
фабрик: заводов
пропагандистск: пропагандистскую
болев: надавить
неудобн: книге
франц: референдуме сша германией
запомн: запомнились градоначальником политике
прочн: доверие европейских понял
франк: франсиско
шест: шести
зонтик: ядерным
национализм: представить
всеобщ: всеобщем ориентацией
противореч: проявлялся
определ: определяя определил
грауп: граупен
голос: следующих
напомина: лагерях напоминали пенсионерах
вылетевш: вылетевший
карибск: обеспокоенный
химическ: собственного
переговор: контакт исторические
освобод: освободившийся
вегетарианск: вегетарианских
прошл: союзников осталось неудобное интеграцию
род: интересах родился
оппонент: уничтожить напоминал
рол: роль роли
однозначн: однозначным аденауэрканцлер
форм: тоталитарным национализм
мер: мерой товаров
интернациона: ярого
долгосрочн: реализовать
легитимн: идее
конференц: ялтинской конференция
готов: массе вполне
максимальн: понятно
заявк: подать
информацион: информационный
вступа: рабочую
парламент: местный
занят: часть
обоснова: обосновавшись
мобилизац: разрозненных
конц: ближе конца мидлтон
меркел: ангелы
сытн: сытную
проработа: пенсию
практическ: практически
принос: влияния
потсдамск: капитуляции
послед: неподалеку
муштр: муштры
вектор: голованов
единствен: сохранилось
наднациональн: примером
робер: очередь иностранных
дава: отношений
мир: мир миру
мальчик: мальчику
оборонительн: антифашистским
предприят: семейных
рассчитыва: рассчитывали
обсужда: публично
привива: прививали
обер: обер
христиан: демократы
феврал: держав
ранен: раненых
адресат: главными
провед: казался
получ: получили получил
зашл: ситуация
ндорф: р прямо
контактирова: американцы
экономическ: экономической отказались центре достигнуты связывают быстрый усиления
комфорт: бытовой
рук: сильной руку
правлен: формам голосования правление
сострадан: сострадание
рур: правительство быстрого
компенсац: марок
прусск: прусской прусских прусским прусском
покинут: пришлось
прям: прошли
рурск: бассейном
непримирим: непримиримым тупик
позиц: непримиримой примирительным штатам
покинул: последний
дипл: диплом
эмм: эмме
истребител: пролетели
миллиард: примерно
моннеруководител: сохранения
германск: советскими
потенциа: промышленный
блюд: блюд
дипломатическ: дипломатические
иде: опасной
счет: банковские
игр: игра
полезн: полезным
удел: отставной
попаст: попасть
свастик: свастикой
эффективн: максимально эффективный
устанавлива: свободно
смогл: органа
расшир: союз
суверен: атрибута
идт: отказывалась
импер: центристов
козн: мнение
деятел: видными
солдат: солдат
забит: забитых
сотн: мост
мол: молись
центристск: возрождению
момент: момент
гнуша: гнушался
мон: жан
булганин: министров булганину
принципиальн: капитализм
основн: численность
смест: восстановлением задумал
управленческ: многолетний
основа: солидарность
опальн: опальный
решен: приняты продавил
биограф: участи
прощальн: уходя
провод: речи
личн: личные граждан
средн: бизнеса
поздн: оппонентам
смерт: достигнута
делегац: делегации
далек: далеких
мощ: мощи
сжат: позволил
земел: родных
ввел: ограничения
кельнск: кельнского кельнской кельнский проходило
результат: результаты
жизнен: повышение соответствует
любв: любви
дал: пушки
рассудительн: рассудительным
пониман: понимание
протекторат: автономным
предложен: друга
приезд: приезда
мечта: социалисты
демилитаризац: полной
сопротивлен: присоединиться
ремилитаризац: идеей условием
референдум: прошел проголосовала
имел: похороны поддержки
имен: одновременно
возобновлен: переговоры
состоя: счета
неподалек: ндорф
станет: гарантией
форпост: антибольшевистский
осторожн: вести осторожности
хрущевперв: хрущевпервый
ставленник: выглядел
бюрократ: бюрократов
формирован: формирований
брат: братьям
пошел: пошел
брак: брак
хдс: союза
провинц: рейнской
мук: муки
предлож: элегантное восстановления
невест: невесты
доступн: доступную фабрик
границ: новые
обескураж: точки
малоизвестн: напоминает
продемонстрирова: продемонстрировала
восток: дальнего
вмест: вместе
финансов: продуманные финансово
уход: рассказывали уходили покой коллег
полиц: тайной шлибуш
правительств: правительства отсутствие оккупационное
марок: крупной
начал: начале
заня: занял заняли лагерем
сынов: дети
поколен: политики
высш: высшего
воскресен: воскресенье
материализм: марксистский
солидарн: политолог
вспомина: вспоминает
обеспеч: руре
вошл: священник
дел: проблем делах
вопрос: расходились насущные решить
соперничеств: накалялось
сохраня: партнерам
блестящ: блестяще
прельща: прельщали
намечен: канцлера
мемуар: многотомными
москв: москве
прообраз: фоне действиях
усил: значительно
семейн: производств
собствен: собственную вооруженных суверенной
измен: изменила границы
британск: британские британской последних
консультирова: председателем
отказыва: возможность саарские
дет: жены
неотъемлем: сталелитейной
восстановлен: восстановление программа справится основания
саарск: считала районами
восточн: восточной возникли
отношен: отношения возобновление позициям
австр: австрией
угол: спрос
продл: продлилось
услыша: услышать
район: крупнейшими
западногерманск: включив территорией
хозяйствен: хозяйственной передвинет
ряд: целого
последн: стороне погребения наблюдали
паул: слово
сам: самую самые самым
детьм: женой
миропорядк: послевоенным
инач: очков
возлага: однозначно
переда: суверенитет
наотрез: сателлиты
называ: стеной
управлен: действующей отошла развала находились
наслед: нацистским
неожида: неожиданнее обескуражить неожиданной
принят: европейские
уважа: любить
скрупулезн: скрупулезный
начина: начинающий
вступлен: заявку ремилитаризации
западн: относилась сторону коммуникации участия
сопровожден: сопровождении
обобществлен: мечтали
пасл: паслись
област: саар
церкв: церкви
сво: регионов своем своим
голован: михаил
станов: старика становились
лежа: видел лежала
парт: партию партий партии
потрясен: потрясений
парн: приятного
тесн: законодательство
молочн: молочных
парк: парках
выступлен: провинции публичных
теря: понемногу
развит: векторы страной
демократ: демократами демократии демократия глава
обеспечен: обеспеченного
оборудован: потенциал
продолж: помешали выгодным
хроническ: хронический
происход: происходит
обществен: карикатур
пользова: пользовалась
мидлтон: дрю
хвата: хватало
конструктивн: конструктивные
ценност: ценности
люксембург: нидерланды
перейт: претензиями
нсдап: нсдап
истор: историю истории
посвят: посвятившему
еврейск: компенсации
спеш: военные
праздник: празднике
аденауэр: коллективной аденауэр аденауэра аденауэру контактировавшие
пробл: соседями
юриспруденц: юриспруденцию
призыва: призывали
насущн: волновали
нюрнбергск: вопросы
сем: большую семьей семьи
флаг: создания флаги прообразом
произошел: произошел
сер: скончался
налад: инфраструктуру великобритания
легл: легла
пастбищ: пастбищ
умер: территории
доход: доходы
вплот: дизайн
одобрен: еврейского
закладыва: закладывал
стрем: материализм
позволя: невозмутимое стратегия поражения позволял
возрод: возродил
урон: непоправимый
прибав: напротив
городск: городской городские городских
социалистическ: противостояние внимания
дом: жили
поддержа: плана меры
берлинск: берлинской
поддержк: поддержке народной значительную
остальн: сталь объединила западного
любов: богом
голл: де
глубок: глубоко
доб: западногерманское эффективного
хорош: хорошие
никит: никитой никита
исправн: важны
любим: любимую
опира: опирались
нац: единения
недочет: недочетом
фундамент: фундамент
религиозн: видом
одарен: запомнил
большинств: большинства абсолютное
сил: сила сил полную лучшие
син: звезд
доллар: миллиардов
марксистск: критику
управл: сути
держав: ведущей
нат: основные
составля: миллиона гитлеровцы
информац: редакциярекламаконтактыпресс
основыва: структура
земл: объемов западногерманская
социализм: социализма социализм
приказ: подписал
противник: повторился противником противников главного
бельг: присоединились
спуст: спустился спустя
автономн: сделала
объедин: федеративная дальнейшей разъединяли
переста: перестал
инфраструктурн: размещения
размещен: войск пространством
притяжен: центром
младш: младшего
катастроф: тяжелейшей
траурн: набережных
дрю: корреспондент
моральн: рода
засверка: засверкали
равноправн: прочные
коллег: консультировал
миров: мировая вошло мировых мировой
низлож: объявили
забот: забот заботой забота стариком
надежд: никакой
соответств: система
председател: участвовал председателю поясняет председателя
приеха: церемонию
сми: сми
надежн: сместили
сло: уровня
нидерланд: бельгия
передвинет: изменит
федерац: состав
союз: советским советскому военный демократического
стран: россии востока страны стране страна обретение стран
настойч: тонн
уровн: жизненного
коалиц: антигитлеровской
укреплен: еаэс
бухенвальд: отправка
качеств: качества качестве
усидчив: усидчивым
прошел: сааре
выбор: выбор выборах
наскольк: насколько
головановполитолог: зонтиком
соверша: мемуарами
баланс: балансом
антисоветск: укреплялся
шума: робера
угроз: угрозы сдерживать
орган: государственных органах
нес: сопротивлению
относ: остальные ближнему
сконча: нации
пошут: пошутил
пойдет: пойдет
интересн: боюсь
дальн: сибири декларацию
просуществова: просуществовала
крупн: наладить решение контроля
всеевропейск: старательно
прозва: прозвали
превзошл: действительность
потряса: потрясающие
надвига: запада
риторик: ним дружественной
монастыр: жил
радикальн: радикальных
воспользова: правильно остальной
преимуществен: преимущественно
выплат: произошедшее
миллион: насчитывала
гест: гест
никак: давали
ленин: ленина
der: der
xx: xx
ctrl: ctrl
xix: xix
york: york
alt: alte
time: times
enter: enter
