случ: случится
ру: ру
говор: говорится говорили говорить
вениамин: вениамин
понима: понимает
оттуд: оттуда
значен: значении
стат: стать статье статьи статей
воен: военных
обычн: обычную
европейск: европейского европейских
рискова: рисковать
рабоч: рабочие
юзер: юзера
радужн: радужную радужных
стал: стали стала стало
подписант: подписантов
мнен: мнение мнению
объясн: объяснили
превыша: превышающую
последств: последствия
работ: работу
сценар: сценарии
среднестатистическ: среднестатистическому
арх: архив
экономик: экономика
правов: правовой
сто: стоит
манхэттен: манхэттене
европол: европоле европол
человек: человека человеком
критическ: критические
некоммерческ: некоммерческой
специализирова: специализированных
вооружен: вооружение
макияж: макияжа
должн: должны должна
структур: структуры
публикац: публикаций публикации
миллиардер: миллиардер
ненужн: ненужными
человеческ: человеческим человеческую человеческой человеческий человеческое человеческого
назван: названием
котор: которую котором
цивилизац: цивилизацию цивилизацией
времен: временем
пос: посыл
силов: силовые
секретн: секретные
ум: умы
приостановк: приостановка
медлительн: медлительны
связа: связанных связаны связан
прав: правила
проект: проекту
ирланд: ирландии
появля: появляться
относительн: относительного
опас: опасен
инопланетн: инопланетную
дела: делает делал
сцен: сцена
сущ: сущее
верс: версии
обеспоко: обеспокоился
позитивн: позитивным
разобра: разобралась
альтернатив: альтернатива
языков: языковая языковые
ауд: аудио
россиянин: россиянин
сосед: соседа
предупред: предупредил
заработа: заработать
юдковск: юдковским юдковского юдковский
очевидн: очевидно
нов: новым новой
умеет: умеет
атом: атомы
част: часть
опубликова: опубликованное опубликована
сдела: сделать сделает
деактивирова: деактивирована
сложн: сложно сложнее
пут: пути
штук: штука
расшифрова: расшифрованную
систем: системы
выход: выход выхода
пропаганд: пропагандой
вкладыва: вкладывал
упрощен: упрощенно
апокалиптическ: апокалиптические
генерирова: генерировать
кибератак: кибератак
непейвод: непейвода
летн: летней
персональн: персональные персональными
путешеств: путешествия путешествуют
сша: сша
машин: машину машины машин машинам машинного
лидер: лидер
процесс: процессами
групп: группу
помогут: помогут
техник: техника
медицин: медицина
европ: европе
превзойт: превзойти
культур: культура
возняк: возняк
актуальн: актуальными
лнр: лнр
продолжа: продолжает продолжаться
помога: помогать
рынк: рынке рынка
опаса: опасаются
рисова: рисовали
насторожен: настороженным
современ: современные современности
помощ: помощь
врач: врачам врач
разработчик: разработчиков разработчики
выступ: выступили
секунд: секунды
неправд: неправдой
опасн: опасность
вклад: вкладе
текст: тексты текстом текстов
будущ: будущего будущем
разум: разума
прекрат: прекратить
нуж: нужен
шир: шири
опасен: опасения
визуализирова: визуализировать
интерес: интересами
силовик: силовики
отключ: отключены
спецпроект: спецпроекты
плох: плохо
росс: россия россией
фбр: фбр
мотор: мотор
разорва: разорвавшейся
числен: численностью
ситуац: ситуацию ситуацией
гигант: гигантов
счита: считает
эффект: эффект
отсутств: отсутствием отсутствие
молекулярн: молекулярное
цел: целом целях целую цели
лент: лента ленту
изуча: изучает
середин: середине
человечеств: человечества человечеству
опечатк: опечатку
эр: эра
канал: каналы
взаимодейств: взаимодействия
создава: создавать
искусствен: искусственному искусственные искусственного искусственный искусственном
серьезн: серьезные
частност: частности
довод: доводы
использова: использовать
достаточн: достаточно
предположен: предположения
професс: профессий
выйдут: выйдут
список: список
ядерн: ядерной
кадр: кадр
затронул: затронул
заражен: зараженные
ссср: ссср
строг: строгом строгие
успеет: успеет
институт: института институтом
организац: организации
невозможн: невозможность
побуд: побудить
коротк: короткого
так: такого таки
нашумевш: нашумевшего
картин: картину
поменя: поменялось
семейств: семейства
сниз: снизит
мощн: мощный
фантазир: фантазируют
заметн: заметно
блогерш: блогерши
назва: назвал
сверхчеловеческ: сверхчеловеческому сверхчеловеческий
описыва: описывали
вредоносн: вредоносный
умрет: умрет
некотор: некоторые
потенциальн: потенциальных
соглаша: соглашается
ген: гении
диалог: диалог
приостанов: приостановить
спорт: спорт
методик: методики
услов: условиях
интеллект: интеллект интеллектом интеллекту интеллекта интеллекте
представля: представляйте представлять представляли
виртуальн: виртуальные
друг: другом другими друг другую
поня: понять
компан: компанией компании
ограничен: ограничения ограниченную ограничение
программ: программе программы
получа: получают
главн: главное главных
действ: действуют
привел: привел
наруша: нарушает
взросл: взрослых
конкурентоспособн: конкурентоспособными
уверя: уверяет
созда: созданные созданных создают создана создать
имеющ: имеющимися
исход: исходят
отдельн: отдельного отдельных отдельные
интернет: интернет интернета интернете
соосновател: сооснователь сооснователей сооснователем
вступ: вступят
колоссальн: колоссальные
визионер: визионеры
тел: тело
тем: тему теме
основател: основатель
применя: применять применяться
официальн: официального
пришл: пришлось
десят: десяти
знан: знания
комментар: комментарии
конкурирова: конкурировать
компьютер: компьютерами
работа: работают работать
сильн: сильного сильному
нанесен: нанесения
долж: должен
исключительн: исключительно
вызва: вызвал
десятилет: десятилетия
высказа: высказанные
числ: число числе
произвел: произвело
отошл: отошли
гражда: граждан
модел: модель моделей моделью модели
подозрева: подозреваемого
сложност: сложностей
вниман: внимание
сотруднича: сотрудничать
видн: видные видны
автор: авторы авторов
виде: видео
нынешн: нынешних
оста: осталось
быстр: быстро
эксперт: экспертов эксперты
спрос: спросить
бизнес: бизнесом бизнеса
принима: принимает
лык: лыков
объединен: объединение
внедрен: внедрения
остав: оставили
общ: общий
пригожин: пригожин
перечисл: перечислил
зада: заданной
обитан: обитания
состо: состоит
недел: недели
поддержива: поддерживают
включ: включая
повод: поводом
сред: среда среди
отдален: отдаленная
устойчив: устойчивой
мног: многих многие
люб: любые
похуден: похудения
способствова: способствовать
избежа: избежать
язык: язык
фон: фоне
захочет: захочет
фот: фото
обязательн: обязательно
стив: стив
злоумышленник: злоумышленники
правд: правда правды
разн: разных
письм: письмо письма письме
планет: планете
прорыв: прорывов
люд: людям людей
безразличн: безразличные
примкнул: примкнули
гибел: гибели
конкретн: конкретную
открыва: открывающихся
физическ: физический
создан: создания созданию
рассужда: рассуждает
потеря: потерять
перехитр: перехитрить
производств: производство
одн: одну одним одни одна
продаж: продажу
мыслител: мыслителя
согласн: согласных
настольк: настолько
потребн: потребностями потребность
рассыла: рассылающего
распространя: распространяется
инфоповод: инфоповоды
итал: италии
ведущ: ведущих
маск: маск маска
сообществ: сообщества
огранич: ограничить
апрел: апреля
таков: таковой
предупрежда: предупреждают
уникальн: уникальный
электрон: электронные
ограничива: ограничивать
десятк: десятки
использован: использование использования
неведом: неведомы
запрос: запроса
поскольк: поскольку
историк: историков
горазд: гораздо
войн: войны
сверхразумн: сверхразумные
март: марта
испытан: испытании
войт: войти
массов: массового
тон: тонах тон
процессор: процессоров
конечн: конечном
эмоц: эмоциями
неотличим: неотличимы
элиезер: элиезер
колонк: колонке
бот: бот ботом бота
болезн: болезни
похож: похож
ракет: ракеты
вполн: вполне
университет: университета
новост: новостей новости
существ: существ существующих
создаст: создаст
достижен: достижения
перехват: перехватят
добр: добро добра
написа: написанное написал написанного написанных
изменен: изменений изменения
автоматизирова: автоматизировать
чипирован: чипирование
нонсенс: нонсенсом
франц: франции
основ: основе основой основы
мед: медиа
повер: поверили
противореч: противоречие
боя: бояться
как: какими какого
определ: определиться
герман: германии
рассматрива: рассматривают
фильм: фильма
прошл: прошлого
род: рода
скептическ: скептически
реальн: реальна реальный реальными
обход: обходить
втор: вторят
риск: рисками риски рисках
точк: точку точки
сфер: сфера сфер сферы
партнер: партнер
мертв: мертвого
научат: научатся
способ: способен
форм: формы форму
мер: меру
илон: илон
избав: избавятся
доцент: доцент
продукт: продукта
обрат: обратили
найт: найти
провер: проверить
суперумн: суперумные
влиян: влияние
студентк: студентке
информацион: информационные
учен: ученые
конц: конце
предлага: предлагает
случа: случае
удал: удалить
практическ: практически
вернут: вернуться
предел: пределы
мысля: мыслящую
представьт: представьте
киберпреступник: киберпреступники киберпреступников
утвержда: утверждается
и: ии
единствен: единственное единственным
приблиз: приблизил
преврат: превратить
личност: личность
хакинг: хакинг
поэт: поэтому
несовершенств: несовершенство
мир: мир мире
укол: уколов
писа: писал
исследован: исследований исследования
совершен: совершенно
внешност: внешности
вагнер: вагнер
скор: скорое
опрошен: опрошенные
нажм: нажмите
резк: резко
феврал: февраля
говоря: говорящим
сообщен: сообщений
власт: власти
немыслим: немыслимые
тактик: тактикам
несущ: несущие
фронт: фронте
враждебн: враждебный
чат: чат
украин: украине
гранат: гранатой
раскр: раскрыли
выстав: выставил
прям: прямо
саморазвит: саморазвитие
отнес: отнесся
миллиард: миллиарды
ответн: ответном
мест: места
вырва: вырваться
ювал: юваль
вход: входа
драматизм: драматизма
существен: существенно
пуга: пугает
эффективн: эффективность
хакоэн: хакоэн
видет: видеть
устанавлива: устанавливать
представительств: представительства
редакциярекламаконтактыпресс: редакциярекламаконтактыпресс
жизн: жизни
зашедш: зашедшей
формальн: формальное формальным
чвк: чвк
юдковскийсоосновател: юдковскийсооснователь
пыта: пытаться
переводчик: переводчикам
развива: развивается развивать
основн: основным основных основные основной основном
составител: составители
сможет: сможет
сторонник: сторонников сторонники
привест: привести
утечк: утечке утечки
решен: решении решения
затрудня: затрудняет
удив: удивились
создател: создателями
личн: личные
нужн: нужное
устаревш: устаревшими
поздн: поздно
вылож: выложившего
выбира: выбираться
результат: результатом
дал: дал
ссыла: ссылаются
контекст: контекст
документ: документы документа документов
предложен: предложение
увер: уверен
глуп: глупы
незаметн: незаметно
внесет: внесет
дан: данные данными
фейк: фейки
веществ: вещества
раскрыт: раскрыты
станет: станет
код: код
гиперзвуков: гиперзвуковой
медицинск: медицинскую
угрожа: угрожающие
технологическ: технологические
автограф: автографы
пожалова: пожаловать
деньг: деньги
общност: общность
старт: старт
очк: очков
предлож: предложил
доступн: доступным
коммунициру: коммуницируя
возраст: возраст
вскольз: вскользь
галер: галереи
границ: границы
оцен: оценили оценил
политик: политике
тезис: тезисы
минимум: минимум
интеллектуальн: интеллектуальных
радиофактчекинг: радиофактчекинг
жив: живых
тупик: тупик
защитн: защитные
обнов: обновила
правительств: правительствами
несет: несет
разработк: разработку разработках
жил: жилья
сугуб: сугубо
экспертн: экспертного
гейтс: гейтс гейтсом
писател: писателей
поколен: поколения
программн: программных
наступлен: наступлении
медиа: медианная
преимуществ: преимущества
животн: животного
произошл: произошло
итог: итоге
полгод: полгода
вошл: вошли
ульян: ульянов
дел: деле
вопрос: вопросы вопрос
ближайш: ближайшее ближайшие
пересеч: пересечь
стремительн: стремительное стремительного
вскор: вскоре
прикладн: прикладной
текстов: текстового
ответ: ответом
изучен: изучения
обывател: обывателю
никт: никто
полност: полностью
несмотр: несмотря
срок: срок сроки
собствен: собственные
измен: изменило изменит изменилась
дет: детей
людьм: людьми
материал: материалов материалы материалом материале
абстрактн: абстрактными
обучен: обучения обучению
отношен: отношение
постбиологическ: постбиологическое
налет: налета
обща: общается общаются общаться
кита: китаем
последн: последнего последние последних
заявлен: заявлении
клеток: клеток
месяц: месяцы месяцев
сам: самых самые
захотел: захотел
жми: жми
фантастическ: фантастического
бо: боится
подобн: подобных подобное подобную
вероятн: вероятно вероятным
управлен: управление
фейков: фейковые
ира: иран
нашл: нашли
превосход: превосходить
билл: билл
нервн: нервных
достигл: достигла
заключа: заключается
коннектикут: коннектикута
предполага: предполагает
вер: верят
западн: западные западными западной
прогноз: прогноз
популярн: популярных популярные
смертельн: смертельной
област: области
научн: научных
пентагон: пентагона
сво: своими
шокир: шокирующий
нача: началась начали
специалист: специалисты специалист
пород: породила
порог: порог
перспектив: перспективах перспективе перспектива
станов: становятся становится
рекорд: рекорд
редактирован: редактирование
появлен: появления
сведен: сведений
развит: развитии развития развитого развитием развитие
станут: станут
сгенерирова: сгенерированные
руководствова: руководствоваться
контрол: контроль контроля
уничтожен: уничтоженных уничтожение
технолог: технология технологии технологиям
притормоз: притормозить
продолж: продолжим
задач: задачами задач
переполох: переполох
зеленск: зеленского
различн: различные различными
нейросет: нейросеть нейросетей нейросетям нейросети
смогут: смогут
ценност: ценности
пересобира: пересобирать
виж: вижу
безжизнен: безжизненного
задума: задуматься
посвят: посвятили
зрен: зрения
ес: ес
голливудск: голливудского
биологическ: биологическая
экзистенциальн: экзистенциальную
представител: представитель представителям представители представителей
сет: сети сетей
конфиденциальн: конфиденциальность
моратор: мораторий
днк: днк
наплева: наплевать
краст: красть
теор: теория
ноябр: ноября
разумн: разумную
нескольк: нескольких
кибербезопасн: кибербезопасности
реальност: реальности
наук: наука
прогресс: прогресса
позволя: позволять
дни: дни
скорост: скоростью
известн: известных известно известны
послуж: послужило
дор: дори
постав: поставить
берут: берут
призна: признают
эмоциональн: эмоциональной
глубок: глубокие
претенз: претензий
принцип: принципу
хорош: хорошие
стоимост: стоимость
реалистичн: реалистичны
пребыва: пребывающего
предыдущ: предыдущего
наш: нашей
ин: иную
киберпространств: киберпространства
пользовател: пользователях
умн: умного умных умнее
арестова: арестовало
евген: евгений
нат: нато
антибиотик: антибиотикам
информац: информация информации
земл: земле
ключев: ключевые ключевая
выгляд: выглядят
противник: противником противники противникам противников
математическ: математической
ровн: ровно
замен: заменить заменит
предотврат: предотвратить
например: например
наводня: наводнять
контролир: контролирует
миров: мировом мировая
забот: забота
сверхумн: сверхумного сверхумных сверхумными
соответств: соответствии
попрос: попросим попросили
сми: сми
музык: музыки
учат: учатся
мощност: мощностей
волшебн: волшебных
стран: стран
аренд: аренды
январ: января
отлич: отличить
громк: громкой
сист: систему систем
отня: отнять
организ: организуют
соучредител: соучредитель
предпринимател: предприниматель
вычислительн: вычислительных
государств: государства государств государством
наскольк: насколько
бомб: бомбы
онлайн: онлайн
наводн: наводнить
проблем: проблемы проблеме
но: ной
заяв: заявила заявили
исследовател: исследователи исследователей
умрут: умрут
угроз: угрозу
владимир: владимир
управля: управляющий управлять
дума: думаю
формат: формата
произойдет: произойдет
оо: ооо
возможн: возможно
дальн: дальнейшее дальнейшего
всу: всу
харар: харари
американск: американский
выбра: выбраться
брос: бросил
буквальн: буквально
увелич: увеличить
внес: внес
рукотворн: рукотворную
упомянут: упомянутые
бойц: бойцов
выпуск: выпуска
восстан: восстании
бывш: бывший
изначальн: изначально
нечеловеческ: нечеловеческого нечеловеческие
радикальн: радикальным
изображен: изображениями
уничтож: уничтожить
филантроп: филантроп
миллион: миллионы
fotodom: fotodom
ctrl: ctrl
appl: apple
bi: bi
novo: novo
miguel: miguel
candela: candela
microsoft: microsoft
walsh: walsh
life: life
youtub: youtube
robert: roberts
getti: getty
dpa: dpa
joshua: joshua
globallookpress: globallookpress
enter: enter
chatgpt: chatgpt
lex: lex
iryna: iryna
imago: imago
bimmer: bimmer
sommer: sommer
fridman: fridman
lightrocket: lightrocket
gpt: gpt
ap: ap
openai: openai
reuter: reuters
shutterstock: shutterstock
killnet: killnet
susan: susan
futur: future
chat: chat
sopa: sopa
time: time
imag: images
fabian: fabian
