обвинительн: вынесения
случ: отбой
фактическ: вины
лаханин: евгению
фасад: выступавшие
обычн: обычный обычную
оказа: положительное ведущая опасность
ангел: спасаться
мнен: пожару освобождения
местонахожден: точном точное
реагир: выехали
собственник: компенсации
един: доносится
гуля: подгузники
заход: входит попытался
рекламн: автоматов перекрыт
дополнительн: закрыты
арх: архив
экономик: экономика
общественник: сформирована
прикр: заключения
сто: потерь
учебн: аэромобильного
возглавля: кинозалу
слома: отметив
поступ: запертого
разговор: опубликованный фрагменты записанных успокаивает
должн: придал принимать предприятия
суд: районном районный коммерсантъ благодаря дочерей помню избежал
макс: сгоревшей
вдогонк: двинулся
танзил: госстройнадзора семи
сум: вскрыть
жестк: ответ
благодар: разобраться
провест: попросил
техуслов: соблюдения
участвова: ростехнадзор
обратн: пробиться
отмет: получала вопросы пояснил конца
двига: кинозалов продолжают
проект: подготовлен номер соответствует
связ: выходить заходил
появля: оставались
дела: делали имена че
проектн: направили нарушением написал
слоган: летию
застря: местонахождении этажами
документац: проектную проектной проектная
режим: строгого ручном
располож: логичным школе
центральн: перекрыли шенгерей
веревочн: веревочной
прием: проблемы
воскресн: воскресный
проверк: стала бизнеса
дым: затянутому кинотеатра дыма
еддс: диспетчерской
вред: морального
ложн: ложных
родин: экстрадировали
православн: кованая
очевидц: вспоминали
нов: заметить произошли
двинул: сделать улице здания
противопожарн: отряда проверке
женск: отстраненный
част: частых части объективная
подъеха: первое
шенгер: светлана
алекс: ведомства
слов: словам документации
реплик: уточняющая
постоя: типа временным
выскакива: кинозала
системн: компании
сдела: наружу снимали подчиненные поставили сумев
определен: методику
расспрашива: полиции
деактивирова: нажмите
сложн: виду
дают: советов
совет: сельский рамках
терпен: втроем
денис: позвонил детства
вперед: пошел
пример: бедствие
футболист: бывшему
расчет: свободу
расположен: седьмую
систем: системы подобная
выход: выход проходу следом живыми оповестившая перестали аварийным западному аварийные
раскаян: елене
прида: тушением
государствен: документацию
летн: видели дочь
отмеча: кинозал другими
баннер: маленько рекламных
яковлев: сложности
трудн: безумно
сообража: способный
миха: останется звучал
лидер: вострикова
аппарат: дыхательный
групп: находившемуся вторая разделились холдинга
трагед: администрации
произошедш: отчета ответственность
техник: техника
надолг: снимки
пуска: новостях
требован: ск
постепен: продолжавшей
культур: культура институте
гудк: разговора
обраща: ефимкина
врач: пострадавшего
праздничн: кафедрального
напряжен: колоссальное особого
секунд: первые й
произнос: средства
жител: жителей
светла: справа
сын: подчиненная руку
аварийн: сознание обнаружит аварийный лестнице ооо
показан: ананьевым собранных
гувд: преступлениями
средств: силы спасательное
фельдшер: ответила
трубк: женщина
пожар: пожаре пожар пожара привело
отключ: бежать никитин комментарии отключили
борьб: разыскного
отделен: вызова следующим
туле: скр
толп: площадь
едв: согласовывали
едк: едкого густой
убед: прибытия
числен: состояние
счита: действовать
отсутств: подогреваемая
взятк: губернатором футболисту
цел: подобных трудно
трансформатор: поменяли
лент: ленте ленту ленты лента
опуст: хрипы
оспарива: приговоры
достаньт: голос
обжал: ведомство
захоронен: тайных
создава: проблем
директор: соболев
александ: указала
администрац: уважаемый указанием выдано
спор: имевшейся
идут: видят
развлекательн: уловкой торгово
уточня: спросить задает зафиксирована
областн: режима парадной
киноза: близости красного
защитник: расчетам
кукл: возилась
сюд: пройти
поясн: главного
пожаротушен: пожаротушения
езд: целью точно
след: следила парирует течение задачи практически
институт: хореографии
организац: охранными
билетерш: лестницы зашедшая
сямозер: гибелью
концепц: понимает
кемеровчанк: рассказывает
попробова: вновь
оплав: оплавилась
так: другого таким
вячесла: комбината
картин: стоит
событ: фигурантов события
течен: западня
храм: православного
концерт: пройдет
надзорн: отдела
бан: сауны
нескор: узнает
искр: полетели
стульчик: баннеров
собира: постепенно аппарат
лабиринт: напряжения
умерл: верили
некотор: спасателей командир
отряд: фгку кемеровского
служб: телефона переговоры службы звонить
попа: дверь
остава: районе дышали
логичн: фабричное
спорт: спорт
содержан: срок
методик: создать
сетова: руках
услов: вообще
звон: внутрь некоторые последнего газа
бежа: уговаривать пробегать
спасительн: направо
приход: передвигаться осознание
подожгл: подожгли
правильн: определять
восстанов: восстановить
милиц: майора
останет: живых
поня: понять
кран: коленчатом
парадн: подошла
подчинен: мамонтов осуждены мамонтова уверен
успокаива: освободят
рассказыва: округе
главк: бывшего
главн: главное главную магистральную
демонтаж: проводят
соответствен: проник
электрик: верховного
перечен: входила
взросл: ловушке взрослые
элемент: перестройку
октябр: родину
сестр: потерял
задых: задыхаясь
массив: огромного
состоян: уточнить
плотн: зала плотно
отдел: подчиненный обращался
выглядыва: окном двигаться
созда: проверок государство
гардероб: гардеробе
помн: наверное корысти
отдельн: находившемся
росгвард: новые
коленчат: сидел
огнетушител: огнетушитель
выбега: начинают
осознан: умерла
сопоставл: проанализированы
колоссальн: снять
игров: всевозможных
тел: грузовиках дольше
сработа: ловушки сработает
тушат: пожарные
бега: родители
владимирович: андрея
тер: дымом
пришл: отделение откуда пришлось
полн: требовали кололи минуту полно отмечает
фотограф: альбом
легенз: легенза
трещевск: поселка
матрас: очнулась
кузнец: храма
зрител: филармонии происходящем предупреждает
бел: бела областного
определя: соображать
привлека: обвинения
рамк: действовал
активит: активити
оповест: выскакивает
оптимистичн: закрытой
долг: достаточно
долж: плану
проанализирова: ролики
подоконник: тяжелый
числ: напутано чопе
сеанс: ожидании
вниман: должного обратили
найдут: казалось
видн: видеонаблюдения
комнат: побежал вытащил
очеред: первую реконструкцию
виде: видео
разбит: раму
ухажива: погибшая
мемориа: стихийного
объявл: зритель
подход: стали получается
едут: продолжает
температур: сверхвысоких ориентиров
явн: оператор добавить
звуча: разговоре
обжалова: обжалует
вконтакт: россии
цепля: веревку
олес: билетершу
бизнес: партнер малого
принима: многолетнего мужчин должен
тип: капюшонного
уточн: примеру
мамонт: глава
сгоревш: конструкций сгоревшем
олег: охранник спросила
остав: можем искали
общ: угрозы температура
гражданск: жилищно
остан: идти
обитан: обитания
недел: неделю заметен хулиганил
поддержива: супруга
включ: фигуранты
удобн: показалась
сред: среда среди
второклассниц: алена
мног: блокбастер показания
уста: явно
тушен: охраны приступить руководил
салатов: оранжевых
контакт: упоминает
избежа: признал специалисты
останов: кинозале западную
заместител: подписью гумирова
неофициальн: негласного
караул: отключил
взял: подошел
образц: брали
разб: ходят
звен: пожарное апарин газодымозащитников коротком подготовке
владел: помещениями
прогулива: смартфоны
фигурант: обжаловали многих
девочк: девочку настю
ожидан: прогуливались
комитет: следственный жгс
поступлен: касается
супруг: истек
потеря: востриков узнают ребенка смирнова
отрица: жарко
звонок: мультфильм
долож: комнате
одн: билетерша рухнуло ответа одна
лестничн: встретил
инструктор: инструктором инструктор матери
согласн: метра
отчаст: защита
пода: бузотерами
столиц: столицы
густ: представлял
действова: показать чиновники выхода
ведущ: скопление
команд: получили бойцы
бенифициар: конечный
баст: концерт
предупрежда: искры
потерп: передадим
врод: экспертизы
участ: отношение
десятк: десятки
смотрет: какое
запрос: обнаружении
пластмасс: горелой
март: марта тяжелом
передвига: нулевой
соедин: сотрудников
вытаскива: вытаскивать
еха: другим
тон: здании повышенных
глав: прибывшего комковой проходят врио бывшую
глаз: смыкал
злополучн: проводить
сраз: ответил
обвин: терентьев
холодн: отвечает погреться официальной
поступа: звонков
упрекнут: пытались
половин: трех
трк: трк
кемеровчан: колено
приедут: поехали
располага: подлог
новост: новости растеряна больницам
перв: инструкцию крикнул предположительно видно группы квартире потушим звонок
извиня: принялся
близк: чьи
приня: тулеев
добр: деактивирована добра
уйдет: эвакуировав
осужден: чуприян
равн: отработал
основ: ролик
тро: троих лежали
отставк: подал
безумн: судах
освеща: освещавший
как: бутылку приходилось залах ко матрасе
участник: отметим
кордон: полицейский
детств: друга
трц: трц
повлия: смогу
каф: увели
рассматрива: весной
площадк: лестничной
фильм: показ
высок: подоконник закуток
реальн: пожаловать реально
тяжел: связи живут
близост: непосредственной
понесен: стоимость
реконструкц: возвести ответственности
точн: возраст исследований трагедии глаз
высот: высоте
тесленк: елена
партнер: сын
коляск: гуляла
установлен: камень
смирнов: анны анна
напоминан: хотели
магистральн: продолжить
двиг: шли
жертв: споры
найт: хотел
чувствова: черным
успел: успели успела эвакуационном
учен: яковлева
вызов: поступлении
окн: окна коридора узким автолестнице
учет: диспансерном
маленьк: мама приедут потерпите жену
появ: кемеровчанка
диспансерн: состоит
усилива: пришли
вернут: вернуться
наряд: сети
мозг: опухолью
вернул: очки пластмассы
комбинат: кондитерский кондитерского
четверт: силу четвертом третьим четвертого
добра: пытался
бригад: делаете
пожарн: поддерживают пожарная кемеровские эвакуирует александра пожарную общения крыше очага ждали караула
д: семенова
схем: кинотеатре подлежит
вообщ: оценить
туш: тушить
й: тасс
преврат: групп
стремлен: желаний
пессимистичн: дало
веревк: двигаясь
ожида: подъезжают
оканчива: средней
вишн: вишне вишня вишни девушка зимнюю
дыша: нечем одежду баллону
показа: напоминание противоречие мелом показалось
сообщ: охранников поднять результате
отправ: отправился
поэт: залез
квартир: жила
двер: достигает убедившись закрыть закрыл
укол: происходило понимать лекарства
отнесл: дышал
безопасн: основа противопожарную
девушк: запись вечеру
нажм: опечатку
резк: маленьких
сообщен: пускали
власт: касках
крича: прошли
подлог: взятки
озвуч: суд
город: города городе становится
резюмирова: бессмысленны
национальн: установят
вдол: диванах
час: часов
метр: квадратный метров размером
внутр: попал
свидетел: происходит
страховочн: страховочному
глюкофон: качелей
надпис: жилетках
больн: старая
крикнул: знаю
могл: могли могла
повышен: вышли объектов
подписа: администрация
гумиров: милиции действие
больш: самый
мест: месте дошла прибывшие
наде: надеясь
ждат: службу
похорон: готовьтесь
карьер: футбольную
вход: заводил золотов относительно
инженер: полозиненко
направлен: основное
ждал: сестренка ждала
ора: сирена
видет: видеть
развернут: прямо третьего
извлечен: метр
редакциярекламаконтактыпресс: отключены
страшн: страшный дни
видел: выглядывали
разыскн: оперативно
жизн: жизни
надел: жив
дымоудален: айкин
эфир: информация смогли
зашедш: кричит
формальн: система
сформирова: митинга
лиценз: должна
пыта: мужчина разом суды
спортивн: развлекательный
дежурн: единой
перестройк: намекая
пошл: послушала вдогонку
смог: присутствовать высокий
митинг: отставку стихийный лидером родственников
пойма: мальчика
отб: давали
тыл: начальника
дошл: ребенком
владельц: устройство штенгелова
допрос: охладить настоящие
каток: бассейн
чиновник: городские
меня: куклой временем
верховн: отказала
футбольн: завершил
посетител: посетителей
послуша: собеседник находится сетовал
умира: умираем
очнул: укола
вызыва: играть
крич: слышат
обнаруж: скажет трусов
знача: произносили
крик: кричал последний
жгс: строительства
увел: школу
разблокир: замки
сравнива: единственное
увер: сломали
отцепля: отцеплялись
ключ: нужные открывавшиеся
подъезжа: горим
хозяев: возникал
жен: сестру
розыск: международный
фейк: многочисленными
установ: наткнулись удобной смогло
пульс: женщину
ехидн: судья
напута: понятно
кол: преклонил
барабан: называет
пожалова: добро
кинотеатр: необходимой западной колобовников зону
отказа: звена увд уголовное
кинозал: синем злополучному желтого коридоре
построен: принцип ангелов
нагроможден: затруднены
очк: взял многие
очн: заочного ходе
звуч: разговор
старш: потерявшая выпускных
шахт: разбивать
горет: гореть
звук: команды услышали
дерев: вишневое
возника: сравнивал
возраст: численность
спасен: спасение необходимые
галер: галереи
гореч: поглаживал
наруж: выбрался
увидел: увидела
жив: установив снаружи найдут позволит
тупик: успел
преступлен: экономическими
уловк: воспользовались
паден: ребенок
повернув: задымлен
жил: выжили
уверен: реагируют
многочислен: достоверной
тревог: женщины
вострик: узнал
горел: запах
произошл: гибель произошло
корпус: новом
кск: контроля
итог: этаж
минут: одну последняя минут
прокрича: спасти
рассказа: рассказала генину
вскор: колени
заверш: вишневский
устройств: преткновения
пришел: сообщения
размер: помещение взятку
увд: заместителем
развлечен: детских
доск: школьной
проход: плакатом рассматриваться пластом кинотеатров результатах шел
докладыва: пришло
ответ: олега послушал точного митингующих мальчику мнению
губернатор: действующим вице
никт: кинозалами
обществ: опасна
пространств: построения
срок: терентьева
опухол: учете
отвеч: напитками
лишен: штраф приговору
следств: избежали
держа: налево аварийного трудом
уда: итоге
правдоподобн: показались
территор: баннер
аптечк: чаем
превращен: концепцию
смен: проектировщика
обучен: очное
омон: встали
претенд: повышенной
ал: средняя
ан: ситуации зайти
готовьт: москве
заявлен: бьется отказали
месяц: осуждена
жми: жми
возвраща: всякий
георг: техдиректор
перенастро: защиты
вероятн: следователям
длин: появились
потуш: спасем
нашл: рады
вед: прокричал
баллон: своему поменяло
снег: ветром
вел: муж
очередн: случилось
годовщин: слоганом
вер: пришел
популярн: популярном
показ: остановит
покаж: помнят
одноклассник: погибла
чоп: официально руководство
цвет: кладет
достига: спасительной
профилактическ: деятельности
уеха: проекту восьмилетнюю городах
нача: начался началось начали
замеча: находящиеся
ждут: пожарного
оруж: лицензия
кряж: тушения
виктор: сотрудника просил
узк: высоким
уговарива: держал
поселк: совет
удава: рост
апелляц: рассмотрения
возбуд: указание комитет
уголовн: возбудил возбудить
спаст: удалось помогите
заводск: приговор
представ: представить
кубик: кубики кубиками
негласн: колобовникова
контрол: строительного
задач: находятся общественников
алта: отеле
округ: палка бегали
трех: следующих
спаса: людям
поеха: спрашивает
сидор: денис
тряпк: мокрыми
трет: проходом уровне котором
трем: кинотеатр пятнадцати
разжа: ответив
спасл: полу обратно
подразделен: прибытии
пап: выжил
влиятельн: гувд
задума: цветы
ел: похоронам извлечения
вин: вине раскаяние
проник: дым
двум: сидоров
востриков: игоря
понест: произошедшее
факт: отрицал
имевш: всей
вид: грохота имею
захар: сына
защит: релейной коротко
внов: поток
красн: номером пятеро красный ближайшего
виц: тонах
обеща: обещали
наук: наука
встречен: позволяла
батутн: батутной
крыш: газозащитной снимать
хрип: напоминающие
сторон: коридору
постав: ампер увеличить
указыва: куртке
поток: воздушный
цивил: чернов
призна: фактически днем говорилось
тогдашн: реконструкции
родственник: собирались отчитываясь участием выплатил
претенз: какие
принцип: непонятен
колол: создавал
стоимост: оценивал
колон: получила
звонк: последние однотипных
плакат: рекламным
бассейн: должны
ил: мэр
им: годом выбиты
обвинен: версии
наст: дочери мемориала летнюю второклассница
обяза: очередь
плам: пламя
план: такого
автобус: салонах длинные
оперативн: руководитель
коридор: спастись пошла конце сеанса
больниц: местной ездили
строительн: комитета
пласт: цепляли
видим: пытавшийся описывает
замет: участвовал цивилев
активирова: антюшин
объяв: уехал
ко: страх
упа: теряя
лейтенант: генерал
черн: владимир вышла становился
собра: данных персонал вводили часовни
закрыт: возле поднялось сигнализации узнала оказалась
дочер: портретом потерявший
аэромобильн: национального
черт: звене
участок: земельный
запута: становились
дочек: вел
самостоятельн: городской
надзира: росгвардии
закрыв: добраться
понятн: вроде
попрос: доложил
президент: принимал
огромн: часть
ответствен: считает вишневского
вод: вода воду
мощност: трансформаторы
воз: ухаживала
громк: очках
четк: улицу
местн: фельдшер
сидел: зрители разбитого
корреспондент: корреспондент
участк: участками
направля: эвакуацией сюда
государств: извиняться написали
собол: георгий
проблем: кемерове
обнаружен: мужчину эфир
пригиба: удавалось
алис: младшая
раздел: запертой
автоматическ: автоматической сработала
вынесен: июня
качел: превращенного
оа: месяцев
мокр: лицо
лучш: признана
владимир: губернатора президента
управля: видимо
дума: могу
ври: руководивший
клоун: торговом
оо: помощью
крайн: безрезультатно
возможн: предоставила сделали использовали спросил
кида: живу
молод: осадить
огон: огонь
открыт: использовалась барабаном
скоплен: окно
увелич: областной короткого
направ: сворачивая проектировщик
колен: запросит опустились
москаленк: семья
гляд: стен
круч: круча
непосредствен: находилось
персона: аптечки
все: проверка
адекватн: вреда
рухнул: стремлений
ориентир: либо
меша: профнепригодность
спичк: спичками
чье: чьей
серге: звено
бойц: звеном
бедств: терпящими
чьи: родственники
наверн: настя
бывш: бывшая включая делу прикрыть бывший
гендиректор: тогдашний
круг: расширение
наверх: наверх
выступа: ударился
ребенк: кончилось повернув
полицейск: продавила
ри: риа
наход: собрали писал находившихся рукой обнаружения помощи оптимистичной узнали трусова находились находился
погибнет: западне
потер: понесенных
забежа: впереди
встал: дома
говор: родителям муниципалитета говорить говорили говорила
ру: ру
оценк: пессимистичной
рф: рф
понима: остался сознании
оттуд: оттуда
охра: работу частными пожарной
малолетн: двое
стат: новостей статьи
леж: выглядывая
подъемник: коленный
стар: общества пристроенном располагался превратить
федеральн: замглавы
катк: катке
стал: знали стало задачей
полетел: свет
мамонтов: главка александу
посад: находившегося
указан: прокуратуру схемы
ск: заявления
парир: уверенно
став: уколы отделениям
центр: центре регионального торговый
разрушен: конструктивных
работ: подходящий претендующего
рукавн: провести
привлеч: бенифициар требованием
получен: людях
пол: лежа легли
человек: погибнет
критическ: ролике
каск: омона
трусов: михаила
лет: культуры праздничный
дыхательн: автономный
ветр: холодным
каса: допросы
недоумен: двинулись
то: позволил
замглав: бурсина
структур: структуры
высказыван: опубликованное
сибирск: критическая
разбива: вскрывать
никитин: инженер
котор: которое лифта
времен: событий кемеровчанами
здан: горящем этажу зайдя
силов: силовые
осен: озвучил
перешл: бесценны
шаг: сделал
ананьев: отказал встрече
прав: лишение
нараста: выходит
вовс: место
либ: каких
майор: неофициального
весн: дело
лиз: старшая
относительн: местонахождение
про: дверной
капл: капли
анализирова: умеющий
верх: берет
сцен: громких
верс: бизнесу распространяется
вывел: резюмировал
травм: множество
увеличива: елены
разобра: хотелось компьютер
неопознаваем: тело
лин: рукавную
позвол: дверью неизменным
зал: зал выглядывают тремя красном фильма нарастает
рубл: зарплату
справ: комкова
занима: права
задымл: сильно
зап: очередная чувствовался
лиц: закрывая упал
встреч: пожарный
ощуп: проем
встрет: киселев спустился
побежа: сразу побежала
позвон: последним июне иначе
эксплуатац: ввод
вдобавок: дымоудаления
слышат: сцен
приговор: госслужбе спасательной прозвучали обвинительного халатности
релейн: техусловий
устро: устроена
опубликова: вконтакте соединены начинается запомнилось
боровков: полученной
завод: отвечал
пострада: передав
одновремен: возможность
предположительн: женщинами
якоб: следствие
обследова: пожарными
родител: звонят кафе комментариями
охранник: комнату пошли чопа опознать счету
ча: столы
газодымозащитник: требовалось
камн: оказалось
пут: двинулось
донос: быстрее
че: гудки
безрезультатн: влиятельные
выпада: надолго
выглядыв: пожарных
комков: главу танзиле танзиля
подач: постоянной карьеру
строительств: разрешения гражданского
должност: занял занимать
трус: михаил
класс: оканчивает
узна: горе одноклассниками богатенко докладывал покажу
неизмен: остается
выб: дышать
спортзал: погибших
торгов: работавшего прошло проект лабиринты
выж: лаханину травм инструктора
частн: надзирающих
труд: возможное
путешеств: путешествия
техдиректор: колонии
заблокирова: заблокированы
раздвига: горечью
осад: адрес
шел: подходили
куртк: черной попадет
доказательств: возможные
кондитерск: гендиректор старом кемеровский
хотел: поменять дерево вероятно
волонтер: работали
одея: растянули
продолжа: оцепленной залов первая достаньте открыли
номер: большой сменить
черед: идет
выл: фейками
помоч: помочь
госслужб: должности
помога: помогала мешали
вечер: ближе
скажет: допросе
неизвестн: спасло
помощ: просили некоторое создали
газозащитн: звеньев
колобовник: олег
выш: указанное
попытк: продолжала
ведомств: заявил спасательного
джоконд: картина
опасн: смертельную невиновности
поглажива: делать
ловушк: ловушка ключи оказавшихся элементом
желан: пространства чередом
лов: ловила
выпускн: смирновой
спокойн: спокойно
задержа: розыск
насовс: уехать
заочн: перешла
альб: хороший
штраф: декабре
арен: кузбасс
свобод: лишения апелляций
задымлен: полное
саун: стоящем
спецпроект: спецпроекты
генера: центра
отговорк: маленькие
следствен: суда
положительн: спортивно проекта
рост: полный
росс: паблике россия
помогл: помогло
помог: генин
ампер: вольт
поролонов: поролоновыми поролоновые
четырех: четырех
земельн: передал
газ: поступил угарный
мотор: мотор
ситуац: напоминало той
каза: спала
выкова: кузнецы
мельк: мельком
трос: тросу
эвакуирова: эвакуировать спустятся вывели
диванчик: стульчиков
кладет: округу
кажд: миллиона
руководител: тутбалин
опечатк: редакциярекламаконтактыпресс
лекарств: аллергии
шла: дочек
магнитн: выходы
педагог: алтае
канал: опубликованы
множеств: получил
уезжа: доходит
автолестниц: подняться
золот: виктор
проверок: ухода
всяк: тряпками
юг: юго
пятер: идут
кузбасс: кузбасса годовщину
использова: еддс максимально аварийной
юл: комбинат
пройт: попыталась
богатенк: олесю
достаточн: появлялось
прибыт: закрыться застряла
мальчишек: мальчишек
мультфильм: смотревших
шли: действовали
настоя: устраивая
кемеровск: кемеровском путем оао выходу вдобавок фпс
сказа: больницы генералу
отстранен: холодный
ссср: ссср
восем: мужчинами
строг: дали
нашел: рассказал
ям: яме ямой ямы яму
невозможн: невозможно
жарк: становилось
попыта: нашел эвакуационному закрыта отключились
коротк: предшествовало следователя анализировать ползать короткое
записыва: телефон
воздушн: развернуть
общен: одновременного
видеонаблюден: камер
поменя: врачам замыканию повлиять
грохот: плотного
назва: государства
устраив: произошедшем
тренировочн: учебно
горноспасател: подготовки
подошл: вплотную
бесцен: бесценна джоконда
описыва: подробно
фабричн: старое
прокуратур: кемеровская заявление
обернул: обернулась
откуд: направлял
собеседниц: едут
лечен: медицинское
антюшин: сотрудник
игор: руки обслуживавшей
подума: подумала
спрыгива: спрыгивали
собеседник: оружие вытащит
проектировщик: ленина требовалась
пластик: пластика
добав: кнопки мозга
выпа: окну
специальн: специальный
друз: близкие
зна: остановил
представля: взрослых
скаж: ожидайте
стро: отчасти
кафедральн: шахтеров
паблик: официальном
жилетк: салатовых
друг: подачи развлечений поступающих двигаются друг апреля
закр: решение предложил версия
диспетчер: застрявших
зон: увеличивалась зоне задымление зоны
тайн: телами
народ: забита
компан: привлекала директор
елен: легче
зайт: вишню
получа: проходили лечение
действ: выпал порядок постоянно едва мнение
эвакуир: половиной выходом
воздух: баллоны подачей
покида: замечают
привел: перенастроена
наруша: догнал
преклон: митинге
передад: реплика
стоя: поймали стояли должность отдельно
зайд: веди
региональн: сибирского
рад: сняла
успева: горит
кирилюк: канале
раз: первого
пиар: заявив
рам: забрался
ролик: опубликовали сделанные лучшей
стол: приготовили
зарплат: пойдет
конструкц: демонтаж
интернет: интернет
вступ: оспариваются
помещен: данные выше обследование
кован: задумали
штаб: расположен уехала
официальн: верх недели сказали
капюшон: средство
полозиненк: игорь
знал: знала расходиться никто
заперт: крик ловушку
комментар: статей басты
сотрудник: радиопереговоров режиме разрешением открыта
невиновн: доказательства
корыст: упрекнуть
приступ: обязаны
адрес: замечания
компьютер: садится
висевш: висевших
сильн: коридор крыши
работа: лета боровкова автобусов
прос: организациями звонили ананьеву
подчеркнет: школы
погрет: автобусы
сотрудниц: уточняет
телефон: погибнем трубку
необходим: рассчитать больная строилась
подходя: диденко
проб: семье
бессмыслен: глонасс
трасс: трассе трассы
сложност: общей
выйт: говорят
тренировк: проводили
обстановк: общая
разрешен: разрешению очереди соответствовало добавила
реб: ребят
спасател: ждать позвонившему
сельск: неопознаваемо
оценива: адекватно
оста: уезжать клоуном расспрашивать действиях
быстр: давайте быстро
заключен: отрицательное положительного
спрос: утверждает тупика успевает
намек: хозяевам
многолетн: тулеева
реш: старому
международн: объявили
айкин: данил
зада: собеседница
состо: подсудимая
серк: алексей
бурсин: андрей осужденных
серг: сергей летнему
додела: признается
оператор: операторы холодностью отговорки
затянут: шагов
разбирательств: продолжил
договарив: самостоятельно
может: ехидным
погибл: девочка погибли
эвакуац: управлять каток
нулев: видимость
люб: насовсем
кемеров: учреждения суде кемерово
снят: недостаточно
фон: звучит
погибн: подожди
снял: позвонила
фот: фото
происходя: знал
погибш: насти похожи родственниками каждого
кисел: тушат
гор: детский пиарится скажите
бузотер: послушали площади
люд: направлять помогали информации
гибел: ситуацию целей лиза
фпс: отряд
отвеча: проникли служба
отчет: полного
год: запутаннее
экспертиз: государственную образцы
лют: лютых
открыва: дополнительные
генин: сергея пульса возглавлял
ставк: очной
подогрева: кемеровчан
разгора: разгораться
квадратн: использовать
особ: вызывала собеседники
вывод: оператора
зрительниц: вспоминала
вскрыт: попыталось
расход: бани
ближ: остались
запис: сопоставлены очагу камерой
знает: вопросов
мал: объект
мам: папа первом
поролон: поролон
продав: толпа
растянул: стоявшие
попадет: эфира
подлеж: безопасность
приб: коллегам поднялись подчеркнет путина
улиц: записи орала
распространя: выйти распространялся
пристегнут: пристегнутые
выда: эксплуатацию
достоверн: отсутствием
подня: собирался апарину кране центр смог
стен: вдоль
апрел: александром
стихийн: вылилась установленный
находя: секунд зрителей
срабатыван: срабатываний разблокируются
инструкц: нарушаете
снаруж: двери
сгорел: сгорели
платформ: платформ
подозрительн: подозрительного
экстрадирова: польше
войт: войти
охлад: линию
конечн: штенгелов
присутствова: думала
бутылк: оставалась
подпис: администрацией
деятельн: надзорной
желт: синего залами
смартфон: глядя
порядк: стражи документация
напитк: диванчиков
подробн: второго
григор: профилактической подчиненного максим
упомина: показаниях разговорах
отчитыв: полковник
похож: настей
задействова: подъемник
преткновен: камнем
шахтер: горноспасателей
втро: каким
прен: заявила
блокбастер: смотреть
сигнализац: сигнализацию сигнализация срабатывания
командир: сообщит
фабрик: кондитерской
проведен: согласно
аллерг: возможной
вытолкнут: отец
написа: специалистов можете
поиск: звук ориентированы
запомн: нескоро родителей
возл: оценке
взлома: попытки
бьет: круга
противореч: внимание
недостаточн: уколов
богданов: юлия
зимн: зимней зимняя приехали
голос: женский оставили
угарн: едкий
напомина: отмахнулись звуки
матер: высказывание
филармон: педагог
переговор: вопрос
освобод: приехала
прошл: коллегами кряжев
втор: яковлев поисках
мел: доске
мер: крайней
залез: выходе
одежд: отдал
возвест: решено
обрат: следователи электрик
максимальн: желания
терентьев: григория
образ: образом
ввод: надписей разрешение
конц: оправдываться места
конч: терпение
гавриленк: построенный
вскрыва: пожарным
ребенок: одеяло
радиопереговор: записями
подсудим: отметила
практическ: шла
удар: падении
четырьм: двумя
отста: поэтому
александр: ставки сознания тушению
вплотн: кордон
утвержда: каком
единствен: тренировку
вольт: мощностью
отъезд: свекровь
дава: сотрудница фразы
коммерсантъ: гавриленко
интегратор: системный
виновник: числился
терент: григорий
зафиксирова: контакт упоминался
потолк: потолка потолком
вывест: вывести
мир: мир
мальчик: спасателям мальчиков вытолкнуть
писа: напряжение
предприят: охранного
исследован: проводилось
смотревш: девочек
этаж: этаже первому покидают этажа четвертым
ламп: ламп
скор: останемся бригада
соблюден: сделано
снесен: разбили
получ: фасада богданова воздухом гранаты
диспетчерск: дежурно
зашл: москаленко выходил
начальник: поднялся команду
госстройнадзор: главе
тутбалин: евгений
затрудн: помещений
провел: провели
вытянут: расстоянии
ищет: спрашивали
декабр: комкову
экономическ: борьбе
забира: забираться
рук: вытянутой держала указывал держали
гранат: кидать
отец: сергею
детск: зона работала детского испуганный
компенсац: договариваясь
прям: расположенную прибыли
грузовик: жертв
площад: городскую назвал
отел: аниматором
погас: очаге
неприспособлен: фабрики
ефимкин: виктора
анастас: анастасию
приготов: развернут
нарушен: строительство
вынест: попытаемся
сворачив: другом
счет: дают особом
порядок: правильный
андр: противопожарной
спрашива: зашли вишней волонтеры
согласовыва: охранники
апарин: действия помощь оставшийся
отда: посадил
подгузник: меняла
генерал: гумировым
смогл: якобы прибывших
идт: вынести
отработа: четко
забит: лестница
мог: ездила
свекров: оставить
мож: раздраженный
момент: момент
приглас: ищет
растеря: девушке
лестниц: лестницу бежали площадке западная
основн: подразделения
вышл: басовская власти
сознан: потеряли находясь полном
андре: калинина
догна: недоумении
решен: принимают
хронолог: хронологию
провод: сотрудники условиях встретить отметил
средн: сад гибели
нужн: найти
поздн: проведенному любой
дольш: числе
результат: учения трещевский
объективн: самая
сослуживец: свободы
анан: александр
дал: входа одно экспертизу октябре
тасс: григорьев
тулеев: амана
напарниц: напарницу
оправдыва: своим
дан: кемерова середюк массива
следовател: прямой сообщила отмечал
дат: просившему
указа: прокуратура выяснилось
ростехнадзор: ответить
штенгелов: дениса
закуток: небольшой
отмахнул: звонившего
обследован: эвакуация
лифт: шахту
медицинск: необходимо
камен: коляской
освобожден: ждут
хулиган: сказавшая
камер: записям зафиксирован
брат: мамой владел
наткнул: вскоре
пошел: здание
эвакуацион: закрытому закрытом
пятидесят: раздвигает
брал: приходить
фраз: значащие
предлож: первым
пятнадцат: отношении
диван: сидели
сверхвысок: спустя
оцен: газ
дво: трое
рассчита: далее
уход: схему
полиц: подходить
муж: захара тесленко
объект: перечень мамонтову
позва: позвала
фрагмент: записывает
заня: недель
руководств: привлечь
заблужден: собравшихся
путин: владимира
подцеп: воздуха
вытащ: скорее вытащить никого
ориентирова: вовсе
вспомина: вспоминает отстала мужчине
полза: ходить
дел: разбирательство четвертое нашли
ближайш: синий дверей
вопрос: отвечая уточняющих ехать
ползк: пригибаться
профнепригодн: явную
игра: автоматы
семенов: тыла
москв: проходившей
полност: эвакуируются
ручн: автоматическом
проникл: ощупь
измен: резко
замк: магнитные
суток: дела
аниматор: детским
дет: детей попробовать дети
людьм: обследовавшими
расширен: мере
калинин: заместителя
снимк: разобрать
слыша: криков
фгку: начальник
седьм: пригласили
снима: апарина направление
восточн: восточной
отношен: изменил уголовных
иска: искать полчаса
мчс: мчс
жилищн: отдел
услыша: слышали
продл: стражей
район: разрушений заводский центральном
налев: людей
сад: фотографиями алиса
последн: следующий штаб пол суду приемом
замечан: жесткие
злост: бузотеры
автомат: ключами игровых
сам: желтым эмоциональная
середюк: илья
детьм: детьми
инач: получилось
переда: правдоподобными привлечен
школьн: чертил
школ: спортзале куртки погибшей
подобн: неприспособленным развлекательного
называ: глюкофона
управлен: кск
записа: диспетчеров
уважа: владимировича
женщин: звонки восемью обнаружил голосе
руковод: бурсин сослуживец
горя: горящего горящей знает
начина: менялись соответственно
расстоян: стоял
западн: генина ним проход полностью забежал вернулась
муниципалитет: безопасности
мужчин: четырьмя зале неизвестном народом отнесли
смертельн: долгое
област: кемеровской
подошел: продолжал
осужд: приговором судденок
вишневск: вячеслав компанию
сво: своими вернулся подцепил
предшествова: обратил
специалист: развития установить
станов: ползком выпадает точек усиливался
лежа: осмотру
глонасс: поставить
кемеровча: злость
очаг: поиск очаг секунде ближайший
полчас: связь
парк: парка парк парке
развит: городского
дверн: спрашивал
непонят: сложно
продолж: д марте
происход: равно шокировало
точек: торговых
пробега: стороны
выясн: кирилюка
конструктивн: температур
ценност: ценности
осмотр: позднее
ход: встреченной участников свидетели
возгоран: возгорания
легч: минута
пробл: ставили
катарин: катарина
сем: размере басовской группа
легк: службой
оцеплен: эвакуировали
легл: взломать
сет: легко
подбега: факт
обслужива: интегратор
сестренк: маленькая
однотипн: устала
доход: поздно
пристроен: корпусе
позволя: обстановка
памя: выковали
дни: братом
городск: центральную участок погибшего управления
мэр: понести
раздражен: тон претензии
дом: белого
способн: сидит
полковник: охранником
терпя: людьми
судденок: надежда
отцеп: отцепиться
сид: заходят рублей
доч: старшую
предостав: прениях
остальн: остальных остальные
эмоциональн: наряду
пройдет: арене
дня: дня
хорош: доделать хорошие
перекр: порядка трети
никит: брат
часовн: открытии
чуприя: главы
днем: одним
палк: подолбить
восьмилетн: мужа
сиз: приговора
прозвуча: трем
большинств: большинство
сил: силами вступили спасения
син: находящихся выбегать красным синим
сир: объявлена
подолб: пятидесяти
потечет: потечет
холдинг: владельца
евген: зрительниц группе никита
соответствова: подписала
выбит: выбитые собрались
информац: уйдет внимания
салон: снегом
испуга: фоном
смыка: суток
впуст: потраченного
всевозможн: нагромождением
забра: выжить
спуст: подъехало задействовали детям
автономн: дать
минздрав: главой
требова: находившиеся сообщили формально
штенгел: увеличил
переста: друзья
берет: раздражение
халатн: обвинили
младш: класс
катастроф: катастрофы
опозна: очевидцы
спас: спасли
идет: снесенной
спал: страшно
подготовк: тренировочного ставились
скр: минздрава
подготовл: заключение
моральн: определения
отправля: отправляли
коллег: впустую подбегал коллега
живут: виновники
забот: забота
страх: страхе тревога
надежд: осенью
соответств: порядке
приеха: скорой отъезде
польш: задержали
сми: сми
страж: митинг содержания
потрачен: лицом
рассмотрен: сизо
свет: погас
уровн: выбил
подожд: счет
портрет: заблуждение
спасательн: надел федерального пожарно
хореограф: обучение
выеха: выводят
заяв: серко слова молодого
угроз: сильной
вишнев: память
ама: захоронениях
небольш: зашла
умеющ: действий
неч: возвращался
пойдет: работы
замыкан: замыкание короткому
выбра: выбраться разжал
истек: защитника
девочек: ананьев
оранжев: запомнила
отрицательн: дала
диденк: лейтенанта
яковл: области
ник: малолетних
воспользова: владельцы
откр: сидят открыт открыть
шокирова: штаба
выплат: собственниками
миллион: родственникам
басовск: человека евгения
июн: продлили сямозере
учрежден: территории
кнопк: активировать
колобовников: охранника
никак: никаких
ленин: расположено
ctrl: ctrl
enter: enter
kdv: kdv
youtub: youtube
