жертв: жертвой жертв
лапш: лапши
инопланетя: инопланетян
слух: слухи
ру: ру
банк: банков
притворя: притворялся
студентк: студентке
влиян: влияние
марихуан: марихуаной
стат: статьи
мобилизац: мобилизации
обычн: обычную
оказа: оказался оказались
банд: банда
стар: старая старый
стал: стала стало
перееха: переехала
обезглав: обезглавил
найд: найдена
теннис: теннису
ката: катаны
сброс: сбросить сбросила
удал: удалить
парик: парик
последств: последствия
работ: работы
удар: ударом
раритет: раритетом
вернут: вернуться
арх: архив
экономик: экономика
возмут: возмутившегося
утрен: утреннюю
мид: мидиях
рипл: рипли
связк: связку
килограмм: килограмма
манхэттен: манхэттене
криминальн: криминальной
человек: человека
охот: охоту
призрак: призрака
вселен: вселенная
личност: личность
структур: структуры
суд: судят
гигантск: гигантских
студент: студент
танцовщиц: танцовщица
подел: поделился
разгар: разгар
отправ: отправился отправившегося
благодар: благодаря
подтасовк: подтасовках
карл: карла карл
котор: котором
уб: убили убил убила убить
денег: денег
лгун: лгун
провест: провести
убийц: убийц убийцу
китаец: китаец
мир: мир мире
укол: уколов
силов: силовые
секретн: секретные
напада: нападать
съемк: съемками
экстравагантн: экстравагантных
организатор: организаторы
прочистк: прочистки
девушк: девушка
нажм: нажмите
приготовлен: приготовления
феврал: февраля
конец: конец
вперв: впервые
расценок: расценок
драк: драка
талиб: талибов
получ: получил
оральн: оральный
фронт: фронте
город: города
просл: прослыл
беремен: беременную
крокод: крокодил крокодила
кров: крови
рук: руки руками
укра: украла
украин: украине
гранат: гранатой
столкнул: столкнул
прооперирова: прооперировал
отец: отец
раскр: раскрыла раскрыли
выстав: выставил
россиянин: россиянин
рубл: рублей
сосед: соседа
жемчуг: жемчуг
лиц: лица
родин: родины
заработа: заработала
лиш: лишили
встрет: встретившуюся
любительниц: любительница
разбогател: разбогатела
нов: нового новой новые новая
ног: ногу
шприц: шприца
нож: ножом
мест: место
женск: женского женский
пожизнен: пожизненный
послан: послание
афганск: афганские
мерзк: мерзкую
устро: устроила
похваста: похвастался
сорва: сорвал
упыр: упырь
ждал: ждали
учительниц: учительницу учительница
дворц: дворце
игр: игры
авантюрист: авантюристов авантюрист
отказ: отказа отказ
сдела: сделать
кольц: кольцо
хищник: хищников
двухметров: двухметровый
эффективн: эффективность
лужиц: лужица
видет: видеть
англ: англии
грязн: грязную
деактивирова: деактивирована
редк: редкая
родител: родителей
редакциярекламаконтактыпресс: редакциярекламаконтактыпресс
страшн: страшный
пут: пути
жизн: жизни
русск: русских русские
сексуальн: сексуальную
наркоторговц: наркоторговцев
козн: козни
противоречив: противоречивое
питон: питона
пропа: пропал пропавшего пропавшую
хирург: хирург
тигр: тигров тигра
двоеженец: двоеженец
инсценирова: инсценировал
процедур: процедуры
впал: впал
выход: выходить
трус: трусы
сотн: сотни
окун: окуня
летн: летняя летний
плантац: плантации
пленниц: пленница
пошл: пошла
ше: шею
лишн: лишний
подросток: подросток
перебра: перебралась
путешеств: путешествия
привлечен: привлечения
труб: труб
охранниц: охранница
укус: укусил
сша: сша
лидер: лидер
машин: машине
пойма: поймала поймал
скрыва: скрывают скрываются
техник: техника
ненавидел: ненавидела
утечк: утечке утечки
хотел: хотел
культур: культура
лесн: лесной
любя: любящий
артур: артура
личн: личные
продолжа: продолжают
номер: номер
отц: отца
смерт: смерть смерти
доминатрикс: доминатрикс
случайн: случайно
секрет: секретами секрет секреты
вып: выпил
приедет: приедет
вылож: выложившего
помощ: помощи
фанатк: фанатка
мексиканск: мексиканского
врач: врач
метеор: метеорит
красив: красиво
любв: любви
вышедш: вышедшая
обнаруж: обнаружила
опасн: опасных опасный
глуш: глуши
жител: жители
желеобразн: желеобразных
документ: документы документов
принесл: принесли
будущ: будущую
предложен: предложение
мечта: мечтают
увер: уверены
нежелан: нежелание
сын: сына
пенсионер: пенсионера
сыр: сыра
загадочн: загадочная
альп: альпах
ностр: ностра
замуж: замуж
агент: агентом
жен: женой жену
средств: средством
когт: когтями
свобод: свободу
дан: данные
собак: собаку
спортсменк: спортсменки
поруга: поругался
спецпроект: спецпроекты
раскрыт: раскрыты
легендарн: легендарной
казн: казнят
суров: суровой
росс: россии россия
помог: помог
мисс: мисс
фбр: фбр
коз: коза
садистк: садистка
гиперзвуков: гиперзвуковой
мотор: мотор
автомобил: автомобиль
медведиц: медведица
ситуац: ситуацию
кот: котов
найден: найденный
пожалова: пожаловать
съел: съел
цикл: цикла
таиланд: таиланд
канадск: канадский
привяза: привязали
брат: брата братом
взятк: взятки
цел: целую
очк: очков
трон: трона
лент: лента ленту
банан: бананов
опуст: опустить
дерев: дереву
опечатк: опечатку
галер: галереи
границ: границей
оцен: оценили оценил
российск: российском
вознагражден: вознаграждением
британ: британии
полиц: полицию
пачк: пачки
смир: смиритесь
ошибк: ошибке
муж: мужа муж
грабительниц: грабительница
стыдн: стыдно
обнов: обновила
увиден: увиденные
преступлен: преступления
жил: жилья
билет: билетов
заня: занялась
худш: худший
примерн: примерный
коронац: коронации коронацию
медиа: медианная
ганниба: ганнибала
высш: высшего
жених: жениха
животн: животные
бойцовск: бойцовский
ссср: ссср
вулкан: вулканов
полгод: полгода
педофил: педофилии
нашел: нашел
жит: жить
попыта: попыталась попытался
пришел: пришел
плейбо: плейбоем
долголет: долголетия
зареза: зарезал
покровительств: покровительством
мебел: мебель
мемуар: мемуаров
москв: москвы москве
обществ: общества
никт: никто
преступник: преступника
поменя: поменяла
порн: порно
военкомат: военкомат
срок: сроки срок
собствен: собственную собственным собственного
буйволенк: буйволенка
маньяк: маньяком
бал: бали
держа: держала
отшельник: отшельник
уда: удалось
подкра: подкрался
веслонос: веслоноса
дет: детей
назва: названы
материал: материалы
смес: смесью
мафиозн: мафиозной
собира: собирался
умерл: умерла
снима: снимают снимали
откуд: откуда
любовник: любовником
изменниц: изменницу
иска: искали
куп: купил
пробежк: пробежку
попа: попала попалась
куш: куш
кита: китаем
богатств: богатство
спорт: спорт
практик: практикующий
шок: шок шоке
младенц: младенца
паук: паука
последн: последние
вылеч: вылечили
бедност: бедности
возлюблен: возлюбленную возлюбленной
беспроводн: беспроводной
ссор: ссоре
сам: самая самых самый
тво: твою
жми: жми
бегун: бегуна
диспетчер: диспетчера
бежа: бежал
израил: израиль
тюремн: тюремная
организова: организовала
барселон: барселону
активизирова: активизировался
цирк: цирку
тайн: тайну тайны тайно
останет: останется
маркл: маркл
поня: понял
краж: кражу кражей
флорид: флориде
называ: называли
рассказыва: рассказывают
отрав: отравить
главн: главное главной главный
неожида: неожиданной
нашл: нашла нашли
лотерейн: лотерейных
женщин: женщине женщина женщину женщины женщинах
свадебн: свадебном
жутк: жутко
церков: церковью
аляск: аляске
велик: великий
взросл: взрослых
сестр: сестрой
полуметров: полуметрового
стоя: стоящим
двухголов: двухголового
вес: весу вес
популярн: популярных
смертельн: смертельной
мужчин: мужчина мужчин мужчине мужчины мужчину
рад: ради
магазин: магазина магазине
созда: создала
пентагон: пентагона
уеха: уехавшей уехала
сво: своим
мафиоз: мафиози
интернет: интернет
необычн: необычных
мега: меган
теленк: теленка
прода: продала
парт: партия
рекорд: рекорд
побереж: побережье
полчас: полчаса
сбежа: сбежала сбежал
чокнут: чокнутые
тел: тело
отрывк: отрывки
уснувш: уснувшему
законч: закончилась
каяк: каяке
великобритан: великобритании
пришл: пришлось
пробра: пробрался пробралась пробравшегося
гаур: гауром
утонул: утонула
переж: пережила
бел: белая белый
знан: знания
многомиллион: многомиллионным
бешенств: бешенство
алкоголик: алкоголика
ценност: ценности
вызва: вызвала
прож: прожил
насильник: насильник насильником
истор: истории история
сеанс: сеанс
тренирова: тренироваться
увидевш: увидевшей
цифр: цифры
модел: моделью модель
подозрева: подозреваемого подозреваемый
клуб: клуб
довел: довела
сел: сел
сем: семья семью семье семьи
пожалел: пожалел
представител: представителей
сет: сеть
виде: видео
умел: умели
заставля: заставляет
защит: защитят
печальн: печальные
москвичк: москвички
кошк: кошка
сельск: сельский
оста: осталась
быстр: быстрого
хозяйк: хозяйка
схват: схватившего
армен: армению
схвач: схвачен
наук: наука
цру: цру
пациентк: пациентке
урон: уронил
хоч: хочу
наушник: наушник
реш: решила
гарр: гарри
известн: известно известная
певиц: певица
сгоревш: сгоревшей
сторон: стороны
куриц: курицу куриц
обойт: обойтись
монстр: монстр
обитан: обитания
любов: любовь
аферист: аферистов
тысяч: тысячи
босс: босс
хорош: хорошие
стоимост: стоимость
любим: любимый
сред: среда
школьниц: школьниц
семилетн: семилетняя
аристократк: аристократка
растерза: растерзал
сафар: сафари
полюб: полюбила
похуден: похудения
язык: язык языка
избежа: избежала
умн: умных
доллар: долларов
лектер: лектера
арестова: арестовало
зоопарк: зоопарке
инсульт: инсульта
нат: нато
гол: голыми
выброс: выбросили
погон: погоня
информац: информация
экзорцизм: экзорцизма
группировк: группировке
развел: развелась
правд: правда
сопоставим: сопоставимого
взял: взялись
одержим: одержимости
планет: планеты
напуга: напугал
люд: людей
россиян: россияне
бельг: бельгии
гибел: гибели
замен: заменивший
двор: двор
объяв: объявили
трав: травила
девочк: девочка
упа: упавший
соперниц: соперниц
применен: применением
черн: черный
супруг: супруги
навоз: навоз
потеря: потерял потерянный
младш: младшего
спас: спасся
волн: волны
продаж: продажу
напа: напал
воспитыва: воспитывающие
настольн: настольному настольной
пляж: пляже
поножовщин: поножовщиной
забот: забота
страх: страхе
бандерас: бандераса
фетишист: фетишистов
уголовник: уголовника
приеха: приехать
сми: сми
кошмар: кошмар
укротительниц: укротительницу
огромн: огромного
убива: убивал
подарк: подарке
уборщиц: уборщица
загрызл: загрызла
масл: масла
музык: музыки
апрел: апреля
доктор: доктор
увлек: увлекся
утекл: утекли
россиянк: россиянки россиянка
стран: страну странный
аренд: аренды
январ: января
побег: побегов побега
громк: громких громкой
потрат: потратила
местн: местных
мутант: мутанта
сне: сне
март: марта
испытан: испытании
войт: войти
том: тома
испан: испании
медвед: медведь
бутылк: бутылку бутылке
глаз: глаза
дета: детали
бомб: бомбы
десятилетн: десятилетняя
букингемск: букингемском
убийств: убийство
медвеж: медвежьими
сект: секты секта
секс: секс сексом
болезн: болезни
подростк: подростком
ракет: ракеты
ограблен: ограбления
четырехметров: четырехметрового
сом: сома
ниндз: ниндзя
туалет: туалет
новост: новости
корол: король королю
принц: принц принца
существ: существ
перв: первую первая
корон: короне
съест: съесть
коров: корова
приня: приняли
добр: добро добра
оо: ооо
поиск: поиски
чемпион: чемпиона
рабств: рабством
равн: равно
брос: бросил
выбра: выбрана
оргазм: оргазма
тро: троих
как: какие каким
турист: туристов
крупн: крупнейших крупный
препятств: препятствия
герман: германию
исламист: исламистов
желудк: желудке
фильм: фильм
тюрьм: тюрьмы тюрьму
ткнул: ткнул
выпуск: выпуска
отпуст: отпустили
род: родила родилась
парфюм: парфюм
поведен: поведения
бывш: бывший бывшей
рож: рожу
реальн: реальный
тяжел: тяжело
отстран: отстранили
гараж: гараже
ром: рома
демон: демонами
ребенк: ребенка
вселюдизвериедапроисшествияперсонысчастливчикианомал: вселюдизвериедапроисшествияперсонысчастливчикианомалии
львов: львов
миллион: миллионы
июл: июля
полицейск: полицейскими
наход: находятся
столетн: столетняя
насилова: насиловал
погиб: погиб
каков: каково
killnet: killnet
ctrl: ctrl
appl: apple
iii: iii
enter: enter
