вешенк: сковороде
обычн: обычной обычная
жирност: жирности
пакетик: пакетиками пакетик
служ: служить
стал: стало
запеканк: запеканки
разлож: разложите разложить
став: ставим ставят
завис: зависит
центр: центр
дополнительн: дополнительно дополнительные
правов: рекламы
привлеч: лица
получен: полученную
килограмм: килограмм килограмма
пол: пол кролику
сто: стоит
очист: очистить
морков: морковью моркови морковь
то: запекания
морск: свежемолотый
присутств: присутствующим
должн: должны должна
суд: суде
новосибирск: новосибирске
готовн: готовности
подел: поделиться поделилась
жестк: жестких
царств: царствие
котор: которое которую
повар: повар
кулинарн: кулинарные иных кулинарная кулинарное
изготовлен: изготовление
высоцк: юлии
шаг: шаг
свят: святого
прав: правило толмач классические редакции
сливочн: грибами сливочного сливочное сливочным
небесн: небесное
воскрес: воскрес
появля: появляться появляются
начнет: начнет
дела: делается делать
десерт: десерта десерт
отрезк: отрезками
сух: сухой сухих белого
раствор: растворе
пряник: пряники
исключен: исключение
центральн: центральное
прост: простое прост простой простых
творожн: творожная творожные творожной творожную
украс: украсить
позвол: позволяя позволить
покрас: покрасить
зал: залить
занима: занимало занимают
светл: светлого
предупред: предупредила
пластинк: чеснок
лиц: виновные
православн: православного православных
ложк: ложкой ложка ложки ложку
луков: луковой луковом
весен: весенние
придума: украшают
сверх: сверху
убежа: убежать
част: часть
настоятел: настоятель
традицион: традиционные традиционных традиционно традиционного традиционное традиционный
слож: сложен
лопаточк: лопаточкой
промаза: промазать
одновремен: одновременно
постоя: некоторое
сдела: сделать сделанный
кольц: кольцо
особен: особенной
выкладыва: выкладываем
сложн: сложно
ча: чай чаем
оттенок: оттенок
совет: советует
пут: путь
примес: примесей
русск: русский русских
прикройт: прикройте
пример: примеру
символизир: символизирующие
ноч: ночь
вскипят: вскипятить
витал: виталий
смаза: смазать
слоен: слоеный
кастрюл: кастрюле
шеф: шеф
каркад: каркаде
отмеча: отмечается
алкогольн: алкогольные
красител: красители красителями
натал: лисовская
труд: труда
закреп: закрепить
оганез: оганезов
обезжир: обезжирить
процесс: процесс
роскош: роскошь
помогут: помогут
приступа: приступать
орнамент: орнаментом
постепен: постепенно
кондитерск: кондитерские
фина: мясные
подготовлен: подготовленные
противн: противном
миллилитр: миллилитров
помест: поместите поместить
выл: вылить
вым: вымыть
ванильн: ванильными ванильного
вечер: тайную
нрав: нравится
помощ: помощью
шалот: лука полукольцами
праздничн: праздничного праздничный праздничном праздничное праздничные
натерет: натереть
лор: лори
текст: выделите
будущ: будущее будущей будущую
клирик: клирика
подсказыва: подсказывает
сыр: сыром сыр
пореза: порезанных порезать порезанные
вкусн: вкусные вкусным
посыпк: посыпки
отключ: мослентыподписаться
вымочен: вешенки
приобрест: приобрести
слит: размокнут
росс: россии
четырех: рассчитанной
посыпа: посыпать
счита: считает
цел: цели коммерческих
освяща: освящает
середин: середины
кажд: каждом каждой каждого каждую
достаньт: достаньте
опечатк: нашли
крабов: крабовых
обжар: обжарить
радост: радости
первоцвет: первоцветы
маринова: маринованный
российск: законодательством
множеств: множество
коммерческ: сайта
духовк: духовке духовку
идут: идут
нежн: высоцкой
довод: доводим
использова: использовать использовали
юл: празднику
достаточн: достаточно
примерн: примерно
добавля: добавляем
плюшк: плюшки
настоя: настоящему настоящего настояться
ткан: тканью
пойдут: пойдут
растоплен: растопленное растопленного
лук: луковицы луком лук
выдел: опечатку
палочек: палочек
переверн: переверните
след: следующий следует следите следующим
аньк: аньков
помим: помимо
присыпа: присыпать
скорлуп: скорлупе скорлупу
зелен: зеленый последний
так: такую такого таком
присыпк: присыпки
письмен: разрешено
пыл: пыли
сним: снимите
событ: событие
храм: храма храм
течен: течение
лимон: лимонного
суфл: суфле
редакц: телефон редакция
хран: храниться
засыпа: финале
нахабин: нахабино
бан: бане
наполн: наполнить
назва: вечерю
собира: собирается
некотор: некоторые белые
липк: липким
игор: игорь
количеств: количество
консервирова: консервированной
добав: добавить добавив
разогр: разогрейте
подожда: подождать
специальн: специальные
друз: друзей
услов: условиях информация
объем: объема
кафедральн: кафедрального
евангел: евангелиям
друг: другими
субстанц: субстанцию
орехов: ореховой
водян: водяной
крас: красить
посто: постоит
тайн: христиане
попол: пополам
выпечк: выпечки выпечку
получа: получаются
главн: главной главная главное главный
полотенц: полотенцем полотенцами
разбира: разбираем
действ: соответствии
велик: великую правил великого
займ: займемся
сковород: сторон той
плотн: плотную
высуш: высушить
вешенок: грибов
христиа: христиан
мраморн: мраморные
рад: радуются
стака: стакан стакана
голуб: голубого
использ: используются используйте
раз: раза
фил: филе
рассол: рассола
щепотк: щепотка щепотку
магазин: магазинах
помн: помнить
стол: столах стол стола столы столе столом
отдельн: отдельности отдельно
выпекан: выпекания выпеканию
московск: московского
торжествен: торжественное
оригинальн: оригинальные оригинальных оригинальной оригинального оригинальное
тел: хлеб
победоносц: победоносца
ягод: ягоды
полн: полной защищены
заливк: заливку
зеленоват: зеленовато
ложек: ложек
бел: горсти сливок белой разогреть белая застолья белый
протерт: протертого
олив: оливье
расфасова: расфасованы
запрещ: запрещены
сильн: сильном
работа: остальном
прос: просейте
покр: покрыть
заправля: заправляем
долж: должен
уменьш: уменьшить
пром: промыть
телефон: нажмите
необходим: необходимо
подходя: подходящую
плоск: плоскую
передержива: передерживать
чист: мясу
жидкост: жидкость
толмач: сливками
бабушк: бабушки
отвар: отвар отварить
автор: комментировать
подава: подавать
перестанет: перестанет
картофел: картофеля ним картофель
подход: подходит
противен: противень
разрешен: письменного
ингредиент: остальным ингредиент ингредиентов
температур: температуры температуре
майонез: майонезом майонез
ростов: ростове
оста: осталось четверг оставшимися оставшуюся осталась
хозяйк: хозяйки хозяйке
быстр: быстро
рамок: рамок
виновн: нарушений
разреш: целях
коньяк: коньяку коньяком коньяк
распространен: распространенный
угощен: угощение угощения
остав: оставить
ягн: ягнят
украша: украшать финал
подтвержден: подтверждением
довест: довести
недел: недели
реж: режем
емкост: емкость емкости
серг: сергей
побольш: побольше
испеч: испечь
золотист: золотистым
культурн: культурный
грамм: граммов грамма
высохнут: высохнут
может: можете
разнообразн: разнообразным
мног: многие
островск: островский
люб: любом любой правила
отрадн: отрадном
снят: снять
потреб: потребуется потребуются
фот: фото
обязательн: обязательный
возрожден: возрождение
искуп: искупил
взят: взять
освят: освятить
разн: разные разного
приспособлен: приспособления
веточк: веточку
кружевн: кружевными
белков: белковую
мирликийск: мирликийского
растительн: растительное растительным
огн: огне огня
законодательств: действующим
шампиньон: шампиньоны шампиньонов
супруг: супруга
прич: причем
сахар: сахара сахаром сахар
кухон: кухонным
постара: постарайтесь
одн: одному одну одним одно
рис: рисе
широк: широко
согласн: согласно
кукуруз: кукурузы
огурец: огурец
реклам: отключить размещение
белоус: белоусов
прилипш: прилипшие
бумажн: бумажными
масс: массой массы массу масса
гнет: гнет
итак: итак
однородн: однородный однородная однородным однородной
масл: масла масло маслом
подня: поднявшееся подняться
чеснок: зубчик шалот
апрел: апреля
сухофрукт: сухофрукты сухофруктов сухофруктам
ограничива: ограничивается
олад: оладьев
использован: условия
треснул: треснули
яиц: яиц
лисовск: холодильник
остынут: остынут
марл: марлю марлей марли
состав: составить
нагрет: нагреть
сраз: сразу
столов: вина столовую
крест: кресте
шелух: шелухе шелухи шелуху
напитк: напитки напитков
татья: татьяна
холодн: холодный
вечн: вечная
перч: солим
рецепт: рецептов рецепт рецепты рецептом рецепте
празднован: празднования
половин: половину половины
яйц: яйца яйцом яйцу яйцами яйцо
ножек: четырех
чайн: чайная чайную
подогрет: подогреть
соломк: соломкой
хлеб: кровью
новост: новости
существ: существует
добавьт: добавьте
близк: близких
партнерск: рекламу
каш: каши
уйдет: уйдет
желтк: желтки желтками
сливк: полив
застол: застолью любого
мед: меда
птиц: белое птицы птиц
цукат: цукаты
напомина: напоминать
нареза: нарезать
смешива: смешиваем
откройт: откройте
заполн: заполняя
род: рода
высок: высокой
обход: обходится
втор: втором
манк: манкой манку манки манке
риск: рискуют
дешев: дешевых
мен: меню
способ: способов способ способы
форм: формам форма формами форм формы форму
кролик: кроликов обжарку нежного
рекоменд: рекомендуется рекомендуют
жертв: жертвой
обрат: обратиться
готов: готовы готовую готово готовые готова готовое готовить готовим готовят готовятся готовили
максимальн: максимально
финал: зеленым
провер: проверить
петрушк: петрушки
образ: образом
орех: орехов
смеша: смешайте смешать
кусочк: кусочками
конц: концом
крестн: крестной
ванил: ваниль
предлага: предлагается предлагает предлагают
блендер: блендером
появ: появятся
случа: случае
свар: сварить сварены
пышн: пышным
частичн: полное
практическ: практически
окрашен: окрашенную
грех: грехи
частичк: частички
четверт: четверти четверть
салатник: салатнике
александр: александр
обновлен: обновление
иисус: иисус
наканун: накануне
туш: ингредиентам
фигурн: фигурную фигурные
четверг: великий
преврат: превратилось
сухар: сухарей сухарями
всенощн: всенощная
вишн: вишню вишни
показа: показаться
поэт: поэтому
отправ: отправить
дрожж: дрожжей дрожжи
волокн: волокна
вкрут: вкрутую
мин: мин
вариант: варианта вариантов вариант варианты
подольш: подольше
пасхальн: пасхальная пасхальному пасхальное пасхального пасхальные пасхальных пасхальном пасхальный
изолент: изоленты
предприят: предприятии
выпека: выпекать выпекайте выпекаем выпекаться
перемешива: перемешиваем
сырн: сырной сырная
идеальн: собственного
обжарк: тушим
этап: этапе
христиан: позади
нажм: текст
приготовлен: приготовленную приготовлении приготовления приготовление
классическ: классическом работают классический
украшен: украшением украшения
получ: получился получившейся засыпать получившуюся получившееся получиться получилась
важн: важно
город: город
кулинар: кулинар
кров: назвал
рук: рукой руками
раскладыва: раскладывает
час: час часов часа
угост: угостить
грядущ: грядущем
традиц: традиция традиции
пудр: пудры
репчат: репчатая
могл: могло могли
ярк: яркие
жарен: жареный
матушк: матушка
приготов: приготовить
типляшин: типляшина
нарушен: обнаружения
выделя: выделять
больш: больших большие большую
мест: место
блюд: блюд блюда блюдо
помидорок: помидорок
пирог: пирогов
сливок: чеснока
оливков: оливковое столовая
пузыр: пузыри
соус: сливочном
смета: сметаны
гарнир: гарнира гарнир
страшн: страшном
ост: остыть
жар: жарим
смоч: смочить
катерин: катерина
глазур: глазури глазурь глазурью
константин: константин
салат: салатов салаты салатом салата салат
мослентыподписа: интересного
хорошеньк: хорошенько
сахарн: сахарной
владельц: разрешения
градус: градусов
удив: удивить
комментирова: кофе
провод: проводится
домашн: домашнюю домашних
нужн: нужного нужны
накле: наклеить
смерт: смерти
христов: христова
аккуратн: аккуратно
изюм: изюма изюм
вылож: выложить
корейск: корейски
убира: убираем
результат: результате
крошк: крошкой
разогрет: морская
христос: христос
полож: положить
поставьт: поставьте
павел: павел
сковородк: сковородку
кулич: куличами куличи кулича куличей кулич
дал: далее
жидк: жидким
пригорел: пригорели
богат: богатым богатых
рисунк: рисунки
закуск: закуски
забудьт: забудьте
измельчен: измельченных
жен: жена
займет: займет
белякин: белякина
суббот: субботу
дат: дать
указа: указал
состоя: состояло
вкус: вкуса вкусов вкус
станет: станет
хват: хватить
код: код
мелк: мелкой мелкими мелко
медов: медовые
угоща: угощают
половинк: половинка
цедр: цедры цедру
белк: белки белка
перемеша: перемешайте
понадоб: понадобится
мук: муки мука муку мукой муке
предлож: предложили предложить
запекан: обжариваем
заран: заранее
спасен: спасению
коф: идеально
сохран: слить
политик: использования
рыб: рыбы
вмест: вместе
рассчита: соусе
белок: белок
разъемн: разъемная
покупа: покупают
прилож: приложить
жив: живые
литр: литра
обжарива: сковороду
остыва: остывает
заня: заняться
накрыва: накрывают
сладк: сладких
совершенств: совершенства
изнутр: изнутри
животн: животных
воскресен: воскресения
пост: поста
протерет: протереть
вытащ: вытащить
ковальчук: ковальчук
вспомина: вспоминают
минут: минут
стольк: столько
дел: дело
рассказа: рассказала
вар: вариться варите
панировк: панировки угодно
приобретут: приобретут
размер: размера
пропорц: пропорциях пропорции
измельча: измельчаем
ваш: вашим вашего
просея: просеянная
порц: порции
размокнут: постоять
богослужен: богослужение
новогодн: новогоднего
рульк: ленивых
собствен: морсы
копирован: частичное
идеал: идеале
позад: остался
людьм: людьми
натерт: натертую
материал: партнерские копирование
поднима: поднимается
имбирн: имбирные
равномерн: равномерно
гнезд: гнездом гнездо
просуш: просушить
закип: закипит
поперч: поперчить
последн: картофелем
вознесенск: вознесенского
плит: плиты
пивовар: пивоваров
сам: самое самый самые
священнослужител: священнослужитель
плавлен: плавленым плавленый
куплен: купленное
сутк: сутки
инач: иначе
георг: георгия
гост: гостей гостям гости
творог: творог творога творогом
принят: принято
нашл: конфиденциальности
женщин: женщина
допуска: допускайте
укроп: укропа
тарелк: тарелку
смысл: смысл
замеша: замешать
предполага: предполагаемого
никол: николая
пасх: пасху пасхой пасха пасхи
очередн: очередной
вер: верующего веры верующие
популярн: популярностью
обваля: обвалять
начн: начнем
цвет: цвет цветы цвета
апельсин: апельсина
яичн: яичные яичный яичными
коричнев: коричневых коричневый
церкв: церкви
сво: телом своими свой
тест: тесто тестом теста
замочен: замоченный замоченного
пообеща: пообещал
кряж: кряжев
подогр: подогрейте
полчас: полчаса
узк: узким
бабкин: бабкина
да: даем
настаива: настаивается
кубик: кубиками
сайт: автор материалов
свежемолот: оливкового
трех: трех
различн: различных
терк: терку терке
трет: трети
перец: перец
щедр: щедрым
яблок: яблока
подгорет: подгореть
подойдет: подойдет
пар: пару
вин: сухого вино
истор: истории история
зовут: зовут
двум: двумя
праздник: праздник дней праздником
тепл: теплого теплое
сем: семьях семью семье
натуральн: натуральными
легк: легко
вид: виде
убра: получившийся
конфиденциальн: политика
дно: дно
красн: красных птице
замоч: замочить
трефил: трефилов
курин: куриных куриные куриного куриными
пришеств: пришествии
вымачиван: вымачивания
зеленк: зеленки
хот: хотим хотите
дне: изысков
дни: дни
помидорк: помидорки
дом: доме дома
дон: дону
известн: известно известный известных известные
изюминк: изюминки
горяч: горячий горячей
постав: поставить
сторон: перчим
куриц: курицу
слегк: слегка
шоколад: шоколад
остальн: вымоченные своим
угодн: придумать
родственник: родственников
пуст: пусть
ид: идеи
защищ: права
морс: соки
любим: любимый
ин: рульки иной
возьм: возьмите
религиозн: религиозными
процед: процедить
гречк: гречка
измельч: измельчите
мясн: наталья
полукольц: сохранить
сит: сито
мяс: мясо красное
евген: евгения
стенк: стенки
информац: правовая
сварен: сваренные
изыск: кулинарных
трат: тратить
ворон: ворона
крашен: крашенные крашению крашеными крашеные
замес: замесите замесить
господн: господня
полсотн: полсотни
мундир: мундире
пен: пены пену
предварительн: предварительно
горст: вешенок
варк: варкой варки варке
добавлен: добавлением
размещен: материалы
черн: черный
собра: собрала
черр: черри
крапинк: крапинку
хозя: хозяев
холодильник: холодильнике холодильника убрать
пролож: проложить
например: например
подготовк: подготовку
отварн: отварной
отправля: отправляем отправлять
обмота: обмотать
супермаркет: супермаркете
ванилин: ванилина ванилин
надежд: надежду
смажьт: смажьте
соответств: соответствующих ответственности
комнатн: комнатной
сме: смесь
освящен: освященное
священник: священников священник священника
польз: пользуется
сло: слой
ответствен: привлечены
вод: вода воду воды водой
окраск: окраски
федерац: российской
замешива: замешивайте замешивать
алл: алла
поменьш: поменьше
свеж: свежее свежие свежий
качеств: качестве
взбит: взбитые взбить
распредел: распределено распределить
медвед: медведь
выбор: выбор
собор: собора
обнаружен: владельца
скотч: скотча
раздел: разделить
алин: алина
сок: сока чистая
сол: соли соль пластинками
полоск: полоски
владимир: владимир
небольш: небольшим небольшую небольшой
окрашиван: окрашивания окрашиванием окрашивание
пойдет: пойдет
интересн: интересных сайт
возможн: возможных
фотобанк: фотобанк
огон: огонь
брос: бросив
ленив: панировке
увелич: увеличиться
получат: получатся
черносл: чернослив
получас: получаса
молот: молотый
кураг: курагу
луковиц: луковиц луковица белых
крупн: крупная крупной
непосредствен: непосредственно
молок: молоко молока
гриб: кролика ножек грибы
сметан: сметану сметаной
прежд: прежде
чехл: чехле
зубчик: шалота
низ: низов
воспользова: воспользоваться
спасител: спасителя
ри: риа
импровизирова: импровизированном
оттенк: оттенка
распят: распятый
пищев: пищевые
никак: никаких
мослент: мослента
aa: aa
rss: rss
moslenta: moslenta
ctrl: ctrl
usmanov: usmanov
globallookpress: globallookpress
telegram: telegram
zamir: zamir
enter: enter
