нейрон: нейронов
ввоз: ввоз
максимальн: максимально
ру: ру
влиян: влияние
студентк: студентке
депортац: депортацией
стат: статьи
обычн: обычную
оказа: оказался
отдыха: отдыхавшую
стал: стали стала стало
дорог: дорог
дорож: дороже
предлага: предлагающих
удал: удалить
гуля: гуляющим
работ: работу
центр: центре центр
поб: побили
доступ: доступен
вернут: вернуться
рейс: рейсами рейсы рейс
арх: архив
экономик: экономика
предел: пределы
возмут: возмутил
сто: стоит
таможенник: таможенники
рейд: рейдами
манхэттен: манхэттене
добра: добраться
человек: человека
схем: схемы
слома: сломанным
единствен: единственным
лазер: лазером
торгова: торговаться
взрыв: взрыва
личност: личность
морск: морской
ошибок: ошибок
структур: структуры
изверга: извергающимся
ослеп: ослепить
пригроз: пригрозили
отправ: отправил
воруем: воруемые
ланк: ланку
карм: карма
здан: здание
льда: льда
мин: мини
мир: мир мире миру
укол: уколов
силов: силовые
секретн: секретные
медлительн: медлительных
прав: правила
девушк: девушками
нажм: нажмите
резк: резко
феврал: февраля
вперв: впервые
учин: учинили
драк: драки
власт: власти
шивелуч: шивелуч
фронт: фронте
член: членов
город: городе
просветлен: просветление
беремен: беременности
укра: укравших
поездок: поездок
мексик: мексике
украин: украине
гранат: гранатой
раскр: раскрыли
выстав: выставил
прям: прямые прямыми
россиянин: россиянин россиянину россиянина
рубл: рублей
сосед: соседа
отел: отель отеля отелей
сплошн: сплошная
предупред: предупредили
украинц: украинцам
уровен: уровень
нов: новый новой
атор: атор
китайск: китайским
мест: местом места
устро: устроил
аэрофлот: аэрофлот
йем: йемен
сорва: сорвал
слов: словами
направлен: направления
минвод: минводы
живописн: живописные
пострада: пострадали
выдава: выдавать
воровств: воровстве
эффективн: эффективность
видет: видеть
гран: грани
деактивирова: деактивирована
редакциярекламаконтактыпресс: редакциярекламаконтактыпресс
свыш: свыше
жизн: жизни
русск: русские русским
ретрит: ретриты
отд: отдых
самолет: самолета самолет самолете
пыта: пытались
чебурашек: чебурашек
стюардесс: стюардессу стюардессы стюардессой стюардесса
загрязнен: загрязнения
смягч: смягчила
средиземн: средиземного
отм: отмена
бронирова: бронировать
летн: летнего
мошенничеств: мошенничества
владелиц: владелица
мор: моря
лестниц: лестницу
основн: основной
путешеств: путешествии путешествия путешествие
курс: курс
клад: клади
сша: сша
лидер: лидер лидерами
автостоп: автостопом
экзотик: экзотика
пойма: пойманный
трагед: трагедией
роскош: роскошью
джин: джин
сознан: сознание
техник: техника
привест: привести
утечк: утечки
европ: европы европу
пуска: пускать
мгновен: мгновенная
культур: культура
шасс: шасси
провоз: провоза
удив: удивилась
личн: личные
ужесточ: ужесточила
бесплатн: бесплатные
вып: выпил
вылож: выложившего
опаса: опасаться
неизвестн: неизвестный
врач: врач
ввел: ввели
лоукостер: лоукостер
востребова: востребованные
проеха: проехал
красив: красивейших
завален: заваленный
полос: полосы
опасн: опасных опасны опасный опасности опасная
буйн: буйный
богач: богачей
крик: криков
жител: жителя
богат: богатых
страховк: страховку страховке
документ: документы документов
будущ: будущих
сравнива: сравнивают
афганиста: афганистана
задержа: задержали
аварийн: аварийную
загадочн: загадочных
задержк: задержка
штраф: штраф
дан: данные
белорусс: белоруссию
задымлен: задымления
пожар: пожара
въезд: въезда
оплева: оплевал
иностранц: иностранца
спецпроект: спецпроекты
посторон: постороннего
раскрыт: раскрыты
легендарн: легендарный
суров: сурово
росс: россии россия россию
гиперзвуков: гиперзвуковой
разруш: разрушило
мотор: мотор
допуст: допустить
ситуац: ситуацию
пожалова: пожаловать
бабл: бабла
таиланд: таиланд таиланда таиланде
отказа: отказалась отказали отказались
летевш: летевший летевшем
конюх: конюхов
цен: цены
изъя: изъяли
очк: очков
лент: лента ленту
фраз: фразой
доступн: доступные
наркотик: наркотиков
опечатк: опечатку
галер: галереи
границ: границей
оцен: оценили оценил
российск: российские российского российском российская российский
авиарейс: авиарейсов
остров: острова
восток: востока
полиц: полицию
военнообяза: военнообязанному
идут: идут
увидел: увидел
жив: живым
обнов: обновила
поездк: поездку поездкам
жил: жилья
билет: билеты билет
оттаска: оттаскал
сома: сомали
вычисл: вычислить
заброшен: заброшенное
медиа: медианная
совершенств: совершенства
настоя: настоящей
кра: край
ссср: ссср
вулкан: вулканом
ремонт: ремонта
произошл: произошла произошло
незабыва: незабываемое
слез: слез
посещаем: посещаемости
напомн: напомнили
рассказа: рассказали рассказал
жит: жить
попробова: попробовать
балканск: балканская
вулка: вулканы
москв: москвы
срок: сроки
ручн: ручной
дьявол: дьявол
бал: бали
бан: баня
август: августа
дет: детей
назва: названы назвали назвала назвал
минус: минусах
суицид: суицид
сэконом: сэкономить
смен: сменил
космонавтик: космонавтики
обернул: обернулось
разочарован: разочарованием
иска: искать
куп: купил
турц: турции турцию
аз: азии
аэропорт: аэропортах аэропорт
пересадок: пересадок
попа: попал попала
оформлен: оформлением
сожгл: сожгли
кита: китаем
посмотрет: посмотреть
спорт: спорт
последн: последнего последние
путешественник: путешественников
сам: самая самые самых самыми
захотел: захотела захотели
жми: жми
отдохнут: отдохнуть
правильн: правильно
настигл: настигла
тайн: тайные
попутчик: попутчиков
ира: иран
главн: главное главные
полет: полетов
действ: действия
поклонник: поклонников
нашл: нашли
предпочтен: предпочтения
женщин: женщины
непал: непале
низк: низкие
достигл: достигли
взросл: взрослых
пасх: пасхи
зарубежн: зарубежные
месторожден: месторождение
популярн: популярный популярная популярных популярные
шри: шри
мужчин: мужчина
смертельн: смертельной
мишен: мишень
рад: рады ради
пентагон: пентагона
сво: сво
пассажирск: пассажирском пассажирского
нача: начал
бортпроводник: бортпроводниками
интернет: интернет
россия: россиян
необычн: необычные
московск: московских
разозл: разозлили
волос: волосы
рекорд: рекорд рекорда
взволнова: взволновала
вещ: вещи
карел: карелии
тел: тело
пришл: пришлось
туристк: туристку
полн: полным
полк: полку
бед: беде
авиабилет: авиабилеты авиабилетов
алта: алтае
туризм: туризм
поеха: поехать поехал
всероссиямирсобытияпроисшествиямнен: всероссиямирсобытияпроисшествиямнения
щедр: щедрыми
ценност: ценности
эконом: экономить
пром: промо
виз: виз визы
ласточк: ласточке
вин: вино
океа: океана
истор: истории
памирск: памирский
лондон: лондон
озверел: озверели
шум: шума
канализац: канализации
возгоран: возгорание
подозрева: подозреваемого
довел: довели
сем: семьи
психоз: психоз
легк: легкая
вид: вид
мошенник: мошенников мошенниках
представител: представителей
убра: убрать
сет: сети
виде: видео
остр: остров
картофел: картофеля
умер: умер
внов: вновь
чуж: чужие
историческ: исторический
быстр: быстрым
тайск: тайский
фрукт: фруктов
наук: наука
стрем: стремятся
разреш: разрешили
дом: дома
контрабанд: контрабанде
реш: решили
известн: известно известную
юбк: юбке
знаменит: знаменитые
ирак: ирак
крым: крым
предостав: предоставил
обитан: обитания
тысяч: тысячи
побыва: побывал побывала
дню: дню
родн: родных родного
хорош: хорошие
стоимост: стоимость
удобн: удобные
любим: любимой любимом
сред: среда среди
грозя: грозящие
улучш: улучшили
домога: домогаться
въеха: въехал
погибл: погибли
чувств: чувство
пользовател: пользователей
уста: устал
полюб: полюбили
люб: любят
зависим: зависимость
закроют: закроют
похуден: похудения
язык: язык
планирован: планировании
умн: умных
сил: силы
пилот: пилотов
борт: борту
фот: фото
посадочн: посадочной
сир: сирии
сервис: сервисы
путешествова: путешествовать
гроз: грозят
нат: нато
погибш: погибшего
описа: описал описала
информац: информация
курорт: курортов курорта курорт курорте
соседк: соседки
соверш: совершил
гор: гору
земл: земли
завлеч: завлечь
посещен: посещения
восхожден: восхождения
напуга: напугал
трат: тратили
люд: людей
россиян: россиянам россияне россиянами
забра: забралась
разб: разбился
гибел: гибели
плюшев: плюшевых
подра: подрался
сканда: скандал
визов: визовые визовый
лагер: лагерях
шенг: шенген шенгена
раздаст: раздаст
ко: ко
хуж: хуже
потеря: потерявшей
притяжен: притяжения
избега: избегать
непозволительн: непозволительной
одн: одном одну
продаж: продажу продаже
напа: напал
глэмпинг: глэмпинги
пляж: пляжем пляж пляжи
миров: мирового мировой
забот: забота
запуст: запустить
откроет: откроется
страх: страхе
попрос: попросили
устрем: устремились
сми: сми
выда: выдать
итал: италии
обстоятельств: обстоятельствах
музык: музыки
ма: мае
апрел: апреля
мусор: мусором
багажн: багажную
венгерск: венгерский
россиянк: россиянку россиянка
стран: страна странах страны стране стран
аренд: аренды
январ: января
громк: громкой
тракт: тракт
южн: южная
пьян: пьяные
местн: местные
кресл: креслу
горазд: гораздо
март: марта
испытан: испытании
песн: песни
войт: войти
отдых: отдыха отдыхе
ноутбук: ноутбука
массов: массовая массово
выживан: выживания
еха: ехать
ближн: ближнего
выбор: выборе
пошлост: пошлость
посадк: посадку посадка
сект: сектой
болезн: болезни
автоматическ: автоматическую
похож: похоже
ракет: ракеты
угроз: угрозой
жела: желанные
туалет: туалете
новост: новости
выдвор: выдворить
лучш: лучшим
напиток: напиток
красноярск: красноярска
нарва: нарвались
посет: посетил
тоник: тонике
добр: добро добра
экстрен: экстренную
оо: ооо
спа: спа
коре: корея
равн: равно
молод: молодыми
брос: бросил
привыкл: привыкли
голов: головы
обнаж: обнажившуюся
огол: оголившийся
пассажир: пассажиром пассажира пассажир пассажирами пассажиры пассажиру
как: каких
участник: участников
турист: туриста туристам туристов турист туристы туристу
все: всей
китайц: китайцы
соч: сочи
папик: папикам
авиакомпан: авиакомпании авиакомпания
встреча: встречали
тюрьм: тюрьмы тюрьмой
надвига: надвигающейся
выпуск: выпуска
мальдив: мальдивах
высок: высоких
бывш: бывший
реальн: реальный
отпуск: отпуска
точн: точно
песняр: песняров
риск: рисках
дешев: дешевый
выкат: выкатился
мрамор: мрамора
бронирован: бронирования
откр: открылся
способ: способ
полицейск: полицейскими
оскорблен: оскорблениями
бюджетн: бюджетно
killnet: killnet
maserati: maserati
ctrl: ctrl
appl: apple
enter: enter
vip: vip
