встал: встал
париж: париж парижа парижу
ру: ру
говор: говоря говорят говорить
пенс: пенсии
банк: банков
революцион: революционные
понима: понимает понимал понимало
фактическ: фактически
лев: левые
оттуд: оттуда
охра: охраны
рассказ: рассказам
стат: стать статьи
воен: военным военному военными военного военные военных военный военной военную
обычн: обычную
стар: старого старых
оказа: оказалось оказались
европейск: европейских европейские европейской европейский
износ: износ
повторн: повторных
стан: стане
капризн: капризной
рабоч: рабочую
служ: служивший служить
стал: стала стали
мнен: мнение
се: сей
социалист: социалисты социалист социалистов
объясн: объяснил
северн: северной
став: став
повторя: повторяют
центр: центров
оккупацион: оккупационная оккупационную
работ: работу работы
гарольд: гарольду
север: север
арх: архив
клаус: клаусом
экономик: экономику экономика экономики экономикой экономике
уговор: уговорил
пол: поля
сто: стоил
высад: высадились
размеща: размещать
человек: человека человеком
прийт: прийти
охот: охоту
поступ: поступил
лет: летия летом
вооружен: вооруженных вооруженными вооружений
интеграц: интеграции
арк: арки арк
мультикультурализм: мультикультурализма
арм: армии армия армию
разговор: разговоре
замглав: замглавы
проголосова: проголосовали
должн: должное должны должна
снижен: снижения
структур: структуры
недооцен: недооценил
запас: запасы
благодар: благодаря благодарю
назван: название
котор: которую которым которое котором которому которыми
уб: убившей
провест: провести
времен: временное временном временем
осозна: осознав
предательств: предательство предательстве предательству
законодательн: законодательные
силов: силовые
потушен: потушенный
секретн: секретный
отдава: отдавало
слушател: слушателем
железнодорожн: железнодорожный
вест: вести
участвова: участвовал
прав: правые право
связа: связано связанная
визит: визитом визита
уч: учился
двига: двигаться
проект: проектах проект проекта
недовольн: недовольны
связ: связей
вперв: впервые
совместн: совместную
отмеч: отмечены
дела: делает делал
часов: часовую
спбгу: спбгу
адъютант: адъютантом
дискусс: дискуссии
режим: режима
верн: верный
полага: полагался
вывел: вывел
член: членам членов
исключен: исключение
защ: защите
некогд: некогда
книг: книги книге
увеличива: увеличивались
центральн: центральных
обознача: обозначал
прост: простой простыми
либера: либерал
союзник: союзников союзникам союзника союзники союзниками
врем: времена времен
укрепля: укреплять
военачальник: военачальник
позвол: позволил позволили позволит
сосед: соседей
справ: справиться справится справа
занима: занимал занимает занимали
свободн: свободная свободно свободными
фкно: фкно
крепост: крепости
справедлив: справедливость
страхован: страхования
лиц: лице
встреч: встречи встречу встреч
почин: почину
родин: родину родине
встрет: встретить
полномоч: полномочиями полномочий полномочия
просчита: просчитался
очевидн: очевидное
нов: нового новым новый новой новую новые новых новое
освободительн: освободительных
внешн: внешнюю внешней
жега: жеган
сверш: свершить
слом: слом
вшэ: вшэ
част: часть части
слож: сложа
опубликова: опубликовали
устро: устроила
слов: словам
пятилетн: пятилетние
пострада: пострадала
одновремен: одновременно
постоя: постоянно постоянную
отказ: отказ
излож: изложил
системн: системным системную
сдела: сделать сделал сделало сделавшую
единомышленник: единомышленников
досуг: досуг
покинувш: покинувших
изгнанник: изгнанник
деактивирова: деактивирована
судьб: судьба судьбы судьбой
сложн: сложная
родител: родителей
фигур: фигур
совет: совета
пут: пути путем
посеща: посещали
моментальн: моментально
активн: активности активное
русск: русский русского русским
вперед: вперед
пример: пример
распростран: распространились
расчет: расчетах расчет
колониальн: колониальная
динамичн: динамично
предвыборн: предвыборной
немц: немцы немцами
процедур: процедуру
систем: система системе
выход: выход выходя выхода выходу выходит
должност: должности
средиземн: средиземном
государствен: государственности государственную государственных
национализац: национализация национализацию
оккупац: оккупации оккупацией
убежда: убеждали убеждал
отмеча: отмечает
торгов: торгового торговое
триумф: триумфа
перебра: перебрался
трудн: трудные трудный
путешеств: путешествия
лета: летал
курс: курса курс
облада: обладавший обладает
атакова: атаковала
сша: сша
ресурс: ресурсам
лидер: лидер лидером лидера лидеры лидеров
миха: михаил
процесс: процесс
групп: группы группа
молодеж: молодежь молодежи
техник: техника
напрот: напротив
неудач: неудачу
приведет: приведет
европ: европа европе европы
достойн: достойное достойного
постепен: постепенно
хотел: хотели хотелось
культур: культура культуры культуре
уступ: уступив
актуальн: актуальной
продолжа: продолжает продолжать
господ: господа
католик: католиком католика
обраща: обращался обращали
помога: помогать
могуществен: могущественная
нрав: нравилось
неизвестн: неизвестного
меланшон: меланшон
помощ: помощью помощи
современ: современной
немал: немалыми
марсел: марселя
вагон: вагон
лож: ложитесь
напряжен: напряжение
подав: подавить
выступ: выступил
изгнан: изгнании
валют: валюте
заключ: заключили
враг: врага
попытк: попытка
промышлен: промышленности промышленность
уважен: уважение
будущ: будущей будущий
земмур: земмур
желан: желании
повзрослел: повзрослело
взор: взоры
ироничн: иронично
сын: сын
немецк: немецкий немецкой
почетн: почетного
опасен: опасениям
подчеркива: подчеркивает подчеркивал
интерес: интересах интересы
инвестиц: инвестициям инвестиций
средств: средства средств
арен: арене
воззрен: воззрения
пожал: пожалуй
потребова: потребовал
макмиллан: макмиллану
патриотическ: патриотически
нацизм: нацизмом
охват: охватили
отключ: отключены
борьб: борьбу борьбе
коммунист: коммунисты
музе: музеев
минимальн: минимальными
спецпроект: спецпроекты
генера: генерал генерала
француз: француза французами французом французов французам французы
закон: закон законным
конкурентн: конкурентными
казн: казнен казне
рост: рост роста
росс: россия
задумыва: задумывался
эйзенхауэр: эйзенхауэром эйзенхауэру
процент: процента процентами
росл: росла
вашингтон: вашингтону вашингтона вашингтоном
мотор: мотор
автомобил: автомобиль
романтичн: романтичным
студенческ: студенческим
убед: убедило
числен: численность
ситуац: ситуация ситуацией
битв: битвой
выдвинул: выдвинул
счита: считали считала считает считают считал
причин: причины
противоположн: противоположных
цел: целью
цен: ценные
маршалл: маршалла
лент: лента ленту
середин: середине
мирн: мирное
забастовок: забастовок
кажд: каждым
опечатк: опечатку
шла: шла
эл: элите
множеств: множество
внешнеполитическ: внешнеполитической внешнеполитическая внешнеполитические
взаимодейств: взаимодействия
закрепля: закреплялось
политическ: политическим политический политическая политическом политического политические политических политической политическую политическое
создава: создавался
золот: золотые золоте золото
администрац: администрация администрации
параллельн: параллельно
властн: властных
иностра: иностранного
всяк: всякого всяких
завершен: завершения
пятер: пятерых
африк: африки африке
кафедр: кафедры
безусловн: безусловно
примерн: примерные
тухачевск: тухачевский
карьерн: карьерной
настоя: настоящим настоящая настоящую
ядерн: ядерным ядерное ядерными ядерной
ссср: ссср
североатлантическ: североатлантическом
езд: ездил
сталинск: сталинских
след: следующий следующем след следующей
текучк: текучку
слев: слева
институт: институтов
нашел: нашел
организац: организацию организации
конституц: конституции конституцию
отнын: отныне
бюджет: бюджет
истека: истекал
помим: помимо
суверенитет: суверенитета суверенитет
попыта: попытались
статус: статусом статусе
рыночн: рыночная
коротк: короткую
мясорубк: мясорубкой мясорубке
так: таких
одобря: одобрял
снил: снилась
соратник: соратник
перевест: перевести
отсылк: отсылки отсылками
семейств: семейства
сниз: снизить
течен: течения
назнач: назначил
баз: баз базу базы
исполнительн: исполнительной
уменьша: уменьшались
мощн: мощной
учред: учредил
атомн: атомной
капитуляц: капитуляцию капитуляции
назва: назвать назвали назвал
символ: символы символом символов символа
товар: товары
утверд: утвердили утвердил
собира: собиралась
строптив: строптивым
провозглашен: провозглашение
турн: турне
предпочита: предпочитал
некотор: некоторые
игор: игорем игорь
служб: службу
соглашен: соглашение
конрад: конрад
попа: попал попала
остава: оставались оставалась оставалось
спорт: спорт
транспорт: транспорт
нацист: нацистов нацистами
консенсус: консенсус
услов: условиях условии
стро: строить строю
представля: представляется
расстрел: расстрел
друг: другом друг друга
зон: зону
тюремн: тюремные
восстанов: восстановилась восстановили
однокурсник: однокурсники
наступ: наступит
тайн: тайную
останет: останется
народ: народа народ
рассказыва: рассказывает рассказывали
гвине: гвинея
государственничеств: государственничество
программ: программе программах программы
получа: получал
главн: главной главным главных главное
действ: действующей действий
соответствен: соответственно
покида: покидать
помпидупремьер: помпидупремьер
обеспечива: обеспечивает
велик: великой великую великих
пят: пятой
привел: привело привели привел
низк: низкого
избирател: избирателями избирателей
элемент: элементов элементы
рубеж: рубежом
инициатив: инициативы инициатива
стоя: стоял
поражен: поражения поражение
рад: радио ради
отстоя: отстоял
созда: создало создается создана создал созданной создали создает
ран: ранен ранее
объясня: объясняет
отдельн: отдельных
занов: заново
протест: протесты протестов
англосаксонск: англосаксонское
сохранен: сохранении
интернет: интернет
командован: командование командованию командования
учител: учителя
вступ: вступили
торжествен: торжественно
ранг: ранг
штаб: штабу
официальн: официальным официально официальные
заслуг: заслуга заслуги
великобритан: великобританию великобритания великобританией
пришл: пришла пришлось
полн: полной полного полном
полк: полк
легенд: легенде
затянувш: затянувшейся
дважд: дважды
дистанцирован: дистанцирование
приглашен: приглашению
местечк: местечке
реформ: реформы реформ
орлеанск: орлеанская
знал: знали
комментар: комментарии
позицион: позиционной
рамк: рамка рамках
коллаборационистск: коллаборационистского
ингольштадт: ингольштадт
сильн: сильно сильной сильна
работа: работало работал работала
запрет: запретил
долг: долгие
репресс: репрессий
долж: должен
африканск: африканским африканские
исключительн: исключительно
капита: капитан капитана
кандидат: кандидат
проанализирова: проанализировать
пособ: пособия
необходим: необходима необходимости
числ: числе
проб: пробыл
период: период
неустойчив: неустойчивость
нейтральн: нейтральные
совбез: совбезе
клуб: клубе
кризис: кризисы кризисом кризисах кризиса
сложност: сложности
сотруднича: сотрудничал
одобр: одобрили
пойт: пойти
очеред: очередь
чита: читал
глобализац: глобализации
опор: опорой
виде: видео
положен: положении положения
обстановк: обстановка
овдовел: овдовела
несистемн: несистемный
антигитлеровск: антигитлеровское антигитлеровской
президентск: президентский президентских президентская
историческ: исторических
нынешн: нынешний нынешнем
сельск: сельском
оста: остается оставшихся остался оставшись
заключен: заключенных
конституцион: конституционной конституционный
быстр: быстрый быстро
хозяйк: хозяйка
учредительн: учредительное
прояв: проявил
эксперт: эксперт
депутат: депутатов
принима: принимал принимать
разреш: разрешить
тир: тири
объединен: объединений объединенными объединение объединения
спектр: спектра
набра: набрали набрав набрать
тих: тихом тихий
намек: намекая
поправк: поправки
реч: речью
реш: решил решилась
отрасл: отраслей
бремен: бременем
накал: накалена
преждевремен: преждевременно
международн: международных международной
остав: оставил оставило
общ: общей
гражданск: гражданским
недостатк: недостатки
окончан: окончания
знаменит: знаменитый
защища: защищать
обитан: обитания
состо: состоит
высказыва: высказывает
недел: неделю
марин: марин
побыва: побывал
унизительн: унизительно унизительного
включ: включая
рен: рене
обо: обоих
культурн: культурного
подвиг: подвиг
сред: среда среди
польск: польская
безукоризнен: безукоризненность
социальн: социальные социального социальное
упрек: упрекая
урегулирован: урегулирования
мног: многие
люб: любые
зависим: зависимость
средиземноморск: средиземноморский
избежа: избежать
фон: фоне
останов: остановилось
содержа: содержали
индокита: индокитае
орден: орденом
критикова: критиковал
иезуитск: иезуитского
колонист: колонистов
взят: взять
европеизирова: европеизирован
трибунал: трибуналом
мировоззренческ: мировоззренческая
правд: правда
гот: готов
разр: разрыв
разн: разная разных
взял: взяли
избирательн: избирательную
алжир: алжире алжиру алжир алжира
апеллир: апеллируют
наград: наградами
люд: людям людей
отчет: отчеты
люк: люк
отвеча: отвечал
огн: огня
год: годами годом годы
пошлин: пошлин
использу: используя
подписан: подписание подписания
владен: владения
сдержива: сдерживать
дворянк: дворянки
ревиз: ревизии
министр: министра министр министры министров
интерв: интервью
преподава: преподавал
комитет: комитет комитету
создан: созданием
особ: особым особой
потеря: потеряла
вывод: выводу
прич: причем
вывоз: вывозились
расход: расходы
привод: приводит
знает: знает
волн: волны
одн: одному одним одном одна
мар: мари
приз: призыв
отчаст: отчасти
неприемлем: неприемлемо
президиум: президиума
дирижизм: дирижизмом
обращен: обращение обращениях
гаван: гавани
улиц: улицы
ведут: ведутся
выда: выдающийся
ведущ: ведущих
команд: командующим
вермахт: вермахта
апрел: апреля
баст: бастьен
адольф: адольфа
брюссел: брюсселя
врод: вроде
коломб: коломбе
участ: участие
завещан: завещанием
сблиз: сблизились
голосован: голосованием
войн: войной войны войн войне война войнах войну
смотрел: смотрели
сентябр: сентября
испытан: испытаний испытаниями испытания
март: марта
войт: войти
превосходств: превосходство
массов: массовой массовых
фредерик: фредерик
существова: существовали
вынес: вынес
послевоен: послевоенном послевоенные послевоенного послевоенное
глав: главы главе глава
сомнен: сомнения
глаз: глаза
сраз: сразу
сража: сражались сражающейся сражался сражающаяся сражаться
обвин: обвиняя
крест: крестом
холодн: холодная
подробн: подробно
голлизм: голлизм голлизма
излага: излагал
поход: походе
верденск: верденской
жела: желаемое
волнен: волнения волнениям волнений
новост: новости
корол: королем
вьетн: вьетнам
избран: избранием
существ: существуют существующие существует
перв: первой первую первые первым первом
повстанц: повстанцами
руин: руинах
непрост: непросто
достижен: достижение
командир: командиром
посел: поселился
юнош: юношей
близк: близки
бок: бок
приня: принять принялся
добр: добро добра
написа: написал
протаран: протаранить
выборщик: выборщиков
энергетик: энергетики энергетику
равн: равно равного
триумфальн: триумфальной
франц: франции франция францией францию
пресека: пресекали
основ: основе
франк: франка франков франко
отстава: отставала
повел: повел
покрыв: покрывая
ушел: ушел
шест: шести
обнаж: обнажил
отставк: отставку отставке
всеобщ: всеобщим
зван: звании
определ: определился
участник: участники
детств: детстве
препятств: препятствуют препятствием
голос: голосов голоса
герман: германия германии германией германию
премьер: премьеру премьера премьер
встреча: встречаться
переговор: переговорах переговорам переговоры
освобод: освободили
шарлотт: шарлотта
отыска: отыскать
сражен: сражениях сражении
прошл: прошлого прошлые прошли прошлое
род: родился
высок: высоко
примирен: примирения
оппонент: оппонентов
реальн: реального реальный
тяжел: тяжелой тяжелую тяжелыми тяжелый тяжелейшими
втор: второго
реконструкц: реконструкцию
рекордн: рекордный
рол: роль роли
дешев: дешевым
сфер: сферах сфере
форм: форме
мер: меры мер мере
парашютист: парашютистов
доцент: доцент
легитимн: легитимного
напрям: напрямую
улучшен: улучшению
лояльн: лояльное
марат: марата
закрича: закричавший
жертв: жертвой жертв
обрат: обратиться обратился
готов: готовиться готовы готовятся готовилась
максимальн: максимальной максимально
найт: найти
оздоровлен: оздоровление
влиян: влияние влиянием
парламент: парламент парламентом
учел: учел
независим: независимость независимой независимости независимостью
образ: образ
идеологическ: идеологических идеологический
тур: туре
конц: конце конца концу
учет: учетом
эмиграц: эмиграции
конт: конти
предлага: предлагал предлагает предлагали
геро: героя героем
соглас: согласились
случа: случаях
появ: появилась
проработа: проработало
успех: успехи успех
удал: удалился
шака: шакала
голлистск: голлистские голлистская голлистской
настоян: настоянию
петербург: петербурге
практическ: практически
удар: удар
доступ: доступ
вернут: вернуться вернуть
наряд: наряду
вернул: вернулся
парадигм: парадигмы парадигму парадигма
предел: предела
мид: мид
четверт: четвертой
конфликт: конфликта
франсу: франсуа
предк: предков
подчеркнут: подчеркнуть
бригад: бригады
алжирц: алжирцы алжирцев
мятежн: мятежные
послед: последующие
д: д
схем: схема
наканун: накануне
швейцарск: швейцарском
вообщ: вообще
меморандум: меморандум
наднациональн: наднациональности
преврат: превратились
танков: танковой
макрон: макрону макрона
свернут: свернуть
валер: валери
санкт: санкт
переизбира: переизбираться
дава: давал
х: х
показа: показала
отправ: отправить
нападк: нападки
вариант: вариант
кандидатур: кандидатуру
памят: памяти
мир: мир мире
агеев: агеева
штауффенберг: штауффенбергом
предприят: предприятий
писа: писал
однопартиец: однопартиец
кеннед: кеннеди
зят: зять
прекращен: прекращения
идеальн: идеальным
обсужда: обсуждался обсуждать
совершен: совершенно
воинск: воинские
безопасн: безопасности
этап: этап
подписыва: подписывали
чрезвычайн: чрезвычайные
нажм: нажмите
резк: резко резкой
феврал: февраля феврале
выслуша: выслушав
оон: оон
патриотизм: патриотизма
боев: боевых
власт: власти властям властью власть
получ: получила получили получил получивший получить
разрыв: разрыву разрыва
оглядк: оглядки
французск: французскую французской французские французских французское французском французская французского французский
публик: публике
флот: флот
фронт: фронте фронта
важн: важной важными важно
провел: провело провел провели
замысл: замыслу
город: города
национальн: национальное национального национальным национальному национальном национально национальной
экономическ: экономическую экономическим экономического экономических экономические экономическом
декабр: декабря
рук: руки
час: час
столкнул: столкнулась
сосредоточ: сосредоточена
правлен: правления
внутр: внутри
отец: отец
компенсац: компенсацию
млн: млн
подлин: подлинного
прям: прямые
интриг: интриги интриг
позиц: позиций позиции
марша: маршала
покинул: покинули покинул
могл: могли
дивиз: дивизии дивизий
движен: движений движение движения
переворот: переворота перевороту
подписа: подписать подписана
орд: орден
черчилл: черчилль черчиллю
больш: большой большая большое
прокатыва: прокатывались
германск: германской
мест: место места
иде: идея
похорон: похоронили
порядок: порядок
счет: счет
спрашива: спрашивали
карьер: карьере карьеру
сорва: сорвать
ждал: ждала
пересмотр: пересмотра
лозунг: лозунгом
феминизм: феминизма
генерал: генералом генералу генералы
видет: видеть
англ: англией
исчерпа: исчерпала
смогл: смогли
мягк: мягкой
представительств: представительства
редакциярекламаконтактыпресс: редакциярекламаконтактыпресс
заговорщик: заговорщики
видел: видел
департамент: департамента
виден: видению
окружен: окружения
жизн: жизни
жан: жанны жан
импер: империей
идт: идти
солдат: солдат солдата
населен: населения
формальн: формальные
покушен: покушений покушение
сформирова: сформировал
шарл: шарля шарль шарлю
провал: провалились провалилась провалился
расцен: расценить
отм: отмены
вопрек: вопреки
момент: моменту момент
обсужден: обсуждение
формулировк: формулировке
авторитет: авторитет
пошл: пошла
мор: море
развива: развивающейся развивали
изредк: изредка
основн: основном основной
лестниц: лестнице
управленческ: управленческий
сможет: сможет
сторонник: сторонниками сторонники
развернул: развернула
психологическ: психологического
тыл: тылу
решен: решение
владельц: владельцам
передава: передавать
ультраправ: ультраправые ультраправых
создател: создателя
милитаризац: милитаризации
провод: проводил
личн: личная
взлетел: взлетел
советск: советским советская советском советско
меня: менялись
командова: командовал
нужд: нужды
позиционирова: позиционировал
верховн: верховного
востребова: востребован
результат: результате
умира: умирать
чрезмерн: чрезмерной
дал: дал
предложен: предложениями предложения предложением
рузвельт: рузвельт
сравнива: сравнивал
мечта: мечтающим
увер: уверен
ирон: иронии
рассчитыв: рассчитывая
сопротивлен: сопротивление сопротивления
эст: эстен
выросл: выросла
сменя: сменяли
жорж: жорж
выплачива: выплачивали
преддвер: преддверии
референдум: референдум референдума референдуме референдуму
жен: женой
агитац: агитацией
перебрасыва: перебрасывались
непосильн: непосильные непосильным
был: былых былые
жискар: жискар
весьм: весьма
дат: дать датой
установ: установилась
разделя: разделяли разделял
войск: войска
состоя: состоял состоящая состояла
гитлеровск: гитлеровской
сужден: суждениями
девальвац: девальвации
суров: суровых
народн: народного
ветеран: ветеранов
дефицит: дефицитом
освобожден: освобожденной освобождения
коп: копилось
нежелательн: нежелательна
подпоручик: подпоручик
установок: установок
пожалова: пожаловать
возвед: возведя
соединен: соединения соединений
устранен: устранения
отказа: отказался отказаться
старт: старт
предлож: предложил
старш: старший
невест: невестой
дипломат: дипломат дипломатия
спасен: спасение спасению
галер: галереи
оцен: оценило
рядов: рядовые
норманд: нормандии
сохран: сохранить
политик: политики политика политику политиков политикам политике
восток: востока
вмест: вместо вместе
окончательн: окончательный окончательно
уход: уход уходе ухода
финансов: финансовой
полиц: полиция
чин: чине
смир: смирились смирившегося
ошибк: ошибки
увидел: увидели
реформирова: реформировать
жив: жив
характерн: характерно
вторжен: вторжение
правительств: правительству правительства правительство правительством правительстве
аристократизм: аристократизма
оппозиционер: оппозиционеры
настроен: настроенному
жил: жилья
свершен: свершениями
стара: старается старался
возвращен: возвращении
заня: занять занял заняла
писател: писатель
поколен: поколение
руководств: руководстве
потомк: потомки потомков
высш: высшими
офицер: офицер офицеры офицеру офицеров
пост: посту пост
армейск: армейской
приют: приютил
солидарн: солидарна
дев: дева
произошл: произошло
таинствен: таинственности
итог: итогам итоге
вспомина: вспоминает вспоминал
дез: дез
масштабн: масштабную
вошл: вошли
стольк: столько
возобнов: возобновились
дел: делились делам
разгорел: разгорелась
вопрос: вопрос вопросы вопросу вопросах
ближайш: ближайших
европейц: европейцам
стремительн: стремительно
сохраня: сохраняются сохранялась сохраняли
блестящ: блестяще
тяжк: тяжким
эрик: эрик
внутрен: внутренней
устройств: устройстве
заверш: завершить завершившейся завершил
вскор: вскоре
пришел: пришел
заседа: заседает
макмилла: макмиллан
мемуар: мемуары мемуарами
губернатор: губернатором
обществ: обществе общество
москв: москвы москве
порт: порт
полност: полностью
семейн: семейной
несмотр: несмотря
срок: сроки срок
собствен: собственности собственного
деноминац: деноминацию
измен: изменилось
единств: единства
держа: держав держаться
британск: британскому британское британский британского
уда: удалось
территор: территориям территории территория
дет: детей
август: августа
жокс: жокс
подчиня: подчиняться подчинялась подчинялись
каземат: казематах
немаловажн: немаловажно
восстановлен: восстановления
станк: станки
кладбищ: кладбище
восточн: восточном
отношен: отношениях отношение отношений
компетентн: компетентному
иска: искал
обогна: обогнали
дефолт: дефолт
рома: роман
кита: китай
победительниц: победительницы
престижн: престижную
собран: собрание собранием
последн: последним последней последний
парижск: парижских
месяц: месяцы
досрочн: досрочно
приказа: приказал
сам: самую самый самое самые самых
могил: могиле
набира: набирать
альянс: альянсе альянса
захотел: захотелось
жми: жми
недовольств: недовольство
возвраща: возвращавшиеся
инач: иначе
вырос: вырос
расстреля: расстрелять расстрелянным
организова: организовали организовавшим организовал
преувеличен: преувеличения
бо: бои
подобн: подобно
называ: называл
эвиан: эвиане
давлен: давлению
наслед: наследуют наследие
характер: характера
переходн: переходное
неожида: неожиданного
принят: приняты
нашл: нашли
женщин: женщины
складыва: складывалась
достигл: достигла
смысл: смысл
недолг: недолго недолгий
век: века
вел: вел
ист: истым
очередн: очередные
вер: вера
западн: западная западную
популярн: популярны популярность
декларац: декларация
сотрудничеств: сотрудничестве сотрудничества сотрудничество
област: областей
алжирск: алжирского алжирским алжирскому алжирская
научн: научного
форсайт: форсайт
достига: достигались
сво: своя своему свой
кампан: кампании кампанию кампания
нача: начало начал начали начался
эммануэл: эммануэля
горд: гордым
забыва: забывал
академ: академию
перспектив: перспективой
станов: становилась
лежа: лежала лежали
уголок: уголок
оруж: оружие оружием
легион: легиона
истин: истинный
парт: партий партии партия
тесн: тесном
явля: является являются
вслед: вслед
нужда: нуждался
ореол: ореол
свод: сводился
плен: плен плена пленных
удава: удавалось
выступлен: выступлениями выступлений
канцлер: канцлер
теря: терять
развит: развитию развитие
де: де
консультац: консультаций
настаива: настаивал
интенсивн: интенсивнее
представ: представится
шампан: шампани
анализир: анализирует
зажег: зажег
нанес: нанес
станут: станут
контрол: контроль
колледж: колледжа
оборудован: оборудование
продолж: продолжил продолжить
соотечественник: соотечественниках
предсто: предстоят
факультет: факультета
задач: задачи задачей
информагентств: информагентства
придержива: придерживалась придерживались
трех: трех
различн: различные
трет: третьим
утвержд: утвержден
пал: пал
трем: тремя
ценност: ценности
подразделен: подразделения
перем: перемен
перейт: перейти
предста: предстали
истор: историю историй истории
зовут: зовут
филипп: филиппа филипп
парламентск: парламентских
довер: доверие доверилась
ес: ес
двум: двумя
цифр: цифры
прова: провал
пробл: проблем
трехсторон: трехсторонняя
аденауэр: аденауэру аденауэр
факт: факт
насущн: насущной
наброск: наброски
помпид: помпиду
закрыва: закрывать
мятежник: мятежниками
сем: семье семьей
сен: сен
произошел: произошел
представител: представителем представители представителями
вид: видит виде
односторон: одностороннее
метропол: метрополией
обслужива: обслуживающей
боеспособн: боеспособные
консерватизм: консерватизма
умер: умер
бескровн: бескровно
навсегд: навсегда
внов: вновь
доход: доходы
красн: красный
ноябр: ноябре
вплот: вплоть
одобрен: одобрения
воспринят: воспринято восприняты
договор: договора
наук: наука
стрем: стремился
путч: путч
влия: влиять
лидерск: лидерские
раздор: раздор
отзыва: отзывались
дне: дней
эпох: эпоха
отчитыва: отчитывался
поддержа: поддержали поддержал поддержало
компарт: компартия
известн: известный известное
полковник: полковником полковника
антиамериканизм: антиамериканизма антиамериканизм
сторон: стороне стороны
постав: поставил
взам: взамен
указыва: указывал
интеграцион: интеграционные интеграционных
поддержк: поддержке поддержку
предостав: предоставить
доминикан: доминикане
остальн: остальные
призна: признать признал признала
голл: голле голлей голлю голль голля
глубок: глубокими
доб: добиться
хорош: хорошие
колон: колониях колонию колонии
пуст: пусть
ид: идеи идей идее
опира: опирается
нац: нацию нации
оборот: обороты
ин: иные
оборон: обороны оборонных оборона
республик: республики
темп: темпы
фундамент: фундаментом
успешн: успешно успешнее успешными
франклин: франклин
обретен: обретения
большинств: большинство
сил: силы сил силами
заказ: заказов
обяза: обязался
план: планы плану планов плана план
доллар: доллары доллара
сир: сир
арестова: арестованы
регулярн: регулярно
элит: элиты
сокамерник: сокамерникам
держав: державы державой держава державе
нат: нато
гроз: грозил
составля: составлял составляло составляли
обгон: обгоняя
информац: информация
выгодн: выгоднее
призыв: призывая
рьян: рьяно
негативн: негативно
невозмож: невозможен
ключев: ключевые ключевых
замет: заметивший
хозяйств: хозяйства
черновдоцент: черновдоцент
философ: философию
мадагаскар: мадагаскар
спуст: спустя
пен: пен
английск: английский
шпаг: шпагу
объяв: объявил объявили
пет: петена петен
требова: требовал
теоретик: теоретик теоретика
объедин: объединило
кортеж: кортеж
лейтенант: лейтенанта
отвергнут: отвергнуты
пехотн: пехотный
размещен: размещением
соперник: соперником
черн: чернов черных
квартал: кварталы
младш: младшего
граждан: граждане гражданами
катастроф: катастрофе
спас: спас
дуайт: дуайту
идет: идет
гитлер: гитлер гитлера
например: например
разрушительн: разрушительных
вынашива: вынашивал
отправля: отправлял
воспитыва: воспитывали
ле: ле
вне: вне
эмиссар: эмиссары
коллег: коллегией
миров: мировых мировой мировую
забот: забота
запуст: запустить запустились запустило
отстаива: отстаивал
акт: акта
лу: луи
соответств: соответствии
президент: президент президенту президентом президента
сми: сми
чест: честь
огромн: огромная
ма: май мая
ответствен: ответственность ответственные
архитектор: архитектор
союз: союз союзом союзе
консервативн: консервативной консервативного
стран: странами страны стране страной страна странам страну стран
миттера: миттеран
январ: января
отлич: отличие
уровн: уровнях уровня уровней
свет: света
побед: победу победы победил победе
неприязн: неприязнь
четк: четко
дух: духе духом
местн: местных местные
коалиц: коалиции
сист: систему
свел: свела
укреплен: укрепления укреплению укрепление
сне: сне
душ: душе
углублен: углубления
сидел: сидел
качеств: качества качестве
выбор: выборах выборы
мандат: мандат
наследник: наследники наследниками
государств: государства государстве государство
избира: избирался
ни: ниу
высадк: высадку высадки
свойствен: свойственна
эглиз: эглиз
проблем: проблемы проблемой
националистическ: националистическим
толчок: толчок
опытн: опытный опытные
западноевропейск: западноевропейских
раздел: разделились
заяв: заявил заявили
дожида: дожидаться
намн: намного
коммунистическ: коммунистический
авиацион: авиационных
выигрыва: выигрываются
воврем: вовремя
лучш: лучшей
формат: форматом
дума: думаю
операц: операцию операции
самоопределен: самоопределение
крайн: крайне
оо: ооо
оп: опыт
возможн: возможность
дальн: дальнейшем дальних
анр: анри
корд: корде
политолог: политолог политологии
молод: молодой
американск: американский американскому американской американских американские
огон: огонь
брос: бросил
открыт: открытия
выбра: выбрал
буквальн: буквально
увелич: увеличили
направ: направил
маневрен: маневренной
твердост: твердость
сердц: сердцах сердце
крупн: крупнейших крупный крупнейшим
все: всей
сокруш: сокрушил
пораз: поразившим
меша: мешал
прозва: прозвали
взгляд: взглядов взгляды
прежд: прежде
поведен: поведения
бывш: бывший бывшим
чернов: черновым
выступа: выступала выступали выступал
ребенк: ребенком
ник: никому
радикальн: радикальные радикально
уинстон: уинстон
спасител: спасителя
пада: падать
гегемон: гегемонии
откр: открывшая
июн: июне июня
революц: революцию революции
наход: находилось находится находились находился
терза: терзали
потер: потерей потерями
болтовн: болтовню
xx: xx
ctrl: ctrl
enter: enter
