случ: скорого
пенс: пенсию
комар: комары
фактическ: фактически
репарац: репарации
экспорт: произведенные
обычн: обычную
оказа: оказалось оказался
банд: причисленного прицелом группировки
мнен: мнений мнению
поддерж: полагал
последств: последствиями исправление
повторя: случае
капитализм: сторонников китайцы
показыва: твердо
арх: архив
интеллигент: интеллигента
реабилитац: политической
экономик: экономику экономика экономики плановой экономик
впечатлен: впечатление
интеллигенц: интеллигенции
сто: сто
партийн: партийной высокопоставленные следствие партийном проблемах высокопоставленным партийных
размеща: сидань
слома: починку
финанс: финансов
заполня: заполнялись
провоцирован: реакционные
арм: армии подавлен армию
ста: основной
должн: делом простым
льготн: действует льготную
кирпич: стены
крепк: оставил
перспект: карьерных
отсеиван: проводились
сул: возвращение
сум: сцены
жестк: жесткой
благодар: благодаря
назван: получившая
денег: денег
сянган: вопросу
реализовыва: разрабатывались пекину
обратн: обратно
компромиссн: эпохи смерти
проект: бизнесменов подобных проекта
связ: коррупцией
совместн: подписали совместно
появля: реже городских
вперв: науки
отмен: выступали началом
тревожн: конец
цзаофан: хунвейбинов студенты
сут: сути
буржуазн: социалистической
опал: попал
шрми: ви
произведен: налога
полага: поддержку
госпредприят: некоторые
многодневн: многотысячная
устраива: устраивались
центральн: центрального центральный
беремен: беременные
обознача: принято
врем: звучали опасно
заработн: заработных
военачальник: государственным
заработк: заработки
изготавлива: изготавливать
схлестнул: спиной
следова: следовало
разгром: неопровержимым
справедлив: справедливости
родин: родины родину
полномоч: прочие
очевидн: преодолеть
уровен: улучшать
нов: реформаторов предлагая нового деятелем открывались новый принята приспособиться новую новой сходить
освободительн: освободительной
упорядочен: работали
почувствова: убыточных
отражен: нашел
част: часть становились
заступ: эньлай
бунтар: юные
слож: сложилась поста
неурож: неурожая
слов: радио одежды
пятилетн: пятилетний
постоя: постоянные назначения члена
системн: последовательным
сдела: сделаны вождь приватизацию
определен: консерваторов
деактивирова: нажмите
судьб: изменили
зажиточн: зажиточного
кооператив: кооперативах кооперативы
фигур: компромиссной
совет: постоянного
нос: изначально
вперед: шаг
пример: брать пекина
дэн: дэн статусу видевшая дэна
расположен: расположение
локомотив: реставрацией
систем: университетской закреплялась
выход: видел объявлялось выходили
государствен: частью индексировались государственный человека революционером
летн: летнему зуенконаучный
оккупац: оккупацией
маргарет: великобритании
трудн: трудно
курс: курсом курс корректировку
сша: сша
лидер: лидер лидера лидером лидеры лидеров китайскому
аппарат: аппарат
съезд: хх состоялся
трагед: трагедией
групп: исходящую
истреб: истребили
техник: техника
неудач: авторитет
требован: собрались спровоцировали требований перешли крупных
постепен: воли стажировку избавится
культур: культура культуры культур
мелкобуржуазн: мелкобуржуазную
каннибализм: каннибализму
провозглаш: море провозглашена
материк: проекты
провозглас: котором
напряжен: социальное
враг: классовых
крестьянск: колхозов
удруча: удручающей
агресс: агрессией
промышлен: промышленное промышленности
трудодн: трудодни трудоднями
жител: миллиона жителям
укреп: укрепить
задел: слова
коммун: коммуне коммуны коммуна коммун
картер: джимми
усилив: международные
тверд: стойте твердый
сын: пекине радиоприемники сыну
капиталистическ: идущим существует капиталистические сторонникам
опасен: опала
ожив: оживить
инвестиц: притока иностранные
средств: средства
сельскохозяйствен: сельскохозяйственный выходцев сельскохозяйственными
потребова: ветераны
отключ: комментарии
борьб: ставку борьбы борьбу борьба
коммунист: коммунисты коммунистов
связыва: экономической
беспрецедентн: накопленные
извоз: дохода
крестья: крестьян
цех: начальник
вашингтон: картером
гигант: гиганта гигант
счита: которую считался крыла капитализме
отсутств: стабильных
поднебесн: подъема
стимулирова: стимулировали
возмущен: возмущенных вызвать
бизнесмен: тайваньских
цел: целью
цен: рыночным снизил экономикой двойных
субаренд: разрешалась
лент: лента ленту
изуча: странам
сообща: цзэдуне устремилась
мирн: носила
откликнул: радостью
столп: обозначил
закрепля: конституции
идущ: лицом
создава: создавались привлекать
сэз: зоны
кабальн: кабальные
администрац: администрацию
иностра: иностранных иностранной требовались международную
поездк: поездка поездку номенклатуре отправляет
серьезн: серьезно ссылка
кафедр: профессора
растущ: больших момент легкой
останк: медицинских
примерн: примерно
професс: профессии
карьерн: сулило
ткан: тканей
слеп: прекращалось
мастерск: красоты
ремонт: мастерских
отраз: отразились
принесен: жертв
след: следующем дальнейших
прошедш: занавеса
институт: восточного
организац: симпатий
конституц: внесли новая сроками
статус: ударом
стойт: реагировать
убит: столкновений
капиталист: капиталисты
зелен: дал
против: критиковал
цин: цзян
так: внутренние таких
картин: картину
соратник: давний участии волей
событ: событий событиями обозначать
течен: течение
храм: монастыри
усилен: усилением
изнасилован: изнасилования
приспособ: сумев
символ: национальный высказанные
собира: витку
турн: мировое
хладнокровн: наблюдайте
оккупант: оккупантами
некотор: например
извлека: государственных
выработа: процветания
аграрн: аграрный аграрной
полев: полевых
твор: творили
древн: храмы
диалог: восстанавливался требуя
попа: репрессировано
остава: лагерь умирающий инструментом
спорт: спорт
взыскан: взысканиям
солнц: места
бедност: бедности
консенсус: плана склонным
услов: условиях условий новым управления
натур: натуре
приоткрыт: осложнялось
престиж: ударит
крах: краху краха
приход: приходилось запущены приходили
восстанов: восстановившие
аппаратн: легко увеличив потоке увеличение
воображен: поражало
железн: приоткрытием
рассказыва: рассказывает
программ: программу
нанкинск: нанкинская сближение
голодн: голодную
главн: главную главным главное дипломатом лишились
сменяем: условия
лавирова: опытный
страда: нравственность
неразрывн: прогресс
внешнеэкономическ: зависимым
октябр: октябре
неправильн: неправильных
элемент: элементами контрреволюционным
втянут: втянутый
бедн: бедный
облик: облик
созда: создав создано ценам афоризмы постоянный наспех своими витрин создать
отдельн: информацию отдельно
хлопк: хлопка
домн: домнах
завяза: завязал
тем: съезд
применя: успешны
пришл: пришлась пришлось
полн: предоставили
подавл: утром
питан: питание
бел: белая
десят: достигли
реформ: реформу подтолкнули образовательная реформах реформ реформы реформой
привлека: призванные иностранный
коррупц: инфляцию ускорения кумовство
рамк: выходило рамках
побужда: активно
запрет: запрета дэну
репресс: репрессий репрессиями
долж: равных
исключительн: связывать
услуг: предприятия
десятилет: пошлин
пленум: прошел третьего
высказа: аргументы
числ: сотен число
гражда: граждан
автоматизац: коллег
период: периода период
чист: считались
модел: модель
свергнут: пленума
вторгш: вторгшимися
вниман: арбитром вниманию
сяопин: сяопином сяопина сяопин сяопину
исправля: исправляет исправлять
пойт: дружбе
посредств: отбор
возврат: символом
очеред: первую
опор: решением
виде: видео
превраща: старыми класс
ликвидац: постепенная
положен: реальном
джимм: президентом
попада: кадры
звуча: стороне
процветан: голода
симпат: симпатии недостаточных
контрреволюцион: угрозу
назнача: назначает
бизнес: частный малого
принима: сверху принимает телеканалам
долговремен: воплотить
предмет: различные
взлет: регулирующие
осложня: крайне
объединен: объединений
набра: рака
поправк: конституцию
общ: общей функционирования
остав: уйдя
объ: место общий
гражданск: гражданских гражданская гражданского гражданской
окончан: перспектив
прокат: маоизма
унижен: унижениям унижений
обитан: обитания
довест: способны
недел: недель приспущены
набор: базового
беспартийн: беспартийной
поддержива: перевоспитанию свободах
включ: включился
переросл: расширение
противопостав: элит
культурн: оппозицию значительную культурной цзаофаней
азиатск: азиатской ближайших
материальн: увлечения
удобн: любом
сред: усложняющейся напряжение среда среди
социальн: экономические социальной отсутствия коррупцию социальная
мног: многом капиталистического недоступны многим
разнообразн: достаточно
ядр: разнообразны
утвар: утварью
избежа: стремился
останов: убийств
заместител: получил своим
критикова: критиковали важность символ
взят: запретили
коллективизац: коллективизации
инициативн: инициативные
разн: разным встречался
взял: взяли мест
фермер: фермерам
налогообложен: режим
напуга: полномочия
взяв: взяв
разб: протестующие
выявлен: продолжении
производител: крупнейший
пошлин: экспорт
упорядоч: остальных
критер: фактах
бездейств: бездействием
физическ: физическому
комитет: комитета комитет
потеря: потерял
принадлежа: фигурой
разреша: аренду
производств: производство производства производством
главенств: пролетариата
маоизм: идеологии
одн: одну одним воду
широк: вмешиваться широкую широкая
согласн: колебаний лестница
столиц: заместителем столице
масс: широкие
устрем: журналисты
наработк: ценные
склон: состоит
огранич: конституция определенного
предупрежда: чиновниками
участ: назначенные похороны
либеральн: деятели
десятк: десятки ю
разбогатевш: существенно
регион: создавать
поскольк: поскольку
ревизионист: партию
кресл: инвалидном
горазд: самое
сентябр: сентябре месяцев
кормч: кормчего кормчий
догм: идеологическим
март: марта
массов: влияния массовой первая массовые
еха: ехали
недоступн: представлять
усложня: поспевает
глав: главы ставшая
столов: столовых столовой
обвин: личности беспорядков
убийств: убийства волна
печата: статей
болезн: инфекции
половин: чудом
университет: пекинского
новост: новости
существ: обвинил демократию
инициир: цзяньина
перв: личностью занимает террора предметы протесты первые генсек оголтелая
непрост: непростое
возрастн: создана
номенклатур: консервативной
юнош: юношу
близк: занимали
бол: моменту
добр: деактивирована добра
изменен: масштабных изменения постепенным
осужден: посмертного осужденных
инвентар: инвентарь
преодолет: необходимостью
равн: первым
основ: основой заложил
неопровержим: предводительством
птиц: птиц
отставк: отставки отправлен
опер: театре
занавес: железного
образовательн: прошедшая
участник: характер
как: ста
поначал: свергнут
кпсс: съезде
премьер: премьером умершем премьер должность
произнес: произнес
повлия: массы
преодолен: реформам
кардина: кардинал
встреча: поездке
сражен: сражений
критик: критика критике героем
реальн: сообщать пожаловать
тяжел: тяжелого тяжелейшего тяжелых тяжелая
обязательств: дало
точк: точкой индонезии
сфер: сфера технической
способ: способен способ
продукц: излишки
продукт: продукты набора
доказа: ресурсами
учеб: учебу окончании
жертв: жертвами обесценят
найт: найти
преобразован: преобразования возврата преобразований
третирова: третировали
влиян: разрушительного
окн: выбросили
советник: ролью
соглас: руководителями
прагматик: сталина главе крыло
появ: появились
призва: революцию повторился опережающего
успех: абитуриентов
вернут: вернуться обязательство
наряд: наряду
возглав: возглавил
вернул: вернули другим
планов: лучшее плановые
сидан: улице
четверт: жителей
охвачен: остались
отвлека: отвлекаться
пролетариат: диктатуры
преврат: превратил
личност: исключительно культ
ожида: возможности
хрущ: председателю
гвард: старой
х: недолго
показа: показать
поэт: поэтому
отправ: открылся отправиться постов сняли
ю: куан
памят: развенчивать
продава: магазины
идеальн: сохранить
безопасн: намного
орга: завещанию
непра: прав
нажм: опечатку
резн: нанкинской резня
коллективн: система опора
гоминьда: гоминьдана
формирова: бунтари
нелояльн: нелояльными
выраз: участники
власт: власти негласная подобно диалога
приобрел: приобрел
французск: французских
объявлен: объявления
перевод: переводит
важн: важнейшую важнейших неправ
выкорчева: выкорчевать
город: городов города государств
побочн: побочным
аргумент: захлебнулись аргументом
газет: сообщали шанхайской
чан: чан
национальн: взамен национальной многих
вдол: сэз
внутр: организовало
сектор: сектор
прибрежн: десятилетия
больн: больные
шанх: конце
интриг: аппаратных
могл: могло труженики
движен: движение
отстал: очевидную десятка
опа: несправедливая
подписа: официально
специфик: социализме
больш: большие харизмой взрывом большую большой большого
китайск: успехи китайский китайская законным китайских китайские жить китайской китайского
освобожда: компании
мест: положении безработицы первое гвардии
похорон: общенациональные
инфекц: легочной
карьер: карьере
шаоц: шаоци
аналогичн: аналогичными
лозунг: лозунгом
перевоспитан: трудовое отсеивания
фупин: хуан
запреща: арестовывать запрещалась
видет: видеть
редакциярекламаконтактыпресс: отключены
страшн: страшных
исправлен: успешное
видел: кадрах видели
политбюр: политбюро
организаторск: организаторским
жизн: познакомила жизни жизней
кит: китая
самодельн: самодельных
игнорирова: поначалу
опережа: особые
населен: населения город
тайваньск: гонконгских
пыта: изгнании момента
перестройк: перестройки
ожесточен: шла
пошл: кирпичи
развива: развивать стремительно
митинг: митинги миллионный незаконного разгоне
идейн: догмам
сторонник: скрытых окружил бандой
авторитетн: самым
витк: новому
приватизац: провели
советск: советского
удачн: предложениям
чиновник: разными высокопоставленных
меня: критиковать
гостиниц: рестораны
экзамен: конкурсных
умира: декабре
банковск: коммерциализировали
опыт: японского
рынок: всеядный
последовательн: перейти
увер: уверен
ссылк: ссылку цзянси увиденные
реакцион: подниматься квалифицированы
миллиардн: рынок
транспортн: транспортные
жел: желая
кнр: кнр
расследован: коррупционные
жен: последней написанные
чжа: соратники
разделя: кумиру решения
войск: войска
чжо: чжоу
народн: народной народно либерализацией доме народное народная
сократ: сократили
мелк: извозом мелких
дефицит: компенсации
угрожа: реакционная
пожалова: добро
соединен: соединенные
сумел: сумел
перевес: коммунистического
отказа: отказались категорически
обнул: транспорт
построен: построения следующего
очк: очки
кпк: кпк
изоляц: изоляции
старш: старший стран
дипломат: дипломата военачальником
возника: гостиницы
возраст: достижении февраля друга
спасен: спасении
галер: галереи
рядов: дешевке
незакон: организации
следован: слепое
сохран: сохранит социальные вопроса
политик: политики политик опытным политика политикой политику политике
арестовыва: преподаватели
окончательн: окончательно
жиба: цзефан
ошибк: обвинения ошибки
тупик: заведет
вторжен: вторжения
гонконгск: побуждал
увиден: нищета
преступлен: ошибках
модернизацион: первых
оппозиционер: оппозиционеров
паден: падению
разработа: разработанный
жил: жили
продолжен: настаивали необходимым требованиями
возвращен: рубежом июля возвращении
сталин: культа хрущев
пост: государственном ушел авторитетным пост снял
важност: резни указывал
итог: итоге наследия
масштабн: масштабные профессор
лидерств: коллективного
интеллектуал: интеллектуалов
колхоз: ликвидация
объявля: объявлялись ядом
афоризм: заучивают
стремительн: продолжает судьбы бизнес
жит: понимали
внутрен: районы внутреннюю борьбе
вскор: вскоре
размер: размер размеры
послаблен: послабления
требу: голодовку
проход: ниоткуда
ответ: ответом
обществ: среднезажиточного
несмотр: несмотря
творческ: творческие
срок: двумя
идеал: предать
следств: ставший поддерживал
красот: салонов
японск: японские важности японскими японском японской
территор: территории внешних
избра: избран
уда: дипломатическое
милитарист: милитаристы
абитуриент: общенациональных
видевш: силу
смел: свет самые
обучен: нуждалась
аз: азии
кита: китаю китае китаем китай
реабилитирова: тюрьмы реабилитировали
тракторн: перевоспитание
куа: сингапур
месяц: оставались продлилось
жми: жми
японц: японцы японцев
вырос: поток
организова: организовали организовав федерации
оголтел: понимал
оказыва: зачастую оказывал
подручн: подручные
абсолютн: нужды
насеком: насекомые
снес: литература
характер: мирный
нашл: экспериментам
развенчива: отказался
парикмахерск: услуг
среднезажиточн: построение
достигл: прямые
ви: исследований
недолг: осталось
век: веке половины золотым
вес: аппаратный аппаратного политическим
популярн: отставку пользовавшейся популярности
декларац: совместную
манифестац: манифестации серия
ускор: желание
усугуб: усугубило
простор: российских
цвет: цветов
инвалидн: университета
кампан: массовых кампанию официальной кампания
нача: начались штаба начал начали
доброт: доброты
реша: летний
забыва: государственной
го: го
значительн: уничтожили значительно
оруд: орудия
хунвейбин: локомотивом духа
хлопок: хлопок
плеч: плечи
буржуаз: буржуазии
вслед: вслед
юност: юность
вещ: менять
неудивительн: прошлое
заруч: южные
сведен: бесконечному
журнал: журналы
заводск: заводских
переж: пережил
двфу: федерального
пролетарск: марксистом
рыбн: рыбных
негласн: разгоралась
консерватор: превращаемся соцблока
контрол: политический прессой контроля
нищет: нищеты печерицы
уйд: конца
придержива: противился
окруж: вернулись
задан: задания
трет: захочет
ликвидирова: ликвидирована
пал: выбор
перем: перемен
базов: пределами
треб: многолетняя
проник: проникся
поистин: духом
вис: портреты
пуфа: сына
двум: посту
вождизм: защитив
факт: истину
диктатур: вещей
преемник: смертью
противодейств: находилось
гибк: гибкую
скудн: скудное
вид: объему
захлебнул: казалось
обменива: обменивались
сборник: книги
защит: сменяемости
внов: вновь
красн: красный литературу
чуд: выглядят
коллективизирова: снизу
виц: столицу
сингапур: диаспор пал
неслуча: территорий
договор: договоры японией
воспринят: популярностью
неэффективн: подтверждением
повтор: единоличной
наук: обороны наука наук
прогресс: прогресса считали
эпох: тревожной эпоху эпоха эпохой
крыс: крысы
компарт: компартии компартия
сторон: стороны британская материальной противоборствующих перевес
крыл: либерального ожесточенная
поток: бурном деньгами
указыва: поворота
импульс: импульс
призна: признает
тысяч: рублей
сгоня: сгоняли
родственник: близкие
принцип: отличалась упорядочены
предусматрива: предусматривал
пуст: пусть
колон: британскую
ид: идеи роли
безработиц: проблему
обвинен: престижу
республик: молодые республики республика
оборон: долговременную
сыгра: сыграли сыграл
антияпонск: антияпонское антияпонских
плат: платить плат платили
высокопоставлен: поддерживали будучи дополнение
революционер: пролетарским века
эксплуатирова: эксплуатировали
обяза: обязали
затрат: предложение
план: план планом никакого
разрабатыва: народа
молодежн: растущая
образова: столпы
публичн: публичной арест
товарищ: товарища
элит: элиты
разва: развал
гроз: грозили грозившая
плав: плавить
выброс: избили
апеллирова: весом
группировк: схлестнулись
сход: либо учитывая
ключев: вторых
замет: заметил
распоряд: распорядился
олицетворен: олицетворением
противостоя: порождали
самоокупа: самоокупаемых
двор: созданные
объяв: объявила объявил сотни
дополнен: вес
трудност: столкнулась
трав: траву
террор: пострадавшей
ко: ко коими
черн: черная
перераст: провинциях
классов: классовое выявлении
собра: месяца
закрыт: пострадавшие
граждан: граждане
книжн: закрывались
порожда: противоречия
предстоя: предстояло
разрушительн: ограждали
самостоятельн: самостоятельно
увеличен: последствий
либерализац: началась мириться опробовать
секретар: генеральный секретарем июня
попрос: заступился
президент: американским
масштаб: общегосударственного
лю: лю
ма: мао середине
крестьянств: товаров
ответствен: ответственности
доктор: словам
познаком: реформа
вод: импортировали
консервативн: реформаторским позицию консервативные противостояло противопоставить
вол: социальных созданный
пищ: пищи
побед: победы
местн: поддержкой услышав
сист: подчинять
чистк: чистки
накоплен: обстановки
участв: участвует
пис: писем
участк: участки
исходя: опасность
обесцен: неэффективности
государств: европейских государство передовых китайским
взявш: взявшись
неповиновен: акцию
свойствен: свойственно
проблем: существующих
гофэн: компромиссный хуа
опытн: функционером плюрализма
ужас: сотрудник
намн: стало
коммунистическ: отход консерваторы коммунистической коммунистический
экологическ: экологической
приусадебн: приусадебные
сверхпланов: забирать
лучш: взял лучшему
владимир: двфу наработки
механизм: механизмов
операц: операций
борол: отстоять боролись
талантлив: талантливый
крайн: баланс
оо: информация
возможн: возможность показывайте
оп: опыт
университетск: воссоздание
политолог: кафедры
молод: молодым цзаофани учебы
американск: встретился
открыт: образом открытости открыто миллиардной
увелич: увеличилось сторонниками
буквальн: растущие
шанхайск: печатает
демонстрац: митинг стихийная
утр: властями
расплод: расплодились
все: всей
китайц: китайцев запрещалось
взгляд: взглядов взглядах взгляды
присоединен: присоединения
убыточн: закрытия
трест: тресты
бывш: бывшего бывший
бытов: экспортер
мечт: мечты
стабильн: требует
изначальн: яобана
выступа: имени ускорить популярность
уничтож: свинарников
критикуем: числе
улучша: придерживаться
революц: революция революции охваченном культурную
наход: любые находились задели
оскорблен: воспринята оскорбления
термин: культурная
вто: торговой
опробова: эксперименты
забежа: пытайтесь
ру: ру
оценк: оценкам
революцион: носителем кремированы достаточным революционные
впоследств: впоследствии
понима: публике прагматиком
лев: опасности
металл: металл
стат: пишет статьи статьями
расправля: расправляет
воен: военного военные военных военно
европейск: европейское европейскими автоматизация
стар: возмущения становимся советников старые
рабоч: дешевая рабочих рабочие рабочей рабочим затраты
федеральн: дальневосточного
стал: новом сталь стала стали
чья: партийный
категорическ: практика
став: став
работ: работа работе работу работы работ
реагирова: готовы
будьт: хладнокровно
концентрац: чрезмерной
пок: системным
пол: полях полей
торговл: торговлю
вмешива: должны
единоличн: следствием
зуенконаучн: лагерем
человек: человеком пребывания
критическ: критическими истории
несправедлив: расследования
охот: охотиться
неспособн: неспособности
отсчет: отсчета
очист: призванную
взрыв: открытие
то: государством
цзян: женой
структур: структуры
регулир: компьютеры
гигантск: гигантские
студент: студентов школьники
партизанск: партизанское
попрост: местах
всемирн: сделали
прах: бабаошань
котор: искали поколением молодежь пленум
времен: временно
силов: силовые инициаторов
благ: многие
перешл: быстро
эксперимент: смелые отношение
отдава: предложением
бурн: камнями
огражда: силами
рестора: новые
шаг: элите первыми вперед новых
вест: вести
признава: вашингтон
прав: правой повторял современной неслучаен гарантирующие
связа: неразрывно
карман: карману
уч: учиться
либ: аппаратной
ушл: ним
весн: пекинская пекинской
верх: верх
сцен: заслуги сходили
интервенц: интервенции интервенций
скачок: скачок
верс: версию
колебан: каких
вывел: экономическую
исключен: исключением
член: членом посты членов членами
книг: красной
модернизац: провозгласил модернизации
прост: подтверждения страной домах
свест: свести
лин: линии идейная
позвол: выступала авторов позволит
рубл: составил
сосед: азиатских
справ: позволила
занима: заниматься противники занимался занимавший электроники покупать
свободн: инвестиций свободным
ноак: ноак
лиц: лиц опалу
встреч: той
лиш: прагматиков
встрет: диалог
ху: преемником секретарь
хх: воспоминания
внешн: внешне открыты
сверх: насаждалась
приговор: отмену
отбор: строгий
литератур: литературы любую древняя
завод: тракторный зарплаты заводы бригадиру
сопернича: соперничают
цк: цк
пострада: научной консервативное
одновремен: одновременно
выдава: выдавать
идеолог: рамки
камн: спецификой лавировал
пут: путь пути
активн: активных миллиарда
торговц: появлялось
подверг: протестующих
строительств: строительством пошли
самолет: посадку
пропаганд: пропаганды
должност: занявшего руководящие
класс: растущий
трудов: отправил трудовой
пекин: позволяют революцией пекин четверти
журналист: местные
узна: узнал
торгов: всемирной
частн: частной земель прибыль частная
выз: вызов
труд: труда труду трудом
путешеств: путешествия
крестьян: крестьянам крестьяне
облада: которое гофэн
ресурс: беспрецедентного необходимыми
процесс: публичный
молодеж: молодежи сделал
локомот: локомотив
европ: европе европы
достойн: достойное
нововведен: согласия
дружб: мире дружбу
налог: корпоративного налогообложения
нанкин: нанкине
продолжа: манифестаций соратников
черед: череду
выл: неудовлетворенность
нравствен: чья
кайш: кайши
резерв: резервы
телевизор: ремонту
современ: современного современных блага
помощ: помощью
волнова: волновать
фальсификац: фальсификацией
изгнан: увезти обвинили
заключ: турне
опасн: понимая попросту предупреждал
уважен: уважение
интегрирова: правило
показател: показателей
будуч: демократизацией
будущ: опасения будущий будущим будущем
желан: разделял
лов: ловит
прекрат: прекратился
зуенк: ивана
конкуренц: конкуренции
арен: значимость
свобод: вкус свободу задумываться
марионеточн: марионеточное
дисциплин: дисциплины
патриотическ: патриотической
спецпроект: спецпроекты
закон: признавал
рост: рост точками
зарегистрирова: тайваня
росс: мид россия
помог: международной
помогл: жибао
рисов: рисовых
задумыва: свобод задумывался
отправлен: отправленный политзаключенных
четырех: банды
мотор: мотор
плод: плоды
ситуац: ситуацию ситуация внешнеэкономической
каза: критический
причин: причину
выдвинут: впервые
местност: местности
отлича: корне
середин: переговоров
усопш: оскорбление
руководител: руководителем поколения провинциальными
опечатк: ооо
вынужд: вынужден
шла: внимание
эл: консенсуса местных
радост: сообщество
российск: отражение властям
маньчжур: маньчжурию
канал: кабельным
двойн: создало
стажировк: контроль
политическ: большим китайском политическому потребовали политического политических счетов изменившие вышли сохраняя
золот: миллиардов
перегна: перегнать
юг: юго
неважн: неважно
прибыл: извлекать
использова: разгона
юн: юного республике
значим: усиливая
достаточн: требования обладает обладал
установк: преобразовалась
поруч: поручил
завет: следование
уличн: вылилась
кадр: безопаснее обученных
затронул: частную
отстранен: отстранения
ссср: ссср
предводительств: созданных
яд: буржуазным
строг: проходили
нашел: поднебесной
отнын: сферы
невозможн: невозможно
печерицадоктор: владимир
кумир: выразить
рыночн: формирование продукции рыночных
ветера: шагов
радиоприемник: сломанные
провинциальн: реализовывались
сниз: оппонентами инициативе
сниж: снижены
назнач: попросил назначил
техническ: научно технических
выходц: воображение
товар: покупало дефицита
внесл: банковскую
пруд: прудов
гер: герой
поним: сторон
выпа: выпала
чисток: чисток
специальн: специальную
транспорт: имущество
сниска: снискали снискать снискал
помещик: помещиков
друз: родственники
функционер: партийным
разгон: многодневная принятия
представля: должна
друг: другими годах друг сменяют блок
зон: зонам свободные зарегистрированные
бунтова: бунтовали
яоба: секретаря ху
вредител: вредителями
запущ: модернизационные
бабаошан: кладбище
народ: простой нашего
компан: компаний зонах
получа: получал
действ: действия регионов
разбира: неплохо разбираться
велик: великого великий велика снесена великую провозглашен
привел: привело привела
инициатив: принималась
рубеж: жизнью
зарубежн: зарубежной
противоборств: принадлежал
коррупцион: разрешил
рад: цеха
региональн: школы
отстоя: решает
поворот: левого
привилег: привилегий
магазин: книжные
рак: умер
ран: ранее
увест: увести
зарплат: зарплата среде
протест: подавления знак уличные неповиновения давить раненые
деревн: деревни
интернет: интернет
предоставля: предоставлялась
телеканал: сюжеты
вступ: вступил
побереж: южного
траур: паркинсона
реставрац: кампании
штаб: генерального
официальн: научную сторона официального
великобритан: собраний
заслуг: делу арене
знак: апреля
знал: знали
штат: встречи
комментар: эффективность
прощ: проще
сотрудник: научный научного
проч: сложил
компьютер: государствах
сильн: сильно сильное
работа: кампаний работать
чужд: чуждыми
вызва: коммунистических
блок: противопоставляя
театр: речей
подтолкнул: ссылке
дадут: дадут
необходим: времена тупик необходимости жизненно изменениям
руководя: занимавшие
подходя: ожидайте
произвел: произвели
предвестник: напугала
кризис: кризис кризиса
форсирова: форсированную
автор: особых
прощан: каналам
гласност: гласности
остр: острый
обстановк: ситуации оппонентов
историческ: доктора
сельск: сельского сельских сельским сельской сельском
оста: лидеру детей
быстр: явлений быстрого
расцвета: расцветают
прояв: проявил
разреш: кресле ускорение
внедрен: внедрения
посмертн: протеста
реч: цитат
многолетн: проектов многолетние
реш: решил мотыга частично
прикова: прикованы
генеральн: начальника генеральным цзыян
международн: региональных преодолению интегрированы глобальные
залож: цену
подтвержден: станут находил
состо: заслуга
реж: болен льготный
обернувш: обернувшиеся
рек: дне
подстегива: сумму
продвига: связей
бегств: бегства
индустриализац: индустриализацию индустриализации
грамм: граммов
небоскреб: небоскребами
погибл: армией
индонез: малайзии
наблюда: архитектором
мягок: мягок
люб: продавать образовалась любая шага
зависим: делая
восстанавлива: отношений
снят: снять
фон: фоне
причислен: осуждения
захочет: согласны
снял: апреле капиталистическому
соверш: совершили
гот: народного
дальневосточн: шрми
люд: людям людей
отправл: исключен
всеядн: сила
ставш: ужас ставшим жены
гибел: гибели
отчет: отчетов
год: должности годы события
лагер: консервативным разбили
открыва: торговцев
министр: министра министром
зачаст: которыми
неизбежн: реки
ставк: основную
разгора: х
кульминац: кульминацией
особ: забывались внутри особо
лопнул: лопнули
тибет: тибет
волн: прокатилась волне
мал: первой
продаж: продажи
транслирова: семьи
псевдоним: обстановке
корпоративн: освобождались
улиц: демократии улицы улицах
потребн: систему потребность
инструмент: сельскохозяйственным
синьхайск: синьхайская
тяньаньмэн: тяньаньмэнь
сообществ: материке
подня: поднял четырех
стен: весны великой
апрел: премьере демонстрация
стихийн: отправили
незадолг: незадолго
завещан: прощания
подозрительн: подозрительными
войн: войне война войны войну
историк: историков
эньла: эньлаем соратник
каторжн: каторжные
войт: войти
спровоцирова: усопшего будущее
проща: прощалась
конечн: конечном
послевоен: опыта
состав: вложенных
политзаключен: большинства
расцвел: отменили
производ: фабрики
посадк: взлет
скачк: скачка
пишет: фупин
несоглас: несогласия
прем: премии
руин: руинах
достижен: достижения возрастом
командир: командиров командир
фабрик: фабриках дворах
самокритик: самокритику
кабельн: транслировались
написа: оперы
внутрипартийн: продолжение
пропагандистск: пропагандистскую
привыкш: привыкшего
франц: францию
возл: побережья
параллел: параллелей
ушел: митингующих
голод: голод вывел голоду
прокорм: прокормить
противореч: неизбежные
неудовлетворен: молодежной
наполня: буквально
цзыя: чжао
недостаточн: сил элементом
препятств: условиям
напомина: напоминала
сычуан: сычуань
переговор: эффективных
мотыг: оставалась
прошл: акция ушла прошло
род: родился
индексирова: фиксированными
заучива: простых
оппонент: контролем политическими
обход: обходилось
глинобитн: глинобитных
втор: вторым врагов прихода
рол: роль главенствующей ограничиться
дешев: привлекала
вожд: оппозицией
признан: признание
завоевыва: должен
избав: крестьянство
легитимн: легитимности
одежд: продуктов
корректировк: поддержит
обрат: занятие
готов: будьте
печериц: владимира
занят: пытался
идеологическ: заветам
образ: таким
опиумн: опиумные
конц: прошла довести
дорог: дорог
геро: национальным
приобретен: приобретении
электроник: бытовой разбирался
случа: удобном
починк: отдавать
частичн: бизнеса
удар: серьезным очередь
выяв: выявить
преда: готов
бесконечн: положило
предел: позволить
мид: мгимо
принос: приносить
единствен: считал
пита: питались
свернут: свернуть
давн: помог
училищ: училище
дава: семьям
гоминьдан: гоминьданом
реформатор: реформатора реформатор веса
вывест: вывести
кандидатур: кандидатуру
мир: мир собирался договор
предприят: предприятий возникали
исследован: международных
назначен: принципы ключевую
малайз: сингапура
скор: скоро предвестник
ива: россии противодействие
конец: процесс
феврал: покой
цзэдун: цзэдуна цзэдуном цзэдун тотальной
ранен: убитые
соцблок: странами
провед: проведя
получ: либерализация госпредприятия получить правительстве
начальник: электронике совета
вложен: прямых объем
публик: появлялся
реформаторск: умело роста
общегосударствен: перерастая
провел: права провел
экономическ: экономических экономический экономического экономическим создал зуенко примером
декабр: выдвинутую гонконгом
забира: забирали могли
рук: рукой
столкнул: затронули
отец: отец
компенсац: мелким
прям: прямо обеспечил послевоенной
покинут: покинуть
площад: площади
позиц: разгромили позиции
дешевк: товары
миллиард: вырос десяти миллиардам
иде: идеями апеллировал
дипломатическ: полное
счет: сведению
кремирова: останки
игл: игла
убытк: убытков
сопровожда: сопровождались сопровождалась
подъем: развитие
существен: рабочую
эффективн: ядра доказавшему
излишн: страдать
смогл: новое
госсовет: госсовета
репрессирова: итогам
деятел: общественно поколение партийные
излишк: получили
проводник: проводники
сотн: мая
вопрек: вопреки
момент: подходящего друзья заместителя
авторитет: поднять
многотысячн: прежнего
высокооплачива: коррупция
мор: развеян
принципиальн: принципиальный
основн: капитализма необходимо
лестниц: возрастная
вышл: весна вышла
неплох: сын
эньл: эньлая
чэнд: чэнду
сознан: сознание
изб: пуфана
инициатор: критикуемых
догна: догнать
решен: решение важнейшим неудивительно
закупк: закупку
воплощен: воплощение
провож: провожая
передава: газетах
провод: проводить вплоть проводившийся
средн: средний среднем
смерт: сентября премьера смерть
ушедш: ушедший
тайван: тайвань гонконга гонконге
носител: единственным
нужд: постепенно
олимп: политическом
генсек: приговора соответствии
земел: коллективизированных
наспех: телевизоров
ввел: ввело
беспорядк: провоцировании
результат: результате повлиял
сорн: сорную
жизнен: политиком
дав: продвигаться
полож: концентрации
бригадир: обратился
чрезмерн: избежать
подавлен: силового
сближен: пойти
витрин: принимать
дал: британское экзаменов
явлен: отдельных
воссоздан: шагами
увезт: разрешили
функционирован: обнулены
предложен: смелым откликнулось предложения заводе
сопротивлен: сопротивление сопротивления
заведет: уровень
выросл: выросли
сменя: руководителей
мгим: сотрудника
общенациональн: восстановление недели
весьм: весьма
дат: дать
прицел: идеалы
имен: народ
состоя: консервативного
подавля: одобрение
станет: станет
вкус: почувствовавшая
подверга: подвергались
медицинск: переданы
раскрепоща: установку
вредн: вредных
подвергл: подверглись
формирован: общества
вынуд: вынудило
деньг: наполняться
брат: решено
предлог: боролся
провинц: провинции завод провинциям применялись
брал: потребитель
предлож: предложил
фраз: фразу
рассужд: рассуждая
сжига: цин
мух: мухи
ниоткуд: попадали
арбитр: оставался
организовыва: организовывали
глобальн: реализовывать
начат: начатую
вмест: вместо вместе
уход: возраста
развяза: развязанной
обознач: идей
преподавател: оказывались
покупа: цен высокооплачиваемые
маньчжо: маньчжоу
правительств: правительства гонконг правительство правительством вице
лоточник: лоточники
гонконг: возле вопрос вернуть разбогатевших
настроен: настроений настроения
имуществ: налоги
начал: начале началу распределяли
отход: стремительный
конфискова: конфисковали
заня: гофэна занявшим
поколен: согласно старое чистым
руководств: руководстве руководство банда руководства
плюрализм: требованиям
заблужден: заблуждения
высш: высший
гарантир: поправки
инфляц: подстегивало
вспомина: вспоминает вспоминал
обеспеч: возвращения
дел: угрожавшая внутрипартийным потребителя дело дела
харизм: достаточной
ближайш: пример
вопрос: стороной удалось декларацию
цитат: сборника
неудачн: неудачных
семейн: предлогом
собствен: собственности собственность изменений
конкурсн: посредством
измен: либерализации изменить изменила годов
преследован: преследованию
насажда: неудач принципа
британск: сянгане отсталую тэтчер
дет: взять
расширен: исключили
поднима: времен
подчиня: продолжая
передов: одно
уничтожа: уничтожали
восстановлен: выход академии
кладбищ: революционном
восточн: восточной политологии
отношен: отношении веком разделявших
иска: раскрепощать формировали
угод: принесенных
крестьянин: крестьянин
арест: инициирует
умерш: память
квалифицирова: демонстрации
продл: изгнание
услыша: помогло
район: прибрежные
практик: истины
собран: народных
ряд: рядах
последн: последним последний руководством
сам: брал реформаторское реабилитации самых
потребител: рядовой превращает
переда: органы
школ: школ школе института
тотальн: справиться
образован: образование образовании
подобн: просторах тысячи
поощрен: поощрения
называ: называют
управлен: выработал
наслед: культурного
паркинсон: болезни
принят: протестов капиталистических принятый термином
женщин: женщины
пресс: игнорировалось прессы
юридическ: юридических
западн: западного
предлаг: идеям
мужчин: мужчины
административн: административным
област: области
научн: старшего восстановлении общественную иван модернизаций
несогласн: несогласных
приспущ: флаги
спин: власть
сво: назначить свой своему переоценить
марксист: великим
цзяньин: поддержке
демократизац: демократизации связан
порог: пороге
профессор: исторических печерицадоктор
станов: уходят удачные
академ: системы
лежа: лежали
откроют: откроют
истин: искать критерием
парт: очистить партии
потрясен: потрясений
нужда: средой
труженик: субаренда
расправл: расправляясь
развит: развития поездки стремительное развитию
настаива: прагматики
культ: насаждается развенчании
станут: преступлениях
мыш: мышей
руководствова: руководствовалась
демократ: призвал стеной
продолж: препятствием
обществен: общественной политическую основу
ускорен: ускоренную выступал требованием
пользова: пользовались критики
различн: производили
воплот: стремясь
уступа: уступать
ценност: ценности
сегодняшн: бросив
перейт: смогло
зерн: зерно зерна
истор: историю темой
ход: ходе
мышлен: мышления
переоцен: сцене
пробл: решить
закрыва: остановилась
сем: крестьянским участием семье
флаг: траур
сер: протест
легк: революционеры видов
сет: сетью
представител: тайване представителей
умел: консенсусам
умер: поддержки
прекраща: отныне
доход: доходило сверхпланового
кошк: кошка
вплот: другому
нескольк: нескольких
одобрен: чиновников
стрем: коллективное упорядочением
урок: уроки
памя: митинга
позволя: ресурсы
дне: камни
вэньмин: вэньмина
сумм: гораздо
городск: развивался
социалистическ: социалистического поистине угоду
дом: висят декабря
способн: способного способных забежать
тэтчер: маргарет
оконч: окончил
политработник: политработника
взам: сталину
поддержк: главной группы заручиться нашли
предостав: штаты
остальн: завоевывать
глубок: глубокие
лачуг: лачуг
хорош: хорошая хорошие
нац: нации
наш: большинство
улучш: улучшить
геноцид: геноцидом
фундамент: фундаментом крепкий
школьник: хунвейбины
успешн: успешных курса нововведения успешно
большинств: абсолютное подавляющего большинству
марксизм: марксизма
сил: собственных набравшая рабочая силе вторые
доллар: долларов
держав: державу державами
эпизод: эпизодов
составля: составлял
информац: размещать редакциярекламаконтактыпресс
салон: парикмахерских
развенчан: кпсс
цзефа: газете
земл: земля землю
диаспор: диаспоры представители
социализм: социализма солнцем
прогрессивн: прогрессивных
выгляд: олимпе
столкновен: использовали
оппозицион: оппозиционных
хозяйств: хозяйстве хозяйством хозяйства
противник: политические противников
скрыт: ревизионистов
комбатант: комбатантов
забра: забрали
вороб: воробьи
перестро: перестроить
требова: требовали недостаточно
военнослужа: военнослужащие
хуа: псевдонимом
оппозиц: оппозиции партийную внутренней
катастроф: катастрофа катастрофе
развея: прах
например: трудностей
свинарник: строительство
отправля: потребностям отправляли отправляется
коллег: изучать
миров: отправился мировой
забот: забота
поспева: деятелей
импортирова: колонию
приток: вложений
страх: страха
соответств: лидерства
председател: председателем председатель относиться председателя
акц: массовая переросла
сми: сми
голодовк: объявили
польз: пользу
архитектор: главных
федерац: российской
союз: союз союза
стран: отсталость странах страны правила стране случилось страна страну развитым
аренд: давали
январ: января
свет: зеленый
портрет: вождизма
южн: южным вдоль семейного
дух: революционным революционного
легочн: возрасте
япон: заключил японо япония
отобра: отобрали
отдых: отдыха
свеж: памяти
противопоставл: интриг
невыполним: невыполнимые
прошел: реабилитированы
выбор: соседей
госмонопол: госмонополию
националистическ: националистических
кумовств: расцвели
поража: самолетов
исключ: подвергся генсека
заяв: заявил заявит
баланс: идеальный
фиксирова: заводах
угроз: дэне
трибун: трибуна
небольш: небольшие
распределя: молодых
относ: социалистическим
корн: масштаба
безжалостн: безжалостно
дальн: фундамент
брос: бросить вто
выбра: выбранный
воспоминан: свежи
учитыв: преобразованиям
пребыван: ограничила
цзянс: провинцию
крупн: крупнейших сегодняшний крупной уханя
сот: погибли
коммерциализирова: рыночной
преобразова: линия
увлечен: излишнего
обреч: обречены
тюрьм: отправленных
сюжет: передавали
мизерн: мизерная
талант: талантом
становлен: становлении
монастыр: сжигались
ухан: шанхая
прежн: продолжения
пекинск: окна название результаты
откр: инвестиции
миллион: населением миллионы спровоцировала
июл: правительству июле
экспортер: производитель
урожа: урожай
июн: продолжавшаяся
захват: захватила
никак: яобан
xx: xx
ctrl: ctrl
xix: xix
mao: mao
enter: enter
