ру: ру
провер: проверить
влиян: влияние
студентк: студентке
понима: понимаю
оповещен: оповещения
стат: статьи
мобилизац: мобилизацией мобилизация
воен: военный военную
обычн: обычную
ввод: вводит вводятся
учет: учетом учет учете учета
стал: стало
жительств: жительства
предлага: предлагала предлагает предлагается предлагаем
объясн: объяснил
случа: случае случаев
призва: призвать
удал: удалить
един: единого единый
работ: работы
частичн: частичная
дополнительн: дополнительные
вернут: вернуться
мероприят: мероприятия
арх: архив
экономик: экономика
призывник: призывников
подчеркнул: подчеркнул
получен: получение полученной получения
сто: стоит
манхэттен: манхэттене
возглавля: возглавляет
встат: встать
арм: армию
личност: личность
должн: должны должна
ошибок: ошибок
структур: структуры
публикац: публикации
сообщ: сообщить
котор: которую
несовершенств: несовершенство
мир: мир
укол: уколов
силов: силовые
осен: осеннего осенью
секретн: секретные
модернизирова: модернизироваться
прописк: прописки
воинск: воинском воинский воинским воинского
прав: правил право правила
связа: связанных связанные связаны связан
подписыва: подписывайтесь
отмет: отметил
скор: скорее
нажм: нажмите
получ: получил получить
режим: режиме
проблемн: проблемных
фронт: фронте
важн: важно
списк: списка
реестр: реестр реестра
украин: украине
гранат: гранатой
ситдик: ситдиков
раскр: раскрыли
выстав: выставил
прям: прямо
россиянин: россиянин
сосед: соседа
ощут: ощутить
занима: заниматься
заработа: заработает
нов: новых новые новой
кстат: кстати
госдум: госдума госдумой госдумы
мест: место места
цифров: цифрового
законопроект: законопроекту законопроект
традицион: традиционным традиционные
госуслуг: госуслуг госуслугах госуслуги
андр: андрей
субъект: субъекта
слов: словам
вход: входе входить
охраня: охраняемую
выписа: выписана
определен: определенного
сдела: сделать сделана
эффективн: эффективность
видет: видеть
смогл: смогли
деактивирова: деактивирована
министерств: министерства
редакциярекламаконтактыпресс: редакциярекламаконтактыпресс
исправлен: исправление
заказн: заказными
работодател: работодателя
активн: активно
жизн: жизни
идт: идти
солдат: солдат
пропа: пропавших
витал: виталий
систем: система системы
кремл: кремля
индивидуальн: индивидуального
упрощен: упрощенном
срочн: срочную
трудов: трудовой
государствен: государственную
момент: момента
смог: смог
путешеств: путешествия
привлечен: привлечение
сможет: сможет
сша: сша
лидер: лидер
техник: техника
утечк: утечке утечки
решен: решения
требован: требованиям требований
культур: культура
нововведен: нововведения
личн: личном личный личные
вылож: выложившего
современ: современных
щигарев: щигарева
врач: врач
актуализирова: актуализировалась
истечен: истечении
дал: далее
жител: жители
документ: документы документов
увер: уверен
нул: нулю
портал: портале
транспортн: транспортных
подчеркива: подчеркивал
повестк: повестки повестка повестке повестку
средств: средств
дан: данные
отключ: отключит отключены
указа: указаны указал указанного
спецпроект: спецпроекты
состоя: состоящих состоящий
раскрыт: раскрыты
закон: законом закона закон законе
росс: россии россия
регистрац: регистрацию
фбр: фбр
отправлен: отправлениями
гиперзвуков: гиперзвуковой
неточн: неточности
мотор: мотор
отсрочк: отсрочку
ситуац: ситуацию
пожалова: пожаловать
некорректн: некорректно
счита: считаться
формирован: формирования
причин: причины причине
функц: функцию
цел: цель
очк: очков
лент: ленте лента ленту
достиг: достиг
сообща: сообщать
руководител: руководитель
добровольн: добровольных
возраст: возраста
опечатк: опечатку
галер: галереи
оцен: оценили оценил
сохран: сохранить
канал: канале
радиофактчекинг: радиофактчекинг
максут: максут
военнообяза: военнообязанных военнообязанного
прилож: приложив
обнов: обновила
разработк: разработкой
частност: частности
жил: жилья
постановк: постановке постановка
начал: началах
мфц: мфц
уточня: уточнял
медиа: медианная
завер: заверил
ссср: ссср
кабинет: кабинете кабинет
комисс: комиссия
ввест: ввести
прослед: проследить
яв: явиться
след: следующая
вопрос: вопросы
рассказа: рассказали рассказал
помим: помимо
военк: военком
проход: проходила
ответ: ответил
так: таком
гадалк: гадалки
военкомат: военкоматов военкомате военкомат
семейн: семейного
срок: сроки
течен: течение
снилс: снилс
контрактник: контрактников
материал: материалы
уведомлен: уведомления уведомление
смен: сменил
порта: портал
совфед: совфед
служб: службу службе
количеств: количество
кита: китаем
добав: добавил
спорт: спорт
последн: последние
заявлен: заявление
уважительн: уважительной
отображ: отображена
объем: объеме
жми: жми
вруча: вручать
приход: приходить
тайн: тайну
образован: образовании
ограничен: ограничения
получа: получать
главн: главное
принят: принятом принятый принятия
нашл: нашли
пресс: пресс
пят: пяти
юридическ: юридическую
подтверд: подтвердить
очередн: очередного
обязан: обязанность
популярн: популярные популярных
смертельн: смертельной
региональн: региональная
пентагон: пентагона
имеющ: имеющие имеющими
сво: сво
нача: начали
интернет: интернет
россия: россиян
рекорд: рекорд
появлен: появления
уклонист: уклонистам уклонистов
тем: темы теме
официальн: официальный
сведен: сведений сведения
пришл: пришла пришлось
полн: полном
развит: развития
знат: знать
почтов: почтовыми
гражданств: гражданстве гражданство
предусмотр: предусмотрена
задач: задача
комментар: комментарии
поставл: поставлен
ускорен: ускоренном
трет: третьем
смогут: смогут
запрет: запретят
ценност: ценности
шадаевглав: шадаевглава
долж: должен
коснут: коснутся
норм: норма
нервозн: нервозность
рекламирова: рекламировать
необходим: необходимые необходимо необходимым
числ: числе
призывн: призывная
гражда: граждан
ход: ходе
подозрева: подозреваемого
одобр: одобрил
мошенник: мошенники
представител: представитель представителей
вид: виде
виде: видео
чтен: чтениях
положен: положения
явк: явке
придет: придет
обжалова: обжаловать
комиссариат: комиссариат
депутат: депутат
наук: наука
уточн: уточнил
дне: дней
сюжетмобилизац: сюжетмобилизация
поправк: поправки
цифровизац: цифровизации
нажива: наживаются
известн: известно
ограничительн: ограничительных
обитан: обитания
систематизирова: систематизировать
дня: дня
родственник: родственниках
хорош: хорошие
стоимост: стоимость
предусматрива: предусматривает
паспортн: паспортные
вторник: вторник
сред: среду среда
ин: иную
оборон: обороне
ит: ит
пользовател: пользователь пользователю
мног: многие
похуден: похудения
язык: язык
срочник: срочников
сил: силу
умн: умных
фот: фото
содержа: содержать
арестова: арестовало
гроз: грозит
нат: нато
информац: информация
составля: составляющих
призыв: призыва призывом
заболел: заболел
транс: транс
россиян: россиянам россиянах
повесток: повесток
отталкива: отталкиваться
приравня: приравнять
министр: министра министр
контракт: контракту
законодательств: законодательство
комитет: комитета
применен: применении
ставк: ставка
поступлен: поступления
создан: создание
граждан: граждане гражданами гражданах гражданам
маргарит: маргарита
например: например
продаж: продажу
правил: правилах
согласн: согласно
дублирова: дублировать
забот: забота
запуст: запустят запустить
рассылк: рассылки
картаполовпредседател: картаполовпредседатель
пода: подать
обращен: обращениями обращения
понятн: понятно
шада: шадаев
бумажн: бумажные
секретар: секретарь
соответств: соответствующий соответствует
запуск: запуска
президент: президента
одинаков: одинаковую
сми: сми
музык: музыки
апрел: апреля
электрон: электронном электронного электронные электронная
стран: страны
аренд: аренды
запрос: запрос
регион: регионы
громк: громкой
сист: систему
март: марта
испытан: испытании
войт: войти
свед: сведено
качеств: качестве
песк: песков
глав: главы глава
рамил: рамиль
дета: детали
предпринимател: предпринимателя
деятельн: деятельности
наскольк: насколько
гражданин: гражданин гражданину
дум: думой
онлайн: онлайн
порядк: порядке
исключ: исключены
картапол: картаполов
автоматическ: автоматическая
болезн: болезни
ракет: ракеты
новост: новости
приня: приняла
добр: добро добра
написа: написать
оо: ооо
изменен: изменения изменениями изменениях изменении
возможн: возможность
брос: бросил
тимк: тимкив
как: каком каких
определ: определены
дмитр: дмитрий
рассматрива: рассматриваться
выпуск: выпуска
бывш: бывший
реальн: реальный
втор: втором
точн: точные
улучша: улучшать
отраслев: отраслевом
способ: способы
мер: мерах мер
ри: риа
минцифр: минцифры
killnet: killnet
pogontsev: pogontsev
russian: russian
ctrl: ctrl
appl: apple
globallookpress: globallookpress
telegram: telegram
viktor: viktor
enter: enter
