ру: ру
говор: говоря говорят говорить
оценк: оценкам
понима: понимают понимать
лев: левой левыми левым
фактическ: фактически
стат: статьи
воен: военно военного военных военное военный военном военную военной
захот: захотят
обычн: обычную
европейск: европейских европейского
оказа: оказалось оказалась
федеральн: федеральный
нин: нина
стал: стали стало
мнен: мнения
объясн: объяснили
северн: северными северной
последств: последствия последствий
реализова: реализованы
центр: центра центре центры
работ: работа работе работы работу
проблематик: проблематикой
показыва: показывает
дополнительн: дополнительно
арт: артем
сценар: сценариев
прогулк: прогулке
арх: архив
предсказа: предсказать
экономик: экономику экономика экономики экономике
привлеч: привлечь
пол: поле
радикал: радикалами
пандем: пандемии
инфраструктур: инфраструктуры
единоличн: единоличную
сто: стоят стоит
нефтеперерабатыва: нефтеперерабатывающего
манхэттен: манхэттене
бундесвер: бундесвера бундесвер
просматрива: просматриваются
критическ: критическое
некоммерческ: некоммерческих
вооружен: вооруженных вооружений вооружения
каса: касается
интеграц: интеграцией
макияж: макияжа
взрыв: взрывы взрывам взрывов
нарастан: нарастанием
разговор: разговоры разговоров
арм: армии
то: той
леопард: леопард
присутств: присутствие
структур: структуры
публикац: публикации
суд: суд
означа: означать
запас: запасов
котор: которую которое котором которыми
денег: денег
маке: макеев
силов: силовые силового
осен: осенне осени осенью
секретн: секретные
связа: связано связанным связанные связанных связанную связанный
прав: права правыми
статистик: статистика
либ: либо
связ: связи
ушл: ушло
появля: появляются
затруднительн: затруднительной
заб: забыть
обозрим: обозримой
относительн: относительно
гельзенкирхен: гельзенкирхене
шольц: шольца шольц
дела: делать
сут: сути
омельяненк: омельяненко
причастн: причастность
дискусс: дискуссии дискуссия
проблемн: проблемных
верс: версиях
байд: байден
центральн: центральном
союзник: союзникам союзников
лин: линии линия
альтернатив: альтернативе
россиянин: россиянин
зам: замена
обвиня: обвиняемого
сосед: соседа
справ: справиться справа
заявля: заявляют
занима: занимают
лиц: лиц лицо лица
тенденц: тенденции
родин: родину
эксплуатац: эксплуатацию
очевидн: очевидную
уровен: уровень
нов: новые новых новой
внешн: внешней
катрин: катрин
слом: слом
част: частью части часть часты
корен: коренным
пожил: пожилая
алекс: алексей
слов: слова
завод: завода
пострада: пострадали
одновремен: одновременно
внешнеторгов: внешнеторговой
отказ: отказ отказе
системн: системные
определен: определенную определенной определенные
особен: особенностей
деактивирова: деактивирована
сложн: сложную сложно
министерств: министерств
выставл: выставляя
активн: активно активности активная
пример: примером пример
немц: немцы
выход: выхода
строительств: строительства
узна: узнала
государствен: государственных
летн: летней
клар: клара
активистк: активисткой
путешеств: путешествия
бесед: беседуют
текущ: текущей
сша: сша
ресурс: ресурсов ресурс ресурсы
лидер: лидеров лидер
метод: метод
перемен: переменная
произошедш: произошедшего произошедшем
техник: техника
неудач: неудач
напрот: напротив
европ: европы
культур: культура культуры культуре
лнр: лнр
продолжа: продолжает продолжали продолжают продолжать
электростанц: электростанции
инерцион: инерционное
рынк: рынке рынка
опаса: опасается
современ: современные
помощ: помощь помощью помощи
врач: врач
выступ: выступить
заключ: заключены
промышлен: промышленные промышленных промышленности промышленного промышленность промышленным
трубопровод: трубопроводу
будущ: будущее будущему будущем
прекрат: прекратили
шир: шире
спокойн: спокойно
насовс: насовсем
немецк: немецких немецкие немецком немецкой немецкую немецкого немецкий немецкая немецкому немецким немецкое
версификац: версификации
подчеркива: подчеркивают
интерес: интересов интересы
конкуренц: конкуренции
побратим: побратимов
средств: средства
пожал: пожалуй
евр: евро
отключ: отключены
спецпроект: спецпроекты
фаз: фаза
закон: законов
рост: рост ростом
беспрецедентн: беспрецедентно
росс: россии россия россией
помогл: помогли
фбр: фбр
процент: процента
газ: газа
мотор: мотор
зим: зимы зима
ситуац: ситуацией ситуации ситуацию ситуация
числен: численности
имеет: имеет
каза: казались
счита: считалось считаю считан считают
цел: целом
цен: цен
спецоперац: спецоперации
лент: лента ленту
мирн: мирно мирных мирным мирного мирное
финансирован: финансирования
безальтернатив: безальтернативен
опечатк: опечатку
пройд: пройдены
российск: российского российских российском российско российскую российской российскими
всеполитикаобществопроисшествияконфликтыпреступн: всеполитикаобществопроисшествияконфликтыпреступность
внешнеполитическ: внешнеполитической
взаимодейств: взаимодействие взаимодействия
подрыв: подрывами
политическ: политическом политического политических политической
идут: идут
иностра: иностранных
завершен: завершении
ведет: ведется ведет
кличк: кличко
серьезн: серьезных серьезные
использова: использовать
логик: логике
африк: африки
межобществен: межобщественном
безусловн: безусловно
стратег: стратегия
значим: значимость
достаточн: достаточно
примерн: примерно
благополучн: благополучно
бранденбургск: бранденбургских
ссср: ссср
энерг: энергии
ремонт: ремонт
меньш: меньшей
след: следующая
прошедш: прошедший
слев: слева
напомн: напомню
сокол: соколов
организац: организаций
концепц: концепции
таб: табу
приемлем: приемлемую
зелен: зеленую зеленой
так: такую такого таким
трансатлантическ: трансатлантических
картин: картину
сниз: снизилась
разогна: разогналась
условн: условное
ретейл: ретейла
ближневосточн: ближневосточном
усилен: усилением
блогерш: блогерши
назва: назвал
собира: собирается собираются
антигосударствен: антигосударственными
некотор: некоторое некоторые
потенциальн: потенциальному
утечек: утечек
количеств: количество
диалог: диалога диалоге
остава: оставался
спорт: спорт
деэскалац: деэскалацию
специальн: специальной специального
разновидн: разновидностью
недоста: недостающие
услов: условиях
объем: объемы
хлопа: хлопать
представля: представляют представлял
возвра: возвращаясь
друг: другим
зон: зоны
тайн: тайно
запущ: запущены
низш: низшей
степен: степени
компан: компаний компании
ограничен: ограниченном
программ: программе
конвертир: конвертируются
главн: главное
действ: действия действий
предъяв: предъявить
страда: страдает
низк: низком
имидж: имиджа
подтверд: подтвердили
инициатив: инициативе
состоян: состоянии
отдел: отдела
имеют: имеют
предшественниц: предшественниц
отдельн: отдельным
сигна: сигнал
протест: протесты протестующих
передач: передаче
сохранен: сохранения
интернет: интернет
наращиван: наращивания
тем: тема тему теме
официальн: официальное официальные
пришл: пришлось
полн: полное полный
поставк: поставками поставки поставка
комментар: комментарии
поставл: поставляя поставлены
беженц: беженцев
рамк: рамки рамках
сотрудник: сотрудником
сильн: сильна
работа: работать
воздейств: воздействия
нанесен: нанесения
долг: долгое
блок: блока
эконом: экономии
норм: нормой норма нормы
капита: капитала
оставля: оставляет
заинтересова: заинтересована
телефон: телефонные телефонных
необходим: необходимы
числ: число числе
гражда: граждан
посол: посол
период: период периоду
газопровод: газопроводов газопроводы
нейтральн: нейтральной
подозрева: подозреваемого
кризис: кризисом кризиса
сотруднича: сотрудничать
тренировк: тренировки
сдержа: сдержанную сдержанно
реакц: реакция реакции
возврат: возврат
виде: видео
остр: острой остро
объявл: объявлено
положен: положение
возник: возник
подход: подхода
разрешен: разрешения
намер: намерены
историческ: исторических
нынешн: нынешней
оста: осталось остается остаться
быстр: быстрых быстро
бизнес: бизнеса бизнес
виновн: виновной
принима: принимали принимаются принимать
инцидент: инцидента
хакбайл: хакбайл
многолетн: многолетнего
реш: решен решить
гражданск: гражданский
пригожин: пригожин
обитан: обитания
поддержива: поддерживать
серг: сергей
миграцион: миграционным
культурн: культурно
удобн: удобна
сред: среда среди
отдален: отдаленное
устойчив: устойчивые устойчивая
урегулирован: урегулирования урегулирование
чувств: чувствуют
мног: многом многие
наблюда: наблюдается
ковалев: ковалева
похуден: похудения
контакт: контакты контактов контакт
избежа: избежать
преодол: преодолены
язык: язык
фон: фоне фон
фот: фото
происходя: происходящее
фактор: фактор факторов
критикова: критиковать
невзир: невзирая
соверш: совершившего
инициативн: инициативно
фрг: фрг
разн: разнятся разным
альтенграбо: альтенграбоу
отправк: отправки
огн: огня
производител: производителей
тормоз: тормозить
год: годов
конкретн: конкретных
министр: министра министр
создан: создания создании
предписан: предписаний
мигрант: мигрантами
антивоен: антивоенных антивоенная
производств: производство производства производству
одн: одну одно одним
продаж: продажу
отчаст: отчасти
приб: прибыло прибыли
улиц: улице
потребн: потребность
сравнительн: сравнительно
выда: выдалась
олаф: олафа олаф
сообществ: сообщество сообщества
огранич: ограничены
апрел: апреля
таков: таковую
неучаст: неучастия
участ: участились
смотрет: смотреть
использован: использования использовании
регион: регионы регионе
поскольк: поскольку
войн: войны
горазд: гораздо
сентябр: сентября
март: марта
испытан: испытании
войт: войти
мейнстримов: мейнстримовых
массов: массовая
тон: тоном
фонд: фонда
состав: состава
ближн: ближнего
неча: нечаев
маневр: маневра
неясн: неясно
поступа: поступает
писториус: писториуса
повлек: повлек
болезн: болезни
украинск: украинском украинских украинского
двусторон: двустороннего двусторонним
ракет: ракеты
новост: новости
существ: существуют существует
перв: первых
чувствительн: чувствительный
непрост: непростой
проведен: проведению
приня: приняла
партнерск: партнерских
добр: добро добра
наращива: наращивать
изменен: изменений
чемпион: чемпион
энергетик: энергетики энергетику
заказчик: заказчиках заказчику
равн: равных
исполнен: исполнением
освеща: освещают
как: какую какое каком какие каких каким
зимн: зимнему
герман: германия германии германию
повлия: повлияет повлиять
рассматрива: рассматривается
переговор: переговоров переговорам переговоры
зотин: зотина
прошл: прошлого
количествен: количественном
высок: высокое
реальн: реальный
тяжел: тяжелую тяжелого
втор: вторых
точн: точно
рол: роль
риск: риски
точк: точки
дешев: дешевого
сфер: сфера сфере
однозначн: однозначной
способ: способен способа способы способ
раскалыва: раскалывает
форм: формах форме формы
признан: признанию
мер: меры мере
магистральн: магистральным
найт: найти
готов: готовиться готовы
максимальн: максимально
антироссийск: антироссийских
влиян: влияния влияние
энергетическ: энергетическим энергетические энергетической энергетического
студентк: студентке
информацион: информационном
коронавирус: коронавируса
образ: образом
занят: занятые
обоснова: обоснованные
ввод: вводились
учет: учетом
аспект: аспектом
гарант: гарантии гарантий
франкфурт: франкфурте
успех: успеха успехи
случа: случае
призва: призвать
удал: удалить
кадров: кадрового
удар: удар
практическ: практически
вернут: вернуться вернуть
берлин: берлине берлин
выяв: выявит
знающ: знающего
предел: пределе
мид: мид
подчеркнул: подчеркнула
конфликт: конфликте конфликт конфликта
сокраща: сокращаться
вокзал: вокзале
раздач: раздачей
санкц: санкций
уроженец: уроженец
единствен: единственным
доминир: доминируют
ожида: ожидать ожидалось
личност: личность
заморозк: заморозка
поэт: поэтому
зафиксирова: зафиксированы
двер: дверью
вариант: варианты
мир: мир
укол: уколов
предприят: предприятий предприятиям предприятия
исследован: исследований
прекращен: прекращением прекращению
обсужда: обсуждаются
внешност: внешности
безопасн: безопасностью безопасности
этап: этапе
вагнер: вагнер
скор: скорейшем скорее
соблюден: соблюдением
нажм: нажмите
феврал: февраля
сообщен: сообщениям
боев: боевые боевых
власт: власти властей властями властям
получ: получила получил получен
тактик: тактику
публик: публикуются
фронт: фронте
важн: важнее важно важным
город: городов городами городах
экономическ: экономических экономические
украин: украины украину украине украино
гранат: гранатой
внутр: внутри
сектор: сектор
встает: встает
раскр: раскрыли
лейпциг: лейпцига
выстав: выставил
позиц: позиция позицию позиции
могл: могли
покинул: покинули
ярк: яркий яркой
истребител: истребители истребителей
водородн: водородной
действительн: действительности
анастас: анастасия
кстат: кстати
больш: большая
миллиард: миллиардов
заморож: заморожены
германск: германской германскими германских
мест: место
дипломатическ: дипломатического
демонстрирова: демонстрировало
счет: счет
направлен: направленных направлением направлений
убытк: убытки
наибольш: наибольшего
накоп: накопить
исполнител: исполнителях
ясн: ясно
принудительн: принудительно
эффективн: эффективность эффективны
видет: видеть
извлечет: извлечет
смогл: смогли
расшир: расширить расширяясь
редк: редкими
испытыва: испытывает
минимизирова: минимизировать
дальновидн: дальновидность
редакциярекламаконтактыпресс: редакциярекламаконтактыпресс
представлен: представление представленности
арабск: арабского
жизн: жизни
идт: идти
солдат: солдаты
зашедш: зашедшей
населен: населения
формальн: формально
сформирова: сформировать
угольн: угольной
чвк: чвк
сокращен: сокращением
мож: можем
пыта: пытаются пытается
вопрек: вопреки
момент: моменту момент
обсужден: обсуждении
заседан: заседании
развива: развиваться развиваются
пообща: пообщалась
митинг: митинг
основн: основном основной
борис: бориса
сможет: сможет
пополня: пополнять
утечк: утечке утечки
решен: решение решений решения
дефиц: дефицит
передава: передавать
удив: удивились
личн: личные
вылож: выложившего
выбира: выбирают
результат: результате результатов
турецк: турецкого
вызыва: вызывают
функционирован: функционированием
документ: документы документов
сравнива: сравнивать
энергоресурс: энергоресурсы энергоресурсов
выросл: выросла
мгим: мгимо
диверсификац: диверсификации
восприят: восприятие
расследован: расследование расследования
дан: данные данной данным данный данном
имел: имели
возобновлен: возобновлении возобновление
разделя: разделяют
раскрыт: раскрыты
опрос: опросов опросам
социологическ: социологических
гиперзвуков: гиперзвуковой
вряд: вряд
пожалова: пожаловать
бюрократ: бюрократии
покритикова: покритиковать
функц: функции
незыблем: незыблемыми
встраива: встраиваться
очк: очков
выуч: выучить
эскалац: эскалации
возника: возникает
увид: увидим
галер: галереи
прожива: проживало
оцен: оценили оценил
проявля: проявлялись
сохран: сохранить
политик: политики политику политике политиков политиком
восток: востока
вмест: вместе
финансов: финансовые финансовую финансовой
уход: ухода
тупик: тупик
обнов: обновила
правительств: правительство правительству правительства
настроен: настроений настроениям настроениями
жил: жилого жилья
уверен: увереннее
продолжен: продолжении продолжение
руководств: руководства руководство руководством
танк: танками танки танком танков
наступлен: наступлении
путин: путиным
медиа: медианная
учитыва: учитываются
трубопроводн: трубопроводного
преимуществ: преимуществом
инфляц: инфляцией инфляция
произошл: произошла произошло
масштабн: масштабная масштабны масштабном масштабную масштабной
стольк: столько
дел: дело
вопрос: вопрос вопросу вопросы вопросах вопросам
ближайш: ближайшем
сохраня: сохраняются сохраняют сохраняется
игра: играют
раджпут: раджпут
внутрен: внутренней
шварцер: шварцер
приобретут: приобретут
размер: размере
возникнет: возникнет
переход: перехода
проход: проходят
ответ: ответы ответу
обществ: обществе общества общество
подчеркнувш: подчеркнувшего
пространств: пространства пространстве
несмотр: несмотря
сталкива: сталкивается
срок: сроки
собствен: собственной собственных собственного
измен: изменит изменилась
джо: джо
уда: удалось удается
территор: территорию территории
раст: расти
существован: существование
отказыва: отказывается
расширен: расширению
материал: материалы
восстановлен: восстановления
смен: смены
сар: сары сарой
хронологическ: хронологические
отношен: отношений отношения отношениям отношении отношение
иска: искать
претенд: претендует
ан: анн
протестн: протестные
кита: китаем китай
заинтересован: заинтересованность
посмотрет: посмотреть
район: района
практик: практика
ряд: ряд
последн: последние
заявлен: заявление заявлений
пауз: паузу
сам: самый
альянс: альянс
захотел: захотел
жми: жми
инач: иначе
возлага: возлагает
организова: организованная
переда: переданы
бо: боя
оказыва: оказывают оказывать
ужесточен: ужесточение
подобн: подобным
вероятн: вероятность вероятно вероятных вероятным
давлен: давления давление
ира: иран
принят: принято
характер: характере
нашл: нашли
женщин: женщина женщин женщинами
представл: представляя
достигл: достигли
фатальн: фатальных
заключа: заключается
предполага: предполагается
формир: формируются формирует
западн: западным западных западные западная
популярн: популярных популярные
смертельн: смертельной
научн: научным
окажет: окажется
достига: достигают
пентагон: пентагона
преоблада: преобладает
взаимодействова: взаимодействовать
нача: начать
перспектив: перспективе перспектива
оруж: оружие оружием оружия
значительн: значительный значительное значительно значительные
полигон: полигоне
парт: партии
рекорд: рекорд
явля: является являются
виктор: виктор
канцлер: канцлера канцлер
энергоносител: энергоносители
законч: закончится
перевооружен: перевооружении
трансформац: трансформацию
развит: развитии развития развитие
интенсивн: интенсивном
переж: пережить
обеспечен: обеспечения
контрол: контроль контроле
уничтожен: уничтоженных
обществен: общественно общественным
придержива: придерживаются
пользова: пользовался
зеленск: зеленского
различн: различные различных различными различным
домохозяйств: домохозяйствам домохозяйств
хвата: хватает
трет: третьих трети треть
неочевидн: неочевидно
конструктивн: конструктивность
ценност: ценности ценность
пар: пара
вагенкнехт: вагенкнехт
истор: история
ход: ход
зрен: зрения
ес: ес
тепл: теплая
льнског: льнского
пробл: проблем
призыва: призывает призывал
легк: легко
представител: представителя представители представителей представителями
вид: видит видов видим виде
сет: сети
защит: защитить защиту
прекраща: прекращать
красн: красные
корпорац: корпораций
ищут: ищут
естествен: естественно
договор: договориться
наук: наука
стрем: стремится стремятся
влия: влияла
хот: хотят
пво: пво
пережива: переживает
эпох: эпох
городск: городского
дом: дома
способн: способны
репрезентац: репрезентации
известн: известно
гейвиц: гейвиц
сторон: сторона стороны
восстановл: восстановлены
поток: потоками
указыва: указывать
поддержк: поддержкой поддержке поддержку поддержка поддержки
смотр: смотрят
мюнстер: мюнстер
остальн: остальных
эмоциональн: эмоциональное
евросоюз: евросоюз евросоюза
претенз: претензии
принцип: принципе
хорош: хорошим хорошего хорошие
стоимост: стоимость
опира: опираться
антидемократическ: антидемократическими
ин: иное
оборон: обороны оборонного
лакун: лакуны
успешн: успешно
выгод: выгоды
большинств: большинства большинство
сил: силы силу силой сил силам силами
заказ: заказов
умн: умных
план: планы
публичн: публичным
товарищ: товарищей
арестова: арестовало
измерен: измерении
нат: нато
гуманитарн: гуманитарную
информац: информация
салон: салонных
ворот: ворот
поставля: поставлять поставляется
негативн: негативном негативные негативный
ключев: ключевое
оппозицион: оппозиционным
спуст: спустя
трудност: трудностей трудности
ки: киев
закрыт: закрыта
граждан: гражданами
идет: идет
например: например
производствен: производственные
отправля: отправляет
артем: артемом
самостоятельн: самостоятельную
забот: забота
понятн: понятно
соответств: соответствует
президент: президентом
масштаб: масштабах
приеха: приехал
поставок: поставок
акц: акциям акции акций
сми: сми
соколов: соколовым
молчан: молчание молчания
музык: музыки
ответствен: ответственность ответственности
федерац: федерацию федерации
союз: союза
мощност: мощности
стран: страна странах страны страну стране стран
аренд: аренды
январ: января
свет: свете
уровн: уровне
отлич: отличие
диверс: диверсии
громк: громкой
артиллер: артиллерию
ухудшен: ухудшение
накоплен: накопленных
комплекс: комплекса
наскольк: насколько
собор: собора
государств: государства
проблем: проблемы проблемах проблема
алис: алисой
намерен: намерении
заяв: заявил заявили
поставщик: поставщиков
выражен: выражения
сюжетпротест: сюжетпротесты
камра: камран
об: обе
владимир: владимиром владимир
механизм: механизмов
орган: органов
дума: думают
формат: форматов
относ: относится относятся
операц: операции
произойдет: произойдет
крайн: крайне крайней
оо: ооо
возможн: возможности возможностей возможной возможно возможных
оп: опыт
дальн: дальнейшее дальнейших
упуст: упустить
всу: всу
американск: американских
открыт: открытым открытых
брос: бросил
увелич: увеличились
бокс: боксу
демонстрац: демонстрация демонстрации
палат: палаты
хочет: хочет
крупн: крупных крупные
подтвержд: подтверждено
непосредствен: непосредственно
персона: персонала
адекватн: адекватной адекватно
ориентир: ориентируется
санкцион: санкционных санкционная санкционной
взгляд: взглядов
сюжет: сюжета
бойц: бойцов
воинствен: воинственной
чьи: чьи
выпуск: выпуска
прежд: прежде
наверн: наверное
бывш: бывший
стабильн: стабильных стабильным
выступа: выступающих выступали выступает
воспользова: воспользоваться
прежн: прежний
откр: открыть
миллион: миллиона
ри: риа
наход: находятся находится находились
русскоязычн: русскоязычное
подбор: подбору
никак: никаких никакого
потер: потери
источник: источником источниках
каков: каковы какова
allianc: alliance
gaertner: gaertner
ctrl: ctrl
appl: apple
schmidt: schmidt
bp: bp
photothek: photothek
getti: getty
tang: tang
abdulhamid: abdulhamid
kai: kay
pictur: picture
florian: florian
deutsch: deutsche
macmatzen: macmatzen
nurphoto: nurphoto
enter: enter
anadolu: anadolu
hendrik: hendrik
globu: globus
meissner: meissner
hosba: hosbas
bahn: bahn
ap: ap
probst: probst
michael: michael
ying: ying
leopard: leopard
agenc: agency
morri: morris
killnet: killnet
unip: uniper
martin: martin
nietfeld: nietfeld
imag: images
