париж: доме
убежищ: сведения
случ: вяткин
говор: штурмовать говорят контроля
ру: ру
слух: взаимоисключающих мегафон
оценк: некоторым
банк: лицензии счета сравнить инцидента собственный
теневик: бывшие
обзавел: семья
фактическ: помещения
металл: драгоценными
стат: статьи толку
сравн: бизнес
леж: рынок
обычн: обычную выросли
оказа: рубежом обманувшихся оказал
стар: средних
федеральн: находившегося
рабоч: создании
стал: началась заводить
мнен: кредитов микляев
составлен: наспех
посад: жигули
парик: кудрявом
став: разойтись
реализова: братию
работ: настоящая парализовали возобновлении банками
рекламн: герои
арх: архив
экономик: теневой экономика
привлеч: пытались
впечатлен: приятное
касс: принес
получен: помощь
дремуч: разводом
торговл: пугали переориентироваться
пол: диване комнаты
сто: базар акция
тв: утверждали
приятн: производил
лен: работяга роликах
поступ: наукам
пункт: обменном московских обещаниям
местоположен: раскрыть
арм: армией
то: послед
снижен: решился
должн: неприкосновенность остались
структур: структуры приватизация
публикац: различных пошли
суд: чертановского размере
крепк: крепкие
означа: котировок
правоохранительн: курировались взяли накалилась
благодар: поддерживалась
котор: адреналина
черномырдин: виктор сигналу
денег: игре
несл: равно
обступ: бутылок
времен: причитающееся
провест: намерении
здан: штурм стоявшие выплат располагался
пор: прибыльный кампания
обманыва: государство
подкреплен: милиционеры
силов: силовые
выреза: вырезали
бурн: необычайно
реализовыва: главным
съемн: жил
шаг: трешке методы
прав: эпохи
участвова: многие
доста: версия
спецслужб: ветераны
визит: визита
шампанск: брата
голубков: леню
проект: нового задуманные
ушл: органов
появля: судьбе
относительн: прошли
пирамид: пирамиды пирамид классической превратилась
капл: таких
дела: запретили операций
верхушк: слухам
сух: следствия
вци: опросе
крова: секций
шконк: тюремной
раствор: ми
обеспоко: прозорливые
верс: приговора созданной циркулировавших
вывел: часов
член: записывались
шухер: большого
устраива: ждет
незадачлив: незадачливого
знавш: своем
книг: читал
центральн: здание
травл: прекратить
обогат: обогатились значительно
прост: роликов
сделк: ареста
снова: домой
обитател: обитателей
позвол: старшего
рубл: прежде вместе
справ: способы
занима: разрешавший денег
свободн: серьезными
ложн: зарядить
разгром: мнению
предупред: сотрудник
усугубля: лавина
лих: сгинул
лиц: первые
жигул: красные жигулей
планирова: точно
заработа: несли наверняка
встрет: тысяче
полномоч: получилось
позвон: позвонили
просчита: гениальными
нов: старте рыночной мечтающая
легальн: крупному
ног: лежит
убежд: юмора
парламентар: считала
госдум: госдуму депутат
приговор: мягкого
част: людьми
тишин: матросскую
слож: бумаге
повал: налога
журна: писал
слов: друзей
завод: хищении
перевернул: пыталась
пострада: пострадали
вежлив: обращались
постоя: утверждая
сдела: мешало кооператив свой
отзыв: объявил
неосвоен: указал
деактивирова: нажмите
сложн: увлечь
анишкин: писатель
судьб: информации
обманут: совместительству море
родител: реклама хоронить
прибра: закрылась
охранник: охранника
обречен: обреченным
варшавск: офиса перекрыла
донос: доносившиеся
пут: имели
нос: игорь
сердечн: сердечного случился
обыск: провели убежище вежливо провести
активн: приглашен взялось пошел
моментальн: привести
вперед: шаг
медиапол: всплыл
ноч: ельцина
стабилизирова: мер
перекача: профессиональным
расчет: сложными
взира: молча
предвыборн: депутаты
систем: союза
выход: редко
кремл: позвали
строительств: изначально
персонаж: отрицательный
вкладыва: часть
варшавк: происходившее немалые
срочн: которым
трудов: математика индивидуальной
журналист: варшавке
узна: едва
кооперат: июля
выб: компании
государствен: запретило
окун: россиянам
отмеча: волны
отступа: собирается
частн: запрещенное
архив: достать
проезд: сделал стоимость
эмисс: начиная
путешеств: путешествия
привлечен: счет толпу
исчез: недействительными
агон: думаю
курс: ситуацию низкому
сообража: народ
ваучер: понесли
машин: сапогах
лидер: качестве
немедлен: требования
метод: знали
огоньк: журналист
процесс: активный
групп: группа
техник: техника
заказыва: внимания
требован: репрессии
хотел: очереди обменные
бесследн: складывалось
культур: культура
налог: огромные уплаты миллиардов
продолжа: ситуации революцию
букв: первым
обраща: поэтому
бесплатн: метро
помога: скрываться
рынк: становления
вечер: организации кавашкин
нрав: травлю
хищен: подозрению
помощ: обмен обещания
немал: вернуть
прекращ: паника
потерпел: выборах
вкладчик: вкладчиков джигарханяна вернутся обещая
напряжен: гасить
структурирован: параллельно
выступ: силой
выигра: выиграет прогореть
напрягл: напряглись
вкладчиц: обманутая
центробанк: апреле
жител: жители
сигнал: заседаниях
процентн: скрытые
финансирова: акционеров
маврод: мавроди
будущ: недалеком школе
запрещен: подался
лов: газете
прекрат: прочь полномочия
спокойн: москвы
словн: растворился
недалек: барыши
задержа: прибыль
калькулятор: расчетами
агрессивн: навязчивая
гувд: руководства
скупк: дальнейшую
средств: заработанные
панкин: вячеслава
лох: дремучих
мыльн: словно
силовик: минуты поразила
отключ: комментарии
борьб: отменял
отделен: количеством
спецпроект: спецпроекты
закон: конце
плох: тип
толп: разгонять структурированию сотрудников беспорядки
взаимн: собственную
зарегистрирова: мельникова попытался
рост: бурный
росс: россии россия
едв: парике
толк: сбила
процент: фантастические
четырех: аквариум
росл: забирать
мотор: мотор
допуст: справиться
извест: встретили
разорва: отбить
ринет: толпа
убед: успокоить
ситуац: стабилизировать предела сложившейся
фирм: стоит закрывать выручка
каза: требовали
выдвинул: зданием
счита: развития констатировал считал гением анишкин невиновности играть
отсутств: регулярное
причин: мнение
бизнесмен: отдельным
цел: истинной цель
трос: балкон
отлича: подобных
возбужден: конвоем
лент: лента понятно ленту
середин: середине
отменя: выборами
кажд: полками
руководител: документов
пикетирова: отправились
опечатк: ооо
шла: рассказал
абрамочкин: юрий
отсидк: выпустили
российск: компания
шосс: варшавском
гас: народу
микля: митинг
множеств: полу
циркулирова: голоса
параллельн: приступом
жильц: розыске свидетельству
аквариум: огромный
серьезн: располагала
прибыл: принести
использова: легально
билет: выпуск скидывать обзавелась
обруш: черномырдина
ваучерн: проводилась
юр: шоссе петербуржца
примерн: вечером
адреналин: выработки
годов: треть
сюд: несите
настоя: купить представителей настоящую
проспект: ломоносовском
сказа: скандала
ссср: ссср
знаком: занимал
будн: трудовые
след: стали посадили разошлись
дежур: разгона
институт: московский
организац: активисты организацией общественной
бюджет: годового
снежн: росла
заряд: настрой
поясня: платил
попыта: машков
клиент: работе
рыночн: переход
записыва: вечеру
цик: кандидатуры
ветера: опытные
так: вызвал усилий воды
вячесла: компаньон
предпринимательств: частное
недавн: громкие
течен: варшавки
оплат: наличных
мощн: устраивает
передела: приказ
заметн: заметно
добива: удавалось
назва: персонаж организация объединение старовойтова
тренировочн: старых
грузн: стоял
головн: обступили обыски
товар: производством
собира: головы энтомологии взялась
описыва: толпы
остановк: автобусной
инвестицион: чековый
формул: словам
скидыва: поняли
благополуч: основательность
джигарханя: театр
некотор: крупных
балкон: спустились
выработа: бессмысленно
игор: штурмуют
взаимоисключа: запустили
соглаша: курсу
удивительн: предвыборная
количеств: большим
ген: финансовым
попа: попал поддержку
остава: обеднели
выработк: процесс
поним: понимая
штурм: сотрудники ринется
спорт: спорт
специальн: прельщали
кредит: предоставления
барыш: солидные
друз: андрей
услов: лохов
разгон: варшавское
покрут: месяцев
закр: допустить
ознакомлен: тысячу
приход: суммах сказали
крах: ногами полному
помеша: офисе
тюремн: пересел
правильн: важно
милиц: отбивать
наступ: успел знал
покруч: жулики
поня: чувствительные
спрут: рабочей
народ: помощники вкладчик
компан: февраля государства позволили провокацию
рассказыва: государству
программ: развивать
выглядел: квартире
получа: сдаешь
главн: главное месте
действ: план
воздух: завтра
покида: оказалось
вошел: историю
фамил: буквам
велик: настолько
пят: продолжался
привел: бесплатным хватало
низк: предлагали
раскрут: критикуя
вовлечен: сферы
займ: пользуется
октябр: удивительно
рубеж: способом перекачал
втянул: втянула
зарубежн: продажу
стоя: ним убежден тишину желал
уклонен: обвинили
машиностроен: электронного
бзик: ошибаюсь
уверя: неинтересно
рад: местоположение
использ: клиентами
наблюдател: сторонним
пиар: смелая
созда: способные пузырь
ран: месяцами
объясня: сумму
ролик: рекламных сыгравшего
помн: насколько
паспорт: нашли
отдельн: инфляции рынка
стол: кровать
обманувш: кончилось
занов: начинать
протест: силу
благоразумн: благоразумно
выполн: задачу
интернет: интернет
московск: обычной поступил работы
помещен: заполнили
предельн: привлечь
бабочек: ловит
штаб: брать
основател: знаменитого
применя: прибывших
вячеслав: департамента
пришл: властям
полн: концов
полк: книжными
легенд: суммами
нескучн: реки
штан: тренировочных
достав: решили
реформ: обманывало правда
знал: спецслужб знакомых
сопротивля: аресте
привлека: старался
поставк: пору
комментар: окунев
привлекл: верхушка
сотрудник: отпущения рядовых тросах
невиновн: презумпция
приступ: приступа квартиру сердечный феврале
проч: ларечников руки
адрес: называл
компьютер: документами
решительн: произвола
работа: умел
сильн: впечатление
запрет: правительство форме больнице
долг: долг
машк: суда
долж: должен
репресс: попавшей
вызва: вызвали хотели арест
услуг: товаров
переориентирова: решил
театр: проспекте
необходим: создать
гко: раскрутили
числ: сославшись
гражда: деятельности
отошл: фамилий
бессмыслен: скупку
чумак: огонька
период: доходов
вниман: привлекать
найдут: обязательствам
присво: набрали
пойт: хотел
комнат: выглядела легенды
экономист: мать
понес: поверил
выйт: быстро
очеред: стоять
чита: миру
виде: видео
положен: мандат
обстановк: панкина
президентск: отсидел
явн: органами
оценива: рублей
счастлив: невыезде богатыми
оста: остался оценкам оставшись
быстр: потребуется
пластическ: никаких
прояв: известной
подозрен: задержали
спрос: делом задержания
депутат: наблюдателям нашего положенная
братк: братки
приватизацион: акций
вышел: вышел
бизнес: кстати занятию
тип: жуликоватый
взлет: взлете
воспринима: реформа
объединен: зарегистрировали
инцидент: фоне
выручк: апрель
бумаг: составленной
набра: проблем покрутили
реч: проиграли
реш: государственных причине полиции
накал: вновь
международн: федеральном
общ: выбиться
знаменит: узнал знаменитой
наживк: закинули
сбил: пушкова
энтомолог: бзик
обитан: обитания
аферист: назвали
поддержива: обязательств
рек: москва
серг: сергей
профессиональн: активных публикации
обм: формирование
стихл: стихли
материальн: провел
сред: среда
разгоня: пришлось
консьержк: бдительная
раис: вкладчица
распад: втрое
чувств: талантливый
мног: доход ухищрения
посвящен: правительства
расплачива: население
принес: деньгами
избежа: избежать
потреб: наступит
язык: чумаков
фон: банке
заместител: носов
фот: фото
обязательн: потеряно
происходя: нравилось
правд: реформах
закинул: удалось
огрызнул: рубеж
разн: ставили
коммерсант: коммерсанта акции
взял: отца полуэктов краха всерьез
завтр: приходите
скоротечн: пережила
люд: людей
компаньон: брат
год: пришелся
открыва: открывать
ставк: процентные
малыш: николай
набережн: набережной
особ: нии прилагая
создан: скорее
супруг: следующем
потеря: требовалось
разреша: граждан
лопнул: лопнула
звонок: звонок
вскрыт: вскрытию
ближ: силами
обессмерт: деньги
шумел: квартиры
производств: заниматься
любимц: народными
знает: плюсе
волн: первой
постара: эмэмэмщики
одн: одним
лестничн: лестничную
продаж: поставки
подл: контролируются
рит: париже
мат: монтажником
реклам: агрессивная чеки
настольк: экономике
приб: добиваться попросила
прилаг: называется
пода: начале
обращен: написали
улиц: вывели
свидетельств: комсомольском
действова: стало
масс: психологии
помощник: ждали
мвд: выиграть
склон: многих
массивн: массивной
плюс: небольшом
масл: подлил
подня: поднялись
стихийн: воспринималась
апрел: период обманутых
банкрот: банкротом
наличк: забитых
электрон: институт
участ: навар
тенев: участия
наличн: усугублялась
десятк: существовало включала
пятигорск: философ
глас: слуха
поскольк: выяснилось
произвол: милицейского назвала
кресл: депутатское
смотрел: огрызнулся
март: марта
песн: жизнеутверждающие
войт: войти
фрунзенск: фрунзенской
существова: вообще
расцвет: операции
фонд: инвестиционный
глав: покруче оцепили
глаз: закрывали
подпис: фиаско
деятельн: глаза трудовой
сраз: сразу
производ: голубкова
обвин: документы
секц: четырех
валентин: организатор
похож: жильцов
милиционер: дежурившие
ажиотаж: такого
ограблен: инсценировали
жела: рукам
располага: реальности пункте
гениальн: считаю просчитаны
новост: новости газета
избран: завершилась
существ: следствие
перв: предприниматель президента тогдашние названное
втро: выросла
чувствительн: самые
пермяк: рассказывал
раскус: жильца
полуноч: ближе
добр: деактивирована добра
написа: сбросе
изменен: значительные
прибыльн: переключились
равн: надежность устанавливается
позакрыва: спросил
ушел: ушел
привыкл: советские
повер: иван сюда
курирова: подобные
голов: горячие укладывались
отставк: срок
как: покупаешь
голос: борьбу
оптимизм: ложным
площадк: площадку
освобод: немедленно
прошл: отступать недавнего дни
заполн: запустить
рыночник: мелкий
реальн: происходили помню пожаловать
сосла: досрочно
втор: выбрал
обязательств: откажется выполнения
точн: возможно способности
пермяков: владимира
сфер: нескольких расширению
способ: найдут хирургическим
признан: зарабатывала
форм: резкой
взайм: имущество
мер: ряд
мет: метил
доказа: вина
залег: пространства
страст: погасить
парализова: фактически
жертв: мошенника
чувствова: воздухе
болгарк: болгаркой
конво: улицу
америк: южной
сталинк: сталинке сталинки
успел: задуманное
занят: склонных
накроет: скоро
вызов: игнорировал
конц: принятый конца привела
ждет: образованиями
презумпц: существует
окн: любуясь
конч: плохо пирамиду
предлага: агенты
милицейск: жертву
геро: любимцами
сброс: переделали
ольг: супруга
сдаеш: какое
проработа: специальности
появ: структуре сдаваться
жуликоват: похороны
возмущ: крайне
обеднел: одночасье
вернут: вернуться здания обязательно
предел: покидал накаленная
галин: госдумы
тщательн: финансировалась
пожертвован: добровольных
александр: александр
сапог: новых
иллюз: билетов
а: действовать
послед: валерий
утвержда: основателя властями
схем: незаконные
наканун: проекты
оперативник: оперативники подписал
вообщ: агония
москвич: восторг ленте
констатирова: кончил
спецназовц: открыть
преврат: главы дрожжах
давк: революции
валер: отмечал
основательн: поверили
коммерсантъ: журнал
х: х
филиал: десятки
поэт: книжку
отправ: решительные напряженность
дрожж: эмиссия
квартир: уверял штаб квартир выходил
двер: двери дверь
потолк: пола
кандидатур: выдвижение
голубк: леня
солидн: надежде
памят: памяти
мир: мир искали
испуг: легким
писа: инвест научил
выемк: помешать
обещ: ао
прописк: места
прекращен: объясняли
совершен: совершенно
внешност: сменил
организатор: профессиональный
орга: правоохранительные
скор: чувствовалось гениальность
нажм: опечатку
ива: рита
резк: гувд
феврал: коммерсантъ малышев
классическ: положено
выраз: оставалось
сообщен: пунктов
отдела: предпринимательство
получ: пытаются второе таки
власт: контактировать дом разгрому
начальник: заместителя
контактирова: принципиально
публик: успокоили
кудряв: штанах
перевод: риа
важн: рисковые
провел: офисах вероятно
облигац: выпуска
необычайн: скоротечный
передума: наживку
газет: статья писала
экономическ: экономических
рук: разводили прибрало плакаты
забира: повалил
час: пяти
внутр: внутрь
метр: столичном
отец: семье
раскр: следствием
сдава: держаться
грузовик: москву
прочест: публикациях
погас: смогло
могл: фирмы занялись
неприкосновен: депутату
ярк: отличала
подписк: сизо
сдат: версий
подписа: уверенно
кстат: работал
больш: накануне получил спрута ограбление
миллиард: начислено
мест: шагах первом
начин: облигаций
комсомольск: штурмовали
ждат: ждать
похорон: родителями
ммм: ммм
счет: арестовали дела
андр: шухера
предполож: предположил
акционер: соглашались обращение союзом
инженер: выучился
офис: головном центрального го головной
элитн: элитной
ждал: дней
игр: правил азартной вовлечению
лозунг: выдвинули
искушен: презентации
вынесл: налоговики
ясн: моменту
принудительн: доставить
пузыр: мыльный
пуга: перспективы
видет: видеть
устанавлива: курс
смогл: руководство
редк: деле
проходимц: верите
мягк: ради
редакциярекламаконтактыпресс: отключены
страшн: ужасная
организаторск: оргтехники
драматическ: наступила
департамент: начальника допрос
ухищрен: иные различными
жизн: жизни
козл: сделали
идт: полиция
игнорирова: поскольку
ухитр: отдельные
населен: работа долларами
актер: признанию
забит: потолка комнатах
инсценирова: ограбили
индивидуальн: закон
лиценз: отзыве
пыта: вкладчики формула возбужденная
бронирова: бронированной
вопрек: делать
момент: начались настоящему
пошл: обрушилась
многотысячн: многотысячной
приглаш: лидера
заседан: парламентских расширенное обыска обречена
мор: капля
хирургическ: внешность
принципиальн: соотечественников
развива: активно
митинг: компаний
основн: набраны
борис: выступил
вышл: вышли ясно
ларечник: рыночников
математик: инженера
единиц: единицы
отб: обеспокоились
скрыва: скрывался тщательно дачи
навар: испугом
сознан: превратил
привест: информацией
решен: помощи
мгновен: мгновенно
допрос: вызовы
создател: создатель
приватизац: ваучерная
провод: годы
всерьез: власть
средн: мужчина
задержан: районного
нужн: черномырдин считает
ужасн: пятигорский
отц: легко
советск: головах распада естественно
меня: постоянно
любу: вино
нужд: материальной
прозорлив: публику
наспех: говорилось
драгоцен: операциях
кардинальн: тв
беспорядк: перерастет
банковск: незаконной
полож: наличкой
рынок: неосвоенный
принест: могло
ломоносовск: прогресс
тасс: тасс
крик: раздались
богат: хотите
документ: выемке коробки изъяли
мечта: голубков
пересел: прочесть
чек: приватизационные
рассчитыв: средства
сопротивлен: сопротивления
фиаск: потерпел
выросл: проезда вячеслав
террорист: захвату
незаметн: незаметно
агент: сновавшие
розыск: международном
имел: теневики хвастал
мельников: ольга
возобновлен: заявив
указа: новостей
зачита: акционерам
состоя: суд
дач: менял
народн: расплачивалось вызвать
опрос: жуликом
мелк: игру
вряд: проценты
пожалова: добро
федоренк: владимир
формирован: взялся
деньг: большие платили
кинотеатр: здании
отказа: глава
брат: сферах прочую младший силовик передумала
пристав: приставам
наткнул: наткнулась
пошел: выразился
выдвижен: подписей
незван: незваных
изъя: обыск
старт: объявив
выуч: машиностроения
старш: таланты
ошиба: отделений
звук: звуки
добровольн: взаимных
оцеп: террористов
галер: галереи
границ: переводились
диван: лежал
рядов: отправили
незакон: использовать обвинению банковской
критику: выборы
вмест: ходили
финансов: финансовой вциом торговли несет
уход: границу
полиц: налоговой налоговая
зарабатыва: стол
покупа: предельно бюджета
увидел: вином
правительств: заседание прошло
позва: момента
настроен: структурирована
несет: валом
паден: падении
проследова: проследовали
жил: обману спокойно
имуществ: продали
уверен: держался
вал: взирало
ворва: ворвалась
стара: шумел
начал: проработал
заня: братья
писател: дневнике
руководств: федоренко сообщения
инфляц: спасти
укладыва: коммерсантов
итог: заработали
гиперинфляц: условиях
минут: налоговиков
дел: увидел америке выйти дело
рассказа: участвовал
игра: родители
вскор: вскоре
заверш: октябре
пришел: расцвет посвященное
размер: крупном
переход: банк
разойт: убедить
активист: основные
прельща: особо
проигра: взаймы
договарива: пути
обывател: скупился
москв: москве пределов ночью видами
никт: никто
усил: особых
пространств: публичного
совместительств: консьержка
развязк: драматическая
одночас: молчанием
срок: президентский
собствен: стране организовал
бутылок: множество
петербуржц: паспорт
лишен: лишенным
измен: бизнесом
следств: сделку выяснить защитить
держа: пожелания парламентарий сопротивлялся
уда: выполнить
бизнесм: отсутствие бизнесмен
отказыва: начали
август: записал
расширен: планы кремль
людьм: прогрессивными
чертановск: заседанием
смен: кардинально
смел: яркая
держател: взволновало
отношен: разорвать
омон: бойцов
иска: дно
куп: ельцин ваучеры
арест: зайцева состоялся поправился
район: заседания
ряд: общего выработало
причита: выплатят
сад: нескучного
последн: проекта
переключ: сомнительных
иракл: акциями
месяц: понес несколькими
досрочн: прекратили
охотн: проблемах
сам: самых самый соображает
автобусн: приступ
жми: жми
фантастическ: вкладчикам
организова: сдать
эмэмэмщик: необходимый предупредил срочно
школ: экономистом
подобн: ряда адрес
образован: негосударственными
называ: бывших обогатиться
вероятн: последние
выполнен: хотят иллюзия
гост: гостей
монтажник: отец
принят: изменил
нашл: обыске
хваста: долларов
записа: займами
складыва: появлялось
провокац: мощную
афер: аферу
начина: приходилось
очередн: прошлого
вер: будущем гко
популярн: популярных
неинтересн: покупал
мужчин: мужчины грузный
развод: сделать выглядят
сгинул: бесследно
достига: могла
кампан: пиар
сво: протестующим большинстве присвоили
всплыл: отсидки
утоп: компанию
нача: проблемы банки населением
специалист: сторону
перспектив: велик
перерастет: ситуация
лежа: развязка
россия: россиян
го: январе
значительн: ухитрились отставку
истин: калькуляторе соответствует
прода: знает
вяткин: искушение
виктор: председатель
азартн: относиться
взволнова: банка
мегафон: толпе
удава: бизнесменам
законч: закончив закончилось
настр: эмэмэмщикам
сведен: версии
развит: возможностей
спаст: рассчитывая
представ: представить
переж: пирамиде
контрол: вышла
соотечественник: наших
инвест: фонд
происход: описывал привлечения
задач: ухищрениями
обществен: управляемой
выясн: поясняла относительно
трех: примерно
различн: оптимизмом избранием
окруж: окружил
хвата: оплату
трет: имел
утвержд: руками
сомнительн: отошли
ценност: ценности
сегодняшн: дня
работяг: простой
указ: закрытии
задума: реализовывать реализовать
ел: книги
вин: шампанским стражей пил
поправ: пиццу
истор: обессмертил
парламентск: бизнесмена
ход: портретом
спеш: спешил
спец: спецов
пробл: решении
закрыва: мвд омон
сем: московской российская
понесл: охотно
психолог: языке специалиста
подельник: держателей
уйт: бедствие
легк: говорили отделался
мошенник: сознании мошенником
представител: крыша зачитал
негосударствен: разъяснить
вид: окно
умел: той
налоговик: работу следом
начисл: идти
умер: умер
дно: залег
защит: должна
внов: компьютер
доход: рост получаешь
красн: перевернула
науч: кое
естествен: дмитрий
жизнеутвержда: разные
ельцин: борис указом
нескольк: услуг москвичей
депутатск: шконки
реальност: благополучие
обеща: сегодняшнего
наук: наука точным
лавин: снежная
зайцев: юрия
прогресс: кинотеатра
разда: выполнению
хот: органы пермяков
дне: течение
эпох: представитель
сумм: речь свободными большую
предоставлен: отказываться
крыш: ушла
гробов: известие
дни: следующие
дом: машине пойти купит
кавашкин: получить
способн: проявил песни
известн: будущий известный
структурирова: прекращена
горяч: ажиотажа
сторон: привлекла происходящее
предостав: новой
обмен: приступил заново позакрывали
поддержк: крики
хорон: запретил
остальн: скрывалось
призна: цик
тысяч: оценивалась равным
тогдашн: разгромом
дня: строительство
хорош: хорошие
стоимост: ранее
перекр: трех
пуст: пусть
пушков: раиса
подъезд: подъезд вынесли
невыезд: подписку
базар: билеты
плакат: появились
приплачива: явно
ин: ставки
наш: спасем считали
обвинен: арестован
недействительн: признали
обман: привыкли
сыгра: пермякова
полуэкт: валентин
успешн: настроения предоставил
плат: платить выплатам произволом фирма
сиз: отпустили
откажет: члены
большинств: обыватели
сил: применять своими открылись
трешк: съемной
план: вынашивал разрабатывали
разрабатыва: принудительно
доллар: рублями достигать
публичн: исчез
арестова: пожертвований налогов
регулярн: числе
информац: ознакомление редакциярекламаконтактыпресс изменения
восторг: привел
больниц: скончался
приказ: скандальный
выгляд: обещанные
прогрессивн: считались
распоряд: руководители
разгр: давке
скрыт: используют
философ: уйти
россиян: должны
дневник: августа
сканда: платила
спуст: спецназовцы
объяв: центробанк медиаполе
требова: возмущены целью
паник: страсти
берет: учреждений
ко: приплачивал
младш: игры
закрыт: гласил
отбива: собирались
книжн: забитые
спас: лозунг
скандальн: временем
выбива: выбивать
книжк: оперативникам
вынашива: июне
оргтехник: зарубежной
контролир: успешно
никола: интересная
забот: забота
запуст: союз распорядились
презентац: нужде
понятн: прибыли
успоко: масс подельники
надежд: кассу
соответств: кресло
президент: стояли президенты
попрос: подкрепление
приеха: приехали
председател: утопили
акц: торговля обмену означало порой
сми: сми
огромн: каждой берет
надежн: верил
молчан: гробовым
польз: налоги
страж: держать
увлеч: постарались
вод: сухим
союз: фирму советского названная
ми: лихими
стран: страну страны всей оказалась
вол: волю
штурмова: милиции силовики
январ: января деятельность
отпущен: козла
отсидел: сада
портрет: билетами
громк: архива
южн: бабочек
включа: система
местн: местные
рисков: вкладывали
качеств: остальных
пил: ел
молч: действий
предпринимател: чохонелидзе успешному
столичн: проезд
выбор: нужны зарегистрироваться очередными
мандат: счастливый
избира: избирался
государств: лица проходимцу стабильность договариваться
наскольк: накроется
ни: будни
разошл: полуночи
налогов: смотрела департамент
проблем: знавшие утверждал
чеков: появился
опытн: помогали
намерен: эмэмэмщиков
заяв: огонь
пицц: заказывал
ограб: реально
чохонелидз: ираклий
владимир: акционеры актера
прогорет: пришел
управля: психологов
орган: правоохранительных правоохранительными
матросск: пикетировать
небольш: итоге
нес: счастливыми
дума: собирал
относ: правильно
сконча: остановке
операц: финансовые похоже пластических незаконных
уплат: уклонении
талантлив: сильный
навязчив: шла
крайн: офис
оо: информация
возможн: предпринимателю вряд
интересн: страшно
дальн: продолжать
жулик: доказана аферистом
разъясн: нужным
огон: масла
коробк: подъезда
выбра: схемы
скуп: рекламу
обещан: получением вопреки
старовойтов: галина
подкат: подкатили
крупн: металлами государством десятков
все: филиалов
дмитр: москвич
пораз: обстановка
меша: спросили
обреч: краху
тюрьм: тюрьмы тюрьму
накален: казалось
серге: сергея
бойц: привлечением
бедств: стихийное
котировок: снижение
выпуск: уходили программы
отпуст: истине
отрицательн: вошел
прежд: стоившая
бывш: считается впереди бывший
вороча: ворочал
талант: организаторские талантов
стабильн: жили
изначальн: планировал
выпуст: страна
бдительн: раскусила
становлен: гиперинфляции
наверняк: выплаты
яковл: яковлев
откр: отказался пункты
миллион: миллионы миллионам миллионами
июл: советских
юмор: чувством
выплат: реальные благодаря прекращение грузовиков
июн: отношения
захват: захвата операцию
ри: абрамочкин
наход: делал
революц: народную моментальной
учрежден: финансовых
никак: прописки
пожелан: освободить
ctrl: ctrl
enter: enter
