ру: ру
говор: говорится
влиян: оценили влиянием
студентк: похудения
понима: разведчики
образ: образом
стат: статьи
воен: военного военных военной
мобилизац: мобилизация
обычн: обычную
европейск: европейских
федеральн: федеральное
служ: служит
стал: стали стало
мнен: мнению
объясн: попытки
соглас: согласиться согласился
опровергнув: недостоверности
северн: северной
успех: успехов
случа: случае
эмиратск: фигурирующие
удал: пришлось
последств: ошибаться последствий
работ: работе
центр: заведующий
удар: смертям
сценар: сценарии
доступ: доступ
вернут: вернуться
возглав: возглавило
арх: архив
экономик: экономике экономика
предел: пределами
мид: академии
конфликт: конфликте конфликт конфликта
тщательн: тщательно
сто: стоит
недовер: недоверия сократится
манхэттен: жилья
утвержда: утверждается
видеоигр: видеоиграм
вооружен: вооруженных вооружений
каса: касающиеся
спецназовц: спецназовцев
разговор: разговор
арм: армии
дезинформац: целью
личност: раскрыли
противовоздушн: противовоздушной
структур: структуры
суд: судя суд
карт: карты
попрост: службы
подел: поделился поделиться
сообщ: сообщил
отправ: отправила
благодар: благодаря
котор: которым
мир: мир мире
укол: популярных
силов: силовые
секретн: секретная секретной секретных секретные
запад: запада
расистск: расистским
отредактирова: отредактированы
забудут: избиратели
назначен: назначения
исследован: глобальных
отнесл: опубликованным
обсужда: обсуждают обсуждали
совершен: совершенно
связа: связанных
прав: чиновник
опроверг: лентой
спецслужб: российским
подписыва: дня
вовс: сведений
скор: скорую скорее
нажм: опечатку
резк: обмен
удаст: удастся
феврал: февралем
оон: оон
присматрива: присматривается
дела: украинских
боев: боевых боевым боевыми
вброс: намеренным
власт: властей власти
получ: получил
причастн: причастность
дискусс: дискуссиях
фронт: фронт ситуацию
верс: версии
важн: важной пару
разведчик: разведчиков известны
байд: байден рейтинги
газет: газеты
мигер: крис
рук: руку
украин: украиной украины украину украине кулеба
националист: националисты
чат: чата чате
гранат: соседа
разведок: разведок
союзник: надежным союзниками
раскр: отключены
подлин: подлинные
шанс: байдена
выстав: ракеты
военачальник: военачальников
лин: линии
россиянин: болезни
сосед: бросил
проверк: проверку
позиц: позициями
постро: построили
могл: могли могла
планирова: планировал
перехвачен: перехваченный
недостоверн: планов
украинц: украинцы
очевидн: очевидно
нов: новые нового новой
мест: слабые
част: часть
предоставл: предоставлен
дипломатическ: отношений
подделк: вовсе
опубликова: опубликованы опубликованной думают многие
предполож: рябков
слов: козюлинзаведующий
дональд: дональду
перевернут: перевернуть
якоб: якобы
предположительн: предположительно
сдела: сделанные
существен: существенных
эффективн: оценил
видет: видеть
деактивирова: нажмите
минимизирова: объясниться
министерств: министерство
редакциярекламаконтактыпресс: музыки
представлен: успешности
арабск: арабскими
пут: путем
активн: активно активные
жизн: жизни
кит: китая
ноч: ночь
фигурир: фигурируют заявили
выход: выходить
кремл: дезинформации
сокращен: сокращению
шварцма: валентина
пекин: пекин
государствен: государственных
момент: моменту
отмеча: американские
американц: представлениях
основн: основной
путешеств: путешествия
южнокорейск: южнокорейских
подсчет: подсчетам
бесед: анонимности
сша: сша
ресурс: ресурсы
лидер: лидер лидера
групп: группы
произошедш: произошедшего произошедшее
техник: техника
приведен: опровергнув
информатор: удар
привест: привести
напрот: напротив
утечк: утечку утечке утечка утечки
приведет: приведет
смещен: смещения
культур: культура
боеприпас: покупке
продолжа: продолжают украина
личн: продажу
смерт: признал смерти
чиновник: эмиратский
превентивн: превентивной
помоч: оаэ
насторожен: отнеслись
опаса: вашингтоне
скажет: негативно
вылож: личность
неизвестн: неизвестно
батальон: батальона
немал: отразиться
врач: представителей
слайд: слайды
летальн: летальных
попытк: отношениях
ведомств: ведомства ведомство ведомств
опасн: опасных
ракетн: ракетной
крис: представитель
документ: документы документов документах документе документ документами
предложен: предложенной
гутерриш: гутерриша
оправдыва: оправдываются
эмират: эмиратами
опровергл: египта
агрессивн: агрессивно
расследован: расследование расследований расследования
дан: неверные данным
контрнаступлен: планируемом контрнаступления
отключ: комментарии
весьм: весьма
борьб: борьбе
следовател: следователи
спецпроект: спецпроекты
слит: слитых слитые
раскрыт: рекорд
джек: джек
рост: росте
росс: россии россия
фбр: фбр
сократ: сократило резко
гиперзвуков: китаем
египет: египет
камен: камень
угрожа: ним
вашингтон: разведданных
мотор: мотор
слив: кризисом ущерб
вряд: скандал
кор: кореи
ситуац: влияние
пожалова: добро
соединен: соединенных
опроверга: опровергают
счита: продолжает считает считают
брифинг: брифингов
цел: вбросом
очк: умных
лент: беседе ленту лента важно
сообща: сообщает сообщалось сообщается
мирн: мирных мирные
завед: инцидент
эскалац: эскалации
ошиба: попросту
руководител: руководитель руководители
опечатк: нашли
пройд: пройдены
галер: галереи
оцен: очков врач
российск: российских помочь российской
глобальн: центром
всеполитикаобществопроисшествияконфликтыпреступн: всеполитикаобществопроисшествияконфликтыпреступность
внешнеполитическ: внешнеполитического
взаимодейств: взаимодействии
минимум: минимум
достич: достичь
идут: идут
иностра: иностранных
кулеб: дмитрий
обнов: манхэттене
правительств: правительства
неверн: опровергли
серьезн: опасаются
вад: мид
жил: аренды
твердотопливн: твердотопливных
разведывательн: разведывательном
руководств: руководства
бюр: бюро
маловероятн: маловероятными
путин: путина
медиа: подозреваемого
настоя: настоящему
ссср: ссср
засекречен: засекреченные засекреченных засекреченными
отраз: серьезно
след: следят следует
разведда: американских разведданные
рассказа: рассказал
внутрен: внутренних внутреннюю
порц: порции
так: таким
москв: москве
геймер: геймеров
никт: никто
полност: полностью
усил: усилия
несмотр: несмотря
ллойд: ллойд
остин: остин
развязк: развязке
событ: событий событие
покупк: планах
срок: раскрыты
собствен: собственное собственными
баз: базе
планируем: планируемого приведенные
измен: изменены
мощн: угрожает
джо: джо
усилен: усиленным
британск: спецслужбам
территор: территории
назва: кремле
посыла: посылают
материал: материалах материалам материалы
типограф: типографий
описыва: описывается
смен: смене
аналитик: аналитиков аналитики
возрастет: недоверие
некотор: некоторое некоторые некоторым
отношен: отношения скажется международных
потенциальн: потенциальным
ад: ад
аз: азов азии
отреагирова: отреагировали
количеств: количество
служб: подделка
собеседник: собеседникам
попа: попали попавших
кита: испытании
ввс: ввс
спорт: спорт
содержат: содержатся
специальн: специального
последн: последние
втайн: втайне
месяц: месяцев
сам: самых
набира: набирает
жми: жми
друг: другом другими
израил: израиля
подключен: подключенной
ошибочн: отмечают
переда: передает
предпринима: предпринимают
тайн: тайно
сомнева: сомневаются
подобн: подобной
вероятн: вероятно
программ: программы
ира: иран
главн: главное
действ: действий действиям действиями
хваста: хвастаются
нашл: ооо
разведслужб: разведслужба информаторов
рас: раса
избирател: поскольку
вел: вел
зарубежн: зарубежных
состоян: немалая
козюлинзавед: делается
западн: западных западного
популярн: эффективность
сотрудничеств: сотрудничестве
смертельн: язык
инициирова: инициировал
изуч: изучило
пентагон: пентагона пентагон
достига: достигать
сво: своим
нача: начаться начало
протест: протесты
специалист: словам
слаб: понимать
передач: передачу
академ: дипломатической
интернет: интернет
значительн: значительная
оруж: оружию оружие оружия
исключа: исключают
пообеща: пообещал
рекорд: обновила
вслед: вслед
тем: теме
официальн: официальном
великобритан: великобритания великобритании
сведен: интересным ошибочность
нетаньях: нетаньяху
пришл: студентке
развит: развития развитие
уголовн: уголовное
фотограф: фотографии
реформ: реформы
биньямин: биньямина
знал: знал
файл: файлов файле
поставк: поставкам
штат: штата штатов
комментар: шварцман
зеленск: зеленского
сотрудник: сотрудников
датирова: датированным
проч: прочего
юстиц: юстиции
истощ: истощены
сильн: слива
ценност: ценности
подразделен: подразделении
пар: забудут
посвящ: посвящен посвящена
числ: число
зовут: зовут
истор: истории
ход: ход ходе
подозрева: арестовало
исследова: исследовать
факт: факту
кризис: мощнейшим
призыва: призывала
автор: авторы авторов
налад: наладить
сет: сеть сети
представител: личные представители состоянию
конфиденциальн: конфиденциальные
виде: видео
красн: красные
козюлин: козюлин
оаэ: информацию
нескольк: нескольких
ущерб: минимизировать
договор: договорились
наук: наука
дне: дней
объединен: объединенными
инцидент: инцидента сильно
рейтинг: вряд
известн: опубликованных известно
генеральн: генерального
международн: исследований
общ: общее
окончан: окончанию
затягиван: затягивание
постав: поставить
указыва: указывается
остальн: остальными
обитан: обитания
любов: любовь
недел: недель
призна: мигер признали признают
тысяч: тысячи
включ: включая
дня: ленте
серг: министра
хорош: хорошие
обм: вадим
стоимост: медианная
серб: сербия египте
анонимн: правах
сред: среда среди
нац: нация
оборот: обороты
оборон: обороны оборонное оборонного
суммарн: суммарное
пользовател: пользователей
мног: специалиста
успешн: возрастет
обзванива: обзванивают
похуден: уколов
компонент: компонентов
избежа: избежать
язык: удалить
сил: сил
умн: выпуска
заместител: настороженно
план: планы никаких сведения
неофициальн: неофициальный
фот: фото
содержа: содержались
тегеран: тегераном
поспеш: сербии
арестова: выложившего
нат: нато
гроз: грозит
информац: информацией информация информации опроверг
поставля: поставлять
призыв: призыва
негативн: попадание
моссад: моссад
видим: видимости
анализ: анализ
замет: заметили
сканда: места
министр: министр заместитель
потеря: потерять
собра: собрала
трамп: трампу
близ: близится
привод: приводятся
антон: антониу
производств: производства
например: например
предстоя: шансы
одн: одна одном
продаж: выставил продаже
отправля: отправляет
широк: широко
нацгвард: нацгвардии
коллег: коллег
забот: забота
секретар: секретаря
масс: массе
президент: президент президента
поставок: поставок
распространя: распространяться
сми: сми
доклад: доклада
смоделирова: смоделировали
надежн: считать
объединя: объединяла
ма: мая
нидерланд: нидерланды
музык: громкой
апрел: апреля
обнародова: обнародованных
стран: странами страна страны стран стране
участ: участие участия
аренд: стоимость
уровн: уровне
платформ: платформе
поскольк: выборах
громк: гранатой
местн: местные
рябк: сергей
укреплен: укреплению
март: марта мартом
испытан: фронте
войт: войти
качеств: качестве
состав: составило
выбор: предстоящих
государств: государство
правительствен: правительственной
валентин: подписывайтесь
проблем: проблемы
подробн: подробности
печата: печатавшей
тейшейр: тейшейру тейшейра
намерен: предположил
заяв: данные поспешили заявил
болезн: смертельной
украинск: американцев украинской
ракет: ракет гиперзвуковой
новост: новости
владимир: владимира
латв: латвия
дума: слив
близк: близких
маркирова: маркированы
добр: деактивирована добра
крайн: крайне
попадан: разведслужб
оо: редакциярекламаконтактыпресс
возможн: возможности возможной возможного
поиск: поисках
интересн: назвали
дальн: дальнейшему
уйдет: уйдет
политолог: политолог
всу: всу
франц: франция
американск: британскими союзником последствия американская
брос: россиянин
массачусетс: массачусетс
как: какие
участник: участники
сот: сотен
крупн: крупные крупных
все: всей
дмитр: контрнаступлении
содерж: содержится
судебн: судебной
герман: германия
повлия: повлияет
кат: катится
рассматрива: рассматривают
переговор: переговоров переговоры
тюрьм: тюрьмы
выпуск: сроки
оппонент: оппонентами
бывш: бывший
реальн: пожаловать
точн: точное
партнер: партнеров
шпион: шпионят
мем: мемам
разведк: разведка разведками
мер: меры
наход: находятся
египт: американскими боеприпасов
потер: потери
никак: заявить
источник: источника
hockstein: hockstein
ctrl: ctrl
appl: apple
telegram: telegram
libko: libkos
evelyn: evelyn
jonathan: jonathan
ap: ap
reuter: reuters
twitter: twitter
discord: discord
killnet: killnet
york: york
drake: drake
time: times
enter: enter
press: press
chan: chan
