встал: встала
случ: однокашниками
ру: ру
говор: пользу говорить нагляднее
пнд: пнд
впоследств: начато
понима: понимал понимали
фактическ: фактически
лев: экономику активизировалось обвинил
значен: имеет
стат: статьи приговаривают перспективе опубликовал
обычн: обычную
стар: включая переселения
инвестор: иностранным потенциальных
рискова: невыгодно
рабоч: рабочие
стал: стало преобразований
перееха: процент
мнен: заводы
объясн: действующая
северн: новостройки
един: единой единую появилась
чанг: инициативе
центр: центра центром мировых центр
работ: хорошей работу помешать планомерная
общепринят: существование
показыва: многолетняя
север: коммунистический
арх: архив
экономик: экономика экономики вмешательство
правов: решений
получен: получение заподозренного
малайзийц: фактор отношении столкновения
инфраструктур: улучшал инфраструктура
учебн: школах
высад: высадилась
нефтеперерабатыва: открытия
человек: малайзийцами
ипотек: гражданам
преобража: преображаться
пункт: пункт
каса: стереотипы
арм: армии
то: устают
ветх: переехало
морск: северного
проголосова: радикальное
должн: должны имеющей
структур: структуры
суд: сша
скопирова: формально
студент: насчитывалось студентом
человеческ: индексе
жестк: тюрьмах продемонстрировал эффективна
благодар: благодаря
назван: модели
котор: которую направлением бюро
несл: схемах
провест: распустить
времен: морского
неподкупн: равенство самыми
законодательн: обсуждалось взять
силов: силовые
благ: базовым сделано всеобщего
запад: запада
вест: указывая
прав: права право
связа: мерами
участвова: продолжал
природн: природных природными богатые
географическ: говорило
вовс: языках
либ: либо
проект: шелковый реализация инфраструктурные проекта
недовольн: западных
вперв: впервые
совместн: модель
нефтепереработк: центров
обита: обитало
опас: влияние
дела: разнообразие утверждаю
часов: удобном
сцен: убирать
суш: кусочке
комфортабельн: удобств
верн: преступности
полага: сумский срок быстрого
обеспоко: всерьез
вывел: вывел
позитивн: противовес
исключен: проголосовал
ископа: полезных
член: сохранил
защ: защите
устраива: устраивали
увеличива: ежегодно
прост: выбор
врем: времена
лин: линии
альтернатив: сделает
позвол: система преуспел оппонентов
обвиня: родственников
сосед: нападок
занима: развитию занимался
свободн: наличие
равенств: реальность наказания
конвертирова: симпатии
постро: чанги правовое
зар: дисциплина
усугубля: напряжение
встреч: встреча населения
крепост: крепость
справедлив: считаю
лиц: уникального
родин: родине
сетлментс: сетлментс
заработа: нашел
встрет: реформы
полномоч: неограниченными неограниченные
уровен: реформе
полуостр: разделившей
нов: каналу создать дал
внешн: внешней
панъевразийск: проект
сверш: сингапурское
медийн: клевете
приговор: семьей
част: части большая
отбор: серьезный
сокрыт: штрафы
слож: ломая
завоз: приходилось
устро: совместного
опубликова: гибсон
осво: освоил
слов: свобода описать объяснил
журна: американский
клубок: буддизм
недвижим: покупки
завод: фабрики нефтеперерабатывающих
перерабатыва: добывать
привнес: финансирование
дворц: вестминстерского
системн: многопартийность
сдела: стратегия правильным сделать временем
феном: наоборот
деактивирова: нажмите
нпз: заводов
сложн: компаниями
родител: родители
фигур: той
пут: путь пути путей
примен: применить
символическ: выполняет
активн: активно
пример: полупроводников системой
упорн: лидера
превыс: населении
торговц: торговцы
распростран: мер
колониальн: колониальной колониальная колониального
расположен: географическое
систем: стабильной авторитарной основанных созданная
выход: выходе
строительств: программу карьеры
должност: конкурс преподавательские рисковать
класс: класса трех привилегированным
озеленен: пространства
журналист: радио
неизмен: схожих
государствен: парламентская принципах поставив
отмеча: отмечает
оккупац: оккупации
торгов: основных
выж: погибнуть
труд: результатах труда
трудн: стояла
путешеств: путешествия
закреп: закрепили
привлечен: задачей
законодател: заманиванием
автоном: автономии
курс: курса неолиберальный
облада: деле
ресурс: ресурсами важнейшим ресурсов природные
сша: восьми
лидер: лучшее выборы появится лидером лидеров подчинение
метод: авторитарными любые
процесс: идет долларов
аппарат: подключили
техник: техника
надолг: надолго
окружа: равны
европ: поясе соединяющим
сингапурц: сингапурцы сингапурцев сингапурцах позволяло
культур: культура культурой
граффит: резинка
налог: освободили
комфортн: климат
продолжа: тонга
бойкотирова: решила
расстановк: повлияло
подряд: государстве
вспомин: вспоминая
бесплатн: бесплатно
помога: помогал
госслужа: зарплат
рынк: свободного бум
продвижен: левых
демарш: органами
бюрократическ: долгой
жевательн: запрещены
современ: старого
немал: популярность
наставник: роли
напряжен: усилило межэтническое
климат: деловой
выступ: выступая
попытк: заподозрили неубедительные наркотиков
лом: преодолевать
старост: старости
тонг: чок
умерен: умеренного
жител: жителям
показател: обходя
товарн: валютной
одержа: одержал одержала
будущ: будущий будущего новое
наоборот: целом
соединя: коридором
единожд: таких
шир: ширилось
грамотн: грамотном
сын: старшин сына
нацел: нацелен
интерес: национального приоритет
инвестиц: принять иностранных
штраф: огромные грозил жесткая
средств: людям краже
арен: расширить
свобод: должностями ограничил свобод ряда некоторые
сравнен: сравнении
дисциплин: триллиона общества
отключ: комментарии
борьб: усилия борьбе решением
коммунист: опасаясь
отделен: демократии
минимальн: десятке
спецпроект: спецпроекты
закон: закон зарубежный равенством
осуществля: наказание
неокрепш: коммунисты
рост: рост вывести ростом
казн: смертная смертной
росс: россии россия
едв: чиновниками
процент: низкий
росл: повышали
преуспел: словом
мотор: мотор
убед: способ
имеет: гонконг
фирм: последовали
счита: считалось джентльмен считал преподаватели существованию
исправительн: использование
причин: причин
прибыва: прибывать
стимулирова: всячески
взятк: даче
бизнесмен: рубежом
цел: цели личными всей
цен: высокую
лент: лента ленту
мирн: объявил
кажд: заинтересованности результаты рождается
финансирован: увеличил
наркотик: контрабанду
опечатк: нашли
педагог: западные
эл: элит
российск: проекты
индийц: индийцам
рожда: вырабатывалась
канал: суэцкому
политическ: сингапурскими разные политических политической политическую предполагала недовольных
коммерческ: бизнесом
разорен: швейцарию
искусствен: аппарату
администрац: администрацией
иностра: позволило привлечение привлекательные представлены лучших
формиру: добивается
лейкок: лейкок
всяк: прочны
поездк: средств
юг: демократический юго
предсмертн: сотни
бирж: сингапурская
налич: предполагающий
серьезн: повысили
частност: блага
использова: полной
погибнут: прост
юн: юных
стратег: законы
уточня: менялись
достаточн: процветающего
примерн: увеличивался
блестя: блестящим
реновац: процесс
професс: должности
самоуправлен: самоуправление
ссср: ссср
кабинет: кабинет
наглядн: трудов
слез: слез
повыша: годом
лун: сянь
след: поддержку
нашел: ископаемых
организац: организациями
отнын: отныне
невозможн: невозможно
юрист: юрист
концепц: стала
помим: соседней
статус: статус социального
выслушива: стоять
коротк: жилья
зелен: элегантной
так: компаний соратников
одобря: работа
сян: занял
соратник: старых невиновность
назнач: меритократии
капитал: увеличении
шанха: токио
кабмин: поручению старшего
удовлетворен: связанными
добива: упорно добиваться
капитуляц: капитуляцией
назва: назвали назвал общественной
содружеств: содружества
товар: товаров
привлекательн: максимально прибавляло
авторитарн: построил комбинация свершилось
некотор: некоторой окрепшей
предпочита: предпочитали
гибсон: уильям
благополуч: оставалось
потенциальн: глазах
океан: океании
обуча: школьников
адвокатск: адвокатских
соглашен: соглашение
полез: полезен
увлека: увлекались
благородн: написал
микроэлектроник: прорыв
попа: высокопоставленных
остава: оставалась главной оставался
пересечен: расположенного
богатств: богатству
спорт: спорт
шок: шоком
специальн: создали инвестиций
искоренен: процессе
бедност: бедности
сетова: сетовал
небывал: небывалым
услов: условиях условий бизнеса
представля: представлял
стро: политическим
стереотип: сложившиеся
голода: голодали
друг: другими
приход: воду
тюремн: метро
помеша: движения
правильн: делал
ментор: годах
активизирова: победы
поня: сингапуром
краж: партнера
народ: народов народу
подчинен: менталитета
менеджер: топ
компан: нефтедобывающих иностранными компанию развиваться компании
рассказыва: рассказывал
степен: немалой
программ: учебной индивидуальной программа развернули
ограничен: личностью рынка
неграмотн: вовсе
получа: стабильно
главн: главным роста скончался главное слова соперничество
разбира: разбирается
делов: деловым особняка мнению
действ: действия дает коррупционном
обеспечива: работой
пят: вышла
низк: ипотеку
избирател: избирателями голоса
имидж: улучшении
элемент: объединяющего внедрив
стратегическ: маленьком
инициатив: инфраструктуру
рубеж: финансируемые продолжить
состоян: состоянии
зарубежн: привлекало местных
стоя: чудом больно
игрок: крупным
плотн: закручивался
отдел: отделиться
коррупцион: участие информации
индустриальн: бедный
рад: свободой телевидением
бедн: масштабные бедную
похищен: попытку
раффлз: раффлз раффлза
созда: политики факт торговых могла
имеющ: главой
ран: ран
объясня: многом
отдельн: отдельной
процвета: процветающее построение процветали процветающей большинстве процветал
зарплат: зарплаты повышение получая составляет
муниципальн: муниципальных
нелегк: нелегкой
сохранен: поддерживают заботился
интернет: интернет
реализац: языками азию
учител: профессия
резинк: жевательная
амбициозн: амбициозный
траур: семидневный
приличн: приличную
колоссальн: поистине
сработа: факторы
основател: основателей
официальн: трость
великобритан: великобританию великобритания великобритании
пришл: законодателям
полн: обрел орган рынке
начальн: начальное
госпитал: главном
десят: размере
реформ: проводить успешных реформ образовательную
знан: знания
взяток: ради
привлека: сложно
коррупц: коррупцией искоренения
комментар: возможности
руководству: решено
рамк: рамках
запрещ: например
рыбацк: рыбацких
сотрудник: сотрудник корпораций преступлений
невиновн: доказать
перанакан: перанаканами
сочетан: ресурсы
сильн: сильно сильной
работа: нефтепереработки работать
запрет: внутреннюю
долг: долгие легко
долж: налогов
прор: технологический
вызва: вызвало
десятилет: десятилетия
сотруднич: сотрудничая
оставля: левые
подтолкнул: подтолкнул
агломерац: агломерацией
подвел: подвел
необходим: необходимостью работе выжить феномен
преподаван: программы
числ: последующие несли развитие
гражда: граждан
евре: евреями
перекус: граффити
период: период
чист: офиса
модел: государственной предложить
клуб: мид
кризис: кризиса
раскритикова: лидеры
сложност: общей
оглядыва: оглядываться
демократическ: вестминстерская демократического север
пойт: шанс
посредств: осуществляется
восьм: выросли
снижа: полагая
сдержа: сдержать
гласност: предать
виде: видео
остр: остров больницу
наихудш: наихудшей
подрыва: подлинной
стэмфорд: стэмфорда
объявл: госпитале
положен: национальности положение
подход: средней своем
ротангов: ударов
ингредиент: ингредиентов
процветан: процветанию
счастлив: богаче назвать
оста: аэропорт
кодекс: уголовного
быстр: возможно методы
симпат: квартиры
вырабатыва: корректировались
взяточничеств: кумовство
эксперт: ведущий
депутат: депутатом
виновн: действии
бизнес: надзор иностранного открыть
принима: принимать
правя: политиков
предмет: интересные
разреш: точке
объединен: закончились
печа: печали
удобств: строений
контрабанд: терроризм
реш: решил опрометчиво взяточничество
многолетн: проектов
прозяба: прозябал
гарр: гарри
международн: стабильную
общ: университетах
объ: сработала
окрепш: развивающейся
поконч: ван
полаг: сохранение
профсоюзн: профсоюзными
защища: международной
страдан: страдания
обитан: обитания
поддержива: критиковали крыло похищения
востоковед: уверена
включ: министров
культурн: культурной
азиатск: черта азиатскую небольшой
удобн: находится
сред: окружающей среда
разбирательств: разбирательствах
социальн: клубок вне
распад: распада
устойчив: примеры
хакк: хакка
погибл: человека
мног: привнес успех проводимые
индонез: поездки
уста: граждане
зависим: зависимости зависимость
люб: хватались обыскивать прагматиком
способствова: степени
язык: языки языке разных языком минимум
проконтролирова: стабильность
обязательн: вторым
стил: авторитарного
фактор: религиозный ставку сочетание
критикова: журналистов
взят: места
разн: существовали велось
взял: взял
нападок: защищала
соседн: завозить
планет: безопасных
взяв: сингапурскому
люд: людей дать
создав: потрудиться
разб: амбиции
год: годы сын половиной каждым начиная
клевет: обвинить
расколот: попытке
принадлежн: этнической
открыва: факторов
министр: министра непростой министр тюрьму министром
малайзийск: малайзийского малайзийскими негодованием малайзийские малайзийским
неизбежн: принципами
ставк: сделал
астафьевавостоковед: сингапурской
создан: строительство консолидация
контор: контор
неограничен: имело обладал
методист: педагоги
избега: вести
производств: открыла
знает: никто
одн: плотнее чиновники одним
индск: индской
задержива: имели
согласн: ним
настольк: выборам
пода: посту
гаван: надежная
столиц: столицей наркотической
наркотическ: репутацию
улич: буна
вестминстерск: получила элементы методами
выпускник: неграмотными
ток: игрокам
ведущ: сингапурских
медиакорп: газетами
насчитыва: вырос
объединя: качестве
огранич: частности существенно
материнск: материнской
врод: вроде
уникальн: сохранении
участ: ответственность
привилегирова: считаются
десятк: десятки держится входит десятков
использован: ввел
регион: регионами регионе столицы
поскольк: участвовать
войн: корейской войны
сентябр: сентября сентябрь
март: марта
войт: войти
существова: напоминает
глав: главы руках лично системе
топ: уровне
присутствова: должна
состав: исключение составил составе
глаз: привлекательности
сингапурск: европой сингапурский разногласия пойти сингапурского клише создание получилось радовало заключается
деятельн: коммерческую
валютн: фондовой
обвин: оппозиционных покончил политиком
гражданин: каждого
крест: крест
порядк: одностороннем
убийств: повешение
зависел: зависело
рецепт: рецепт
половин: четырем значение
всяческ: правительство
продума: лица
университет: специалистов университет
новост: новости новость
перв: успешного первым
непрост: задачу
вестернизатор: однозначным
фабрик: основать
близк: политика
приня: принял встречались
добр: деактивирована добра
написа: главе
поиск: занималось
допустим: свободы
разноглас: возникали
корректирова: уточнялись
равн: показал
прочн: настолько
основ: бойкотов подрывает
повер: поверили
держ: показателю
всеобщ: всеобщих жертву
отставк: подал
противореч: религиозных
образовательн: образовательная первых
как: каких
голос: конвертировались
напомина: политолог
премьер: премьера премьер
повлия: никак
площадк: клиринговой
переговор: пошел
встреча: управляющие
последова: примеру
освобод: открывших
род: родился
высок: самую назначая
оппонент: демарш
реальн: зарплата пожаловать
диснейленд: статью
обход: человеческого
втор: становилось
нефт: века
проводим: одобряли
рол: важную выступал
клиш: общепринятого
точк: чужой
партнер: зарубежных делового
сфер: развивая
однозначн: благой
способ: лучший
мер: репрессивными дисциплинарной исправительных
предприимчив: предприимчивость
напрям: подчинялось
улучшен: роль улучшения
признак: этническому
доказа: впоследствии попытки
компьютерн: основаны начался
учеб: учебу
жертв: принести
сумск: виктор
максимальн: создавая
репрессивн: столько
преобразован: экономических
терроризм: убийство
влиян: усилить
парламент: парламент получала заседания парламентом
независим: законом независимости полную независимым независимое
занят: занятия
образ: таким
тун: ви
учен: словам
малакк: малакка
пояс: часовом
кусочк: важном
советник: наставника
дорог: убедить
аспект: превысило
маленьк: живущие маленькой маленькое
соглас: согласилась
забастовк: забастовки
приобретен: стимулировало
прагматик: госуправлению
успех: успехи одерживали востоковед
появ: реформу знает
практическ: жила
кадров: гражданина
удар: посредством
доступ: собственной
вернут: вернуться
вернул: вернулся
преда: расследовать бун
мид: мгимо
комбинац: ученого
предк: предки
недовер: вотум
послед: преподавателей
утвержда: траур
схем: коррупционных
фондов: значительную функции
распа: распалась
преврат: превратил превратив
личност: объясняется
самоуправля: самоуправляющегося
буддизм: китайцы
редкост: поколении
дава: давала
нефтедобыва: работали
х: х
показа: образом
отправ: отправился коррупции
екатерин: екатерина
поэт: годов
ощущен: ощущение
ассоциир: ассоциируется
ю: ю
квартир: комфортабельные
вывест: позиции
мир: мир мире поиском
рассчитыва: могли
бум: компьютерный
бун: тун тюрьмы
обсужда: отделение
безопасн: десятку безопасности
этап: выполнение
орга: законодательный антикоррупционные
госаппарат: сотрудникам
малайз: малайзия малайзии
многоквартирн: возвели
нажм: опечатку
феврал: февраля
авторитаризм: касается
джентльм: восточный
ранен: получили
провед: постколониальной
малайц: малайцам
власт: власти переговоры малайзийских власть
получ: получил миллиона получившего сотен сосуществования название получить
фронт: социалистический
важн: финансовых арестов заработать играли стратегически важных насколько
провел: провел
одержива: подряд
город: города российских
газет: управлял
экономическ: экономической экономический экономического экономическим управление экономическое основой быстром
национальн: национальный концепция национальную независимо
рук: сосредоточены
профсоюз: профсоюзы
сосредоточ: котором основные
правлен: цифры
ежегодн: ввп
метр: перекусы
отец: отец
уникал: счастливее
диплом: дипломами дипломом
подлин: является
млн: высокооплачиваемых
шанс: этапах
преподавательск: отбор
издан: рубежа
прям: прямом объем
больн: поэтому
повешен: казнь
позиц: стартовые
могл: едва идею
заподозрен: любого
беспристрастн: собственные
движен: движение политические
отстал: отсталую отсталой
повышен: повышения существенное
подписа: подписан подписали
черчилл: черчилль
вынест: предполагает
больш: большей благам большой
миллиард: достигает
китайск: китайский китайское китайскими китайских
мест: хорошем депутатские достигал
начин: преданным
предоставл: приобретение
планомерн: трудная
демонстрирова: единожды
счет: капиталов
карьер: заре карьеру
офис: моего
вход: фактом
направлен: суши
энд: энд
полезн: зеленой
невыгодн: госаппарата
существен: борьбы деятельность
эффективн: беспристрастна наказаниям обеспечил
видет: видеть
смогл: оппозиции сторона
расшир: старался
подорва: подорвано
британц: британцам британцы
редакциярекламаконтактыпресс: отключены
страшн: телесных
ост: ост
кембриджск: многое
жизн: жизни
триллион: прямых
импер: империи
эфир: эфире
приоритет: становится
населен: студентов население трети
формальн: системы
индивидуальн: обучаться
правонарушен: подобные
пыта: сингапурские
сотн: обвинили
момент: момент
авторитет: поскольку
особняк: уличили
высокооплачива: одни
исполня: биржа
заседан: проходят
смог: смог
развива: благополучие имиджа начинала полагал
основн: символические пересечении
преступн: преступность снижает
расследова: позволила
вышл: уровнем
управленческ: скопировал
астафьев: астафьева
развернул: деньги
основа: странах микроэлектроника основал основала инвесторам
преодолева: многие
прибавля: региона
решен: принятии решение решения важным
всерьез: идеи
провод: беспрепятственно
средн: среднего предметы
личн: адресованной интересов росла
чиновник: чиновника взяток доходы неподкупными
меня: планы
незащищен: незащищенности
корейск: память
повыс: выросло
выбира: выбирал программе
убира: необходимо
ввел: правонарушения случилось
выполня: глава
результат: реальные сумскийполитолог устроила
жизнен: жизненной
опыт: кембриджского
одноимен: одноименный
принест: допустимо
дал: индустриальный
эмигрант: эмигранты
смертн: диснейлендом разрешена
богач: миллионы
богат: богата богатой мечтать
пониман: встретили
принесл: принесли
мечта: мечтал дальнейшего
увер: социумов
выросл: чиновников число
мгим: асеан
транспортн: панъевразийской транспортных
кембридж: кембриджа кембридже
менталитет: вопрос
расследован: органы полномочия
имел: напрямую сотрудники помимо
займет: займет
весьм: весьма
дат: новые дата
дач: получении
указыв: бытовую
негодован: встречено
станет: станет
суров: разбились
народн: народности народного
подверга: школьные
распуст: правительству
поручен: недвижимости
разруш: разрушена
заманиван: миру
технологическ: возможен
разрух: разрухе
пожалова: добро
функц: исполняет
вынуд: вынудили
деньг: трущобы
возвел: сроки
пошел: неокрепшей
построен: рассчитывать управления
предлож: смогла
выуч: выучил
старш: старший члена
доступн: строительства
возника: дело
амбиц: арене
владеют: совершенстве
галер: галереи
гореч: горечью
прожива: проживало
многопартийн: присутствовать
продемонстрирова: юг
незакон: обвиняли
сохран: сохранив отставку
беспрепятствен: контроль
глобальн: менеджеров
подключ: пневмонией
политик: доказало политик известных высокопоставленные политикой политику жестким политике
остров: острова островом острове острову
восток: востока
пинанг: пинанг
начат: кабмина
минимум: владеют
окончательн: окончательно
финансов: достаточных
британ: британии
сотвор: сотворить
асеа: эксперт
преподавател: сложности место
чин: соратник
ошибк: заплачу
характерн: государству
правительств: правительства правительством домов недоверия ментором
преступлен: расследовании
гонконг: шанхай
настроен: настроений
жил: часть доступного
начал: начале началу
стара: целью
ван: чин
возвращен: возвращения
клирингов: товарной
заня: избраться позволил заняться председателя
писател: журнал
поколен: каждом
руководств: руководством
бюр: специальный
телевиден: медиакорп
совершенств: обязательным
заподозр: властей
впрям: полагает
пост: пост высокие фигуры
произошл: июля
работник: работникам
итог: итоге
обеспеч: обеспечить подход
вспомина: вспоминает вспоминал
потруд: изрядно
масштабн: проведя
стольк: сцены
ассамбл: ассамблею
финансируем: целостность
дел: элитами вестминстерской
высочайш: высочайшая высочайших
вопрос: авторитаризма
соперничеств: оппозиция
стремительн: стремительно
сохраня: сохранял
игра: городская площадки
внутрен: внутренней влиять
вскор: согласны
устройств: управленческое
пришел: пришел
размер: штраф
элегантн: чистой
антикоррупцион: цену
показательн: наказаний
старшин: лун
проход: дворца проходило
обществ: успеха перестроить напряженность реформирования
никт: редкость
порт: портом порт
полност: полностью
усил: попыток малайзийцев сосредоточил
пространств: общественные
несмотр: несмотря
смекалк: смекалку
госуправлен: подходе
покупк: счет
срок: короткие тюремный
собствен: собственную гласности собственное азиатской
лишен: лишенной
единств: единство
следств: лидеру
британск: британских британский британского британской
японск: японской
территор: территорий
избра: избрали избрав смогли
валда: клуба
уда: выгодное
существован: средства считает
ввп: правления
август: партнеров августа
разнообраз: религиозное
этническ: этнических статуса страну законопослушной
людьм: счастливыми
конкурс: престижной
подчиня: которое
вентиляц: искусственной
целостн: медийная
семидневн: объявлен
обучен: единая
изрядн: пришлось
восточн: восточной благородный
отношен: дискриминации
обогна: пятое
аз: азии европу
арест: показательных
закручива: противоречий
аэропорт: построили дорогу
кита: китай
продл: продлился
заинтересован: развитии
новостройк: современные
коммунизм: идей
престижн: престижных учителя
практик: практикой
фицуил: фицуильям
ряд: ограничение
куа: куан
манер: манер
межэтническ: ранения
досрочн: провести
приказа: коммунизма
транзитн: транспортной
сам: самых ошибку месте
трост: английского
дискриминац: позитивной
жми: жми
японц: японцы
вырос: значительно
подключен: полагается
школьн: дисциплину
школ: школе классов
образован: образование уровень образования
подобн: взятки
трущоб: трущобах ликвидировать
называ: называют палками
выполнен: успешное
управлен: государственного управлении специальное
записк: предсмертной
принят: результате полномочиями
нашл: ооо
социум: азиатских
пресс: государственных
представл: акций
исл: исповедуют
юридическ: юридическом юридической
обыскива: задерживать
пресн: никаких пресной
шелков: новый
ви: среды
заключа: развитых
век: ресурсом
предполага: интереса лейбористов курс
вел: преподавание
начина: технологии
внедр: устройство
вер: верил
западн: эффективность соседей
популярн: личная
вмешательств: ограниченное
чок: преемника
административн: ликвидировали
област: области
научн: научный
барьер: административных
остаток: остаток
достига: примерно должность
добыва: нефть
сво: своими досрочные своим
нача: фирмы начал начали
специалист: числа
реализ: неизменности
перспектив: план колоссальные
станов: бизнесменами обществах
малайск: малайский
го: го
значительн: образованности играет
парт: партии партия главных
лейборист: консерваторов
пневмон: острой
явля: заявив
виктор: валдай
меритократ: принципом
экспедиц: экспедиция
тамильск: тамильский
законч: властями
развит: реальности развития эффективное экономическом экономическому
уголовн: статьям
консерватор: партий
демократ: парламентской
контрол: полный
руководствова: кадровой
строен: ветхих
колледж: колледж колледже
продолж: продолжил сингапурцам
предсто: понял
технолог: компьютерные
нищет: нищеты
задач: важной делало
обществен: развивал развивать
придержива: придерживалась
развив: предвидение
бойкот: всяких
трех: большинства
хвата: людьми
трет: составляли
уил: писатель
ликвидирова: способствовало условия
смогут: смогут
уступа: фондовом
ценност: ценности
базов: доступа
поистин: открывает
истор: историю истории
посвят: посвятил
индекс: миллиардов
парламентск: демократическая основы
довер: доверие
лондон: лондону лондон лондона
двум: двумя
цифр: говорят
швейцар: нидерланды
факт: близких верно
преемник: кабмине
сем: расследование семье индонезию семей
репутац: имел
противовес: признаку
легк: вентиляции бизнес
представител: представителем представители
односторон: федерацию
холдингс: пресс
красн: красным красными
чуд: сингапурском чуда чудо чуде
доход: госслужащим
корпорац: глобальных
чуж: подключение перерабатывать
сингапур: сингапур сингапуре сингапура обретения
депутатск: занять
реальност: суровую мечты
упадк: упадка
наук: наука
контролирова: штрафов
влия: негативно
памя: свежа
позволя: обучения
эпох: эпоха
городск: городской комфортная
социалистическ: оппозиционная
дом: многоквартирных
способн: посты способна
известн: арестовать
оконч: окончил
постав: поставило свободу
сторон: одна
крыл: левое
поддержк: понимание
телесн: выступают подвергался
призна: официально
тогдашн: тогдашний
глубок: глубокого
чут: потрясающее
доб: добиться добился
родственник: семьи
предвиден: чутье
родн: родным
принцип: руководствовался построенная принципов руководствуясь
хорош: хорошие гавань стиля
ив: ив
колон: колонию колонией колонии
ид: коммунистические продвижении любую
подконтрольн: подконтрольными
нац: наций нации
безработиц: безработица
переселен: реновации
оборон: обороне
фундамент: надежный
консолидац: необходима
попыток: оставляли
религиозн: усугублял социальных этническое
школьник: опыта
успешн: важны проконтролировать классом
палк: ротанговыми
обретен: неподкупность
высокопоставлен: советника числе
большинств: систему большинство борьба
сил: расстановку силами
план: вынашивал продуманного плана планом
доллар: десяти
образова: создания
швец: обогнав
арестова: приказал
волокит: бюрократической
регулярн: регулярно
элит: политическими
коридор: транзитным
гроз: виновному
однокашник: моими
составля: пытались млн
информац: сокрытие редакциярекламаконтактыпресс
описа: должен
сосуществован: мирного
выгодн: созданы использовал
больниц: попал
схож: устойчивого
земл: земли землях
негативн: издания
социализм: социализма
неубедительн: выслушивать
столкновен: произошли
оппозицион: главная поддерживали
спуст: спустя
английск: английскую называются английский английском
автономн: автономным
объяв: объявив порядке
перестро: предстояло
требова: требовали
наказан: телесным неизбежностью жестких кодекса
объедин: объединили
оппозиц: системная парламенте
живущ: принадлежности
инфраструктурн: реализуются
граждан: предоставляя астафьевавостоковед гражданами
катастроф: катастрофой
черт: характерная
идет: городах
вотум: вынести
предстоя: министру
например: избегать
вынашива: впрямь
вне: талантливых
самостоятельн: самостоятельного
сумскийполитолог: лидер
миров: крупнейших мировой
увеличен: незаконном
забот: вестернизатором заботиться забота
председател: августе
поставок: поставок
настойчив: настойчивее
акц: половины
сми: сми
надежн: сил формируя надежной
огромн: ввели
заплач: справедливо
польз: чужую
нидерланд: швецию
австрал: австралии
ответствен: положения
вод: пресную воды
федерац: государств федерации
дисциплинарн: признано
стран: страны стране страной расколоть страна парламента стран
вол: воле
стартов: инвесторов
отлич: отличие
уровн: зарплату уровней минимальным
побед: победу победила вскоре
мо: мою аэропорта страшного
полупроводник: производство
местн: авторитетом
сист: выбрал
япон: японией
свеж: обеспокоило
качеств: общество
выживан: бороться
предпринимател: ограничены
выбор: необходимости выборах бойкотировать следующим
постколониальн: разоренной
государств: государства следствие государство государством объединением строем
наскольк: выпускник
реформирован: аспектом
кумовств: процветало
антиколониальн: антиколониальное антиколониальных
раздел: войне
заяв: раскритиковали
лондонск: лондонской
коммунистическ: поддерживающее полуостров
радова: независимость
суэцк: альтернативой
лучш: инвестициях взяв остается
управля: иностранные холдингс
орган: законодательными
борот: предстоит
небольш: выживание
дума: думал
поприщ: поприще
сконча: легких
талантлив: способных
оо: информация
интересн: интересно выбирать
возможн: возможность политическое перспективы
оп: опыт
исповед: преимущественно
дальн: фундамент
политолог: казнью
молод: молодости молодой
четыр: приговорили
американск: запретил
перевалочн: перевалочный
выбра: элемента правящая
неолиберальн: выбрала
открыт: выгодные
увелич: реализации
приговарива: распространены
дает: удовлетворенностью
сердц: сердце
крупн: нпз уступает крупнейшей
сот: погибли
все: стать
дисциплинирова: образованной
китайц: китайцами китайцев ислам китайцам
возмож: сферы
стрейтс: стрейтс
взгляд: взглядов
тюрьм: отправил меры годам
потряса: демонстрировал
прежд: прежде
бывш: бывший
бытов: контролировало
мечт: мечте планете
адресова: записке
стабильн: уникален обеспечивала показывает избирателей
законопослушн: дисциплинированной
опрометчив: фронт
обрел: федеративного
надзор: волокиты
выступа: методисты правительстве
радикальн: принято
уинстон: уинстон
улучша: озеленением
преимуществен: малайзийцы
федеративн: состава
откр: предпринимателей барьеров компания
июл: обществе
миллион: судей будущее
захват: захват захватить
наход: удалось находился
никак: заняли практически
xx: xx
fi: fi
esso: esso
ctrl: ctrl
xxi: xxi
british: british
instrument: instruments
texa: texas
mobil: mobil
wi: wi
wire: wired
shell: shell
cane: caning cane
enter: enter
