жертв: жертвой
обрат: фронт
нейрон: улучшили
случ: совершаются
ру: ру
рф: рф
терроризм: путем
влиян: оценили
студентк: похудения
информацион: администратора
понима: разыскивая
стат: стать отдельной статьи
воен: людей сбу
обычн: обычную
сб: добиться
федеральн: данным
служ: вовк
перееха: переехать
стал: стала собственно отделом
мнен: работу
указан: указанию
жительств: место
нит: искать
объясн: лнр
появ: причастна
удал: пришлось
реализова: месяцы
един: некий
центр: политического политический мозговым
работ: жительства грязную
петербург: петербурга петербурге
экстремистск: экстремистской
вернут: вернуться
арх: архив
экономик: экономика
подпольн: появления
мид: обратилось
радикал: радикалы
александр: александра отставке
радченк: сергей
сто: стоит
манхэттен: жилья
бедер: игорь
утвержда: утверждают утверждает
уроженец: руководит
джон: исследований
вооружен: центра
идентифицирова: средствами
каса: проверяться
осуществлен: действия
макияж: нанесения
взрыв: взрыве взрыва взрыв
арм: армии реализована армия
прогрем: рельсов
личност: раскрыли
санкт: санкт
поезд: сойдет
структур: структурами структуры
высказыван: отмечает
партизанск: многие
макс: максим
сообщ: ряду
котор: которую котором согласно
уб: убит попытались
чьем: возникнуть
пор: тени
мир: мир
укол: популярных
силов: силовые
секретн: выложившего
исследован: международных
связа: снимки связаны
внешност: удивились
безопасн: службы
спецслужб: российским украинских спецслужбы спецслужбами
обратн: руку
манифест: зачитал
проверя: проверяются беглого
отмет: слышал
вагнер: чвк
девушк: девушка
либ: либо
майор: генерал
нажм: опечатку
боец: боец
связ: установили
вперв: следующий
вовк: наталья
оон: сб
ранен: ранения
аналог: проводит
власт: власти
получ: получили сообщил
причастн: доказывают причастности сомнительным
котенк: фамилиями
киевск: ирпень
фронт: кибер ситуацию
генр: имени
михайловгенера: странно
важн: свидетелем
член: матвейчевдепутат
город: снятое
реестр: реестр
беремен: песни
национальн: национальном национальной национальная
вербовк: база
рук: играет
украин: очков украины
чат: публичного
гранат: соседа
отец: отец
свидетел: стали
раскр: сша раскрыла
традиц: традиция
издан: бедеров
выстав: пытаются лидер
прям: акции
сбрасыва: спецслужбам
россиянин: болезни
сосед: бросил
занима: приказам
заявля: прогремит появление
могл: масштаба
добровольческ: сделали добровольческом русским
лиц: физическое скрытыми центр
движен: сомнения
подписа: представители
теракт: существовании теракт теракта теракты
нов: китаем
больш: розыск
мест: узнать погибла
госдум: депутат
част: частью
иде: новость
счет: сбрасывать
устро: устроили
слов: словам
дугин: дугиной дугина
направлен: направленный
фестивал: фестиваля
кана: канал чата
сойдет: самолет
отвлечен: стороной
исполнител: нити
якоб: якобы
везув: вулкана
сдела: заявлять
эффективн: оценил
кровав: кровавые
видет: видеть
грязн: самую
идеолог: идеолога
деактивирова: нажмите
редакциярекламаконтактыпресс: всу
печат: информации
пут: которому
активн: ведут набирать
жизн: жизни
русск: русском запрещенная
самодельн: сработало
деятел: деятеля
зашедш: сфера
ливар: владимир
чвк: уничтоженных
самолет: упадет
фантом: создание
пыта: михайлова
алексе: алексея
узна: зная
летн: внешности
отмеча: стороны
натал: преступления
всеследств: всеследствие
активистк: активистка
путешеств: путешествия
привлечен: привлечением
сожален: тылу
константин: царьград
бесед: вербовки
сторонник: сторонников
ресурс: информационного
сша: обсудить
лидер: лидере ракеты
трепов: трепова
нра: нра
произошедш: произошедшее
техник: техника
тыл: нашем
азамат: адрес
утечк: влияние
журналистк: журналистки
доказательств: никаких
владельц: убить
котовск: котенко
культур: культура
допрос: допросе
доказыва: связанные
удив: наступлении
провод: михайловгенерал
лнр: популярные
личн: продажу лично
номер: вычислили
вечер: вечера вечер
вылож: личность
материа: идея
врач: нато
выполня: выполняющих лицо
результат: результате
удугов: мовлади
попытк: поджоги
матвейчев: олега
документ: секретные утечки
запрещен: организация
предложен: мид
будущ: нейронов
желан: чьему
михайлов: цос
взрывн: самодельное
пономарев: ильи аналогию илье
задержа: высказываний
бандподпол: поиск
террорист: террористов признания
приписыва: исключено
агент: агента
средств: программными
свобод: легионом
розыск: основатель международный
михайл: александр
дан: установочные месте
дар: дарья дарьи дарье
борьб: борьбы
установ: армией
антитеррористическ: антитеррористическом
имен: проблем
отделен: отделение
спецпроект: спецпроекты
зачита: ответственными
генера: лентой
раскрыт: рекорд
следствен: следственный
росс: россии россия сотрудничать
установочн: многое
разыскив: порой
гиперзвуков: новой
мотор: мотор
автомобил: автомобиль автомобиле
извест: статье
ситуац: документов
пожалова: добро
сумел: спецназе
счита: собеседник считают
функц: функции
брат: оппозиция
цел: цель намерения
фбк: фбк
очк: умных
брал: брала кавказ
лент: беседе ленту прим лента
предлож: предложил
публицист: публициста
упадет: случилось
финансирован: возможно
исполнительниц: безопасности
опечатк: нашли
галер: галереи
оцен: украине врач
российск: российского михайлов российской внимания
глобальн: профессор
канал: своем
мозгов: заявления
политик: тупик
множеств: множество
стажировк: стажировку
политическ: глава единый
бедеровосновател: органам
параллельн: лицом
тупик: зашедшей
иностра: противодействию иностранными иностранного
чеченск: самопровозглашенной
обнов: манхэттене
преступлен: исполнительницей преступление преступлению исполнителям преступлениями преступлении
частност: специалисты
серьезн: выдумкой
спецслужбыпреступн: спецслужбыпреступная
использова: фантома
жил: аренды
безусловн: спецслужб
вычисл: удалось канала
программн: своими
пройт: пройти
имарат: главой
наступлен: зеленского
судкриминалполиц: судкриминалполиция
поруч: бедеровоснователь
медиа: пентагона
настоя: настоящее
список: список
кадр: кадр
ссср: ссср
комисс: член
корпус: добровольческим корпусе
строг: действует
след: эстонии строго
дел: имеют дела деятельности
отвед: пономареву
организац: организацией организации организаций террористическая
объявля: попытки
рассказа: канале
игра: громких
устройств: взрывное
попыта: области
кавказ: имарата
активист: активистом
коротк: желанию
проход: проходил
так: булкин
никт: промежуток
вулка: извержение
порт: хотят
творческ: творческого творческий
выясня: выясняла
событ: важного
срок: раскрыты
собствен: акцией портить
баз: большая
запечатл: область
территор: территории
существован: стало
уда: ресурса сожалению
август: августа
дет: будущих
блогерш: летней
назва: впервые союз
снимк: получил
материал: материалы
слыша: никто
собира: собирался
передов: школе
брянск: брянские приграничном
росфинмониторинг: перечень
обсуд: асланов
компетентн: передали
иска: проще
медиаресурс: медиаресурса
игор: розыска
аз: азов
служб: федеральной
собеседник: действиям
квалифицирова: квалифицировал
кита: испытании
навальн: навального
спорт: спорт
район: районе
ряд: интервью
последн: осуществленные рдк
самопровозглашен: печати
заявлен: громкие
месяц: последние
зна: телефона
амфетамин: амфетамин
сам: поручили
набира: параллельно
экстремист: экстремистов
захотел: иран
жми: жми
сбу: брошены
друг: другому
возвраща: возвращалась
переда: данные передала
тайн: силы
школ: киссинджера
сомнева: вмешательству
степен: степени
компан: запечатлен
рассказыва: последнем
программ: россией
склоня: намерениями
минюст: минюстом
ира: макияжа
главн: главное
неожида: неожиданно
действ: спикера прямого любым
приграничн: напали
нашл: ооо
фамил: известный
руковод: деятельностью
сву: устройство
перечен: выполняющее
горя: горящий
имидж: собственный
малофеев: константина
популярн: эффективность детей
декларац: подписали
вмешательств: иностранному
сотрудничеств: декларацию
отдел: обратная
смертельн: язык
област: киевская брянской
спикер: отведена
имеют: понимают
созда: радикальные
пентагон: документы
ран: ранее
сво: подмосковье котовский
тяжест: тяжести
отдельн: рассказывала
специалист: реально
профессор: заслуженный
передач: передача
интернет: интернет
атак: атака
легион: сотрудничестве
ирпен: городе
рекорд: обновила
явля: представителем
бегл: рассказал преступлений
появлен: возможность имидж
татарск: татарского татарскому татарский
осуществ: осуществило
тем: теме
сработа: ним
тен: находятся
выступлен: выступления
основател: быстро
пришл: студентке
полк: полка
фотограф: убийствам
уничтожен: число уничтожение
знал: знала
коррупц: коррупцией
обществен: общественного
запрещ: запрещен
зеленск: потребность
поеха: поехал
прощ: деле
евразийств: евразийства
матвейчевдепутат: олег
киссинджер: генри
адрес: напишите
сомнительн: радченко
цос: везувия
нанесен: блогерши
ценност: ценности
телефон: номер
необходим: необходимо
числ: числа пригожин
напиш: материала
подозрева: подозреваются
поджог: задержанных
пробл: глобальных
подрывн: занимаются активную
вниман: отвлечения
сотруднича: захотел
противодейств: комиссии
сел: села
произошел: произошел
сет: сети
представител: представителей лицами объявлял
виде: видео
спецназ: украинском
минувш: участники
сюжетдиверс: сюжетдиверсии
быстр: вычислить
реальност: эксперт
хопкинс: джона
эксперт: отметил
владл: владлен владлена
депутат: беглый мнению
пономаревбегл: бойцами
рдк: корпусом
аслан: азамат
наук: наука
хот: разведка
булкин: фомина
известн: ливар известно
олег: депутата брать
международн: передовых объявить
залож: заложена
статуэтк: статуэтки статуэтке
резонансн: резонансное
сторон: подпольной украинской
пригожин: политике
обитан: обитания
призна: признан призналась
включ: включен
доб: предложением
серг: хопкинса
хорош: хорошие
стоимост: медианная
сред: среда
ил: малофеева матвейчева госдумы
наш: деятельность
рельс: поезд
улучш: беременности
редактор: редактором
республик: чеченской
погибл: сву
мовлад: пономаревым
мног: работы ленты
выдумк: является
сыгра: сыграли
люб: склонять
спланирова: спланировали
снят: появилось
похуден: уколов
язык: удалить
сил: некой добровольческие
кибер: движение
умн: выпуска
нак: нак
план: раскрывают дело
фот: фото
публичн: идентифицировали
царьград: телеканала
погибш: фотография
нат: личные
информац: редакциярекламаконтактыпресс министром
выгодн: российских
группировк: группировки
соверш: совершен
разн: разной
взял: взяла
приказ: следует
выгляд: центром
скрыт: сумела форме
люд: компании
философ: философа
объяв: террористами
телекана: владельца
максим: погибших
ки: киев
интерв: терроризма
министр: удуговым
куратор: кураторов
комитет: комитете комитет
физическ: пономарев
оппозиц: вооруженной тайная
фсб: фсб
набережн: набережной
администратор: активность
создан: считает
дочер: дочери
военкор: военкора военкор
петербургск: петербургском петербургское
скр: скр
продаж: выставил
напа: марте
прим: акция
согласн: манифест
забот: забота
промежуток: короткий
потребн: объяснили
ведут: безусловно
действова: действовала
масштаб: такого
приеха: удается
акц: оппозиции партизанские назвали
сми: сми
музык: громкой
апрел: апреля
ответствен: ответственность назвал
познаком: познакомилась
союз: пономаревбеглый
заслужен: частности
стран: стране выглядят
аренд: стоимость
диверс: диверсий диверсии
ичкер: республики
громк: гранатой причастность громкими громкому заявляет плане
подмосков: подмосковья теракту
март: марта минувшем
возникнут: могла
испытан: фронте
песн: музыки
войт: войти
еха: ехать
фонд: фонда
глав: ичкерия росфинмониторинга
сомнен: реальности
деятельн: изданию подрывную финансирования
бомб: бомба
агентур: агентуры
фомин: фомин максима
убийств: убийству убийство громким
подробн: подробности
соверша: приписывает
исключ: существует
намерен: планы добрыми
заяв: заявили
болезн: смертельной
украинск: использоваться украинские касается служившая
ракет: гиперзвуковой
республиканск: республиканской республиканская
нек: создали неким выставить
новост: новости события
владимир: уроженец
существ: доказательств
можайск: можайском
орган: компетентным
добр: деактивирована добра приехали
оо: информация
возможн: счетов силой
поиск: выгодно
брош: бандподполья
университетск: университетской
всу: бойцов
брос: россиянин
отставк: майор
как: какую какими
участник: известен
каф: кафе
раскрыва: серьезные
бойц: связь вагнер
террористическ: свобода
выпуск: сроки
бывш: бывшая бывший
реальн: сомневаются пожаловать
рол: роль
радикальн: пономарева
пономар: илья
сфер: программе
разведк: военная
извержен: брал
форм: военной
признан: оон
эстон: скрыться
ри: риа
наход: цели
учрежден: учрежденный
никак: подрывной
погиб: погиб
диверсант: диверсанты
new: news
rt: rt
ru: ru
lenta: lenta
ctrl: ctrl
appl: apple
telegram: telegram
food: food
youtub: youtube
bar: bar
killnet: killnet
street: street
uatv: uatv
english: english
globallookpress: globallookpress
mash: mash
crime: crime
enter: enter
