справок: перевод
ру: ру
говор: основе говорю
человечн: историю
понима: понимаю понимала пациенту понимают
стат: простая статье статьи
леж: лежа
подъемник: подъемник откашливателях
обычн: обычную обычного
оказа: оказали
стар: старых
улож: уложили
вводн: вводных
стал: легче фронте
объясн: лнр
реагир: реагирует
нич: ответили
работ: работу
завис: забюрократизирована
дополнительн: вопрос
арх: архив
экономик: экономика
получен: получение бумаг
сто: качество
манхэттен: жилья
человек: человека
критическ: больницы критическом
наравн: достойную
дыхательн: выживет дыхательных
ветр: макс
интеграц: связанных
макияж: нанесения
встат: встать
нейродегенеративн: нейродегенеративное
присутств: присутствие
должн: должны комиссия
структур: структуры
публикац: публикации
суд: суд
нест: должен
макс: финансово
выкарабка: выкарабкались
запас: запасах
котор: госдуму предоставлять
денег: космических
времен: формально
законодательн: государство
силов: силовые
секретн: выложившего
доста: достать
связа: связалась связала решение
неоценим: неоценимая неоценимый
противопоказа: абсолютно
обратн: едем
двига: двигается
отойт: отойти
либ: либо
целенаправлен: целенаправленно
дела: делать
ребят: ребята
едет: европу
крова: кровать
режим: ручном
разобра: разобрать
доверен: доверенность
прост: простые теоретически
немножк: немножко
врем: времен
россиянин: смертельной
рубл: рублей
сосед: соседи бросил
занима: занимает комитеты
заявля: проблемы
встрет: встретить
позвон: неходячие
выплыва: выплывать
нов: китаем ощутимое
ног: ноги
сверх: сверху
слышат: слышат
госдум: депутат беженцев регулирования
част: часть
законопроект: рассматриваем
алекс: алексей
устро: устроиться
субъект: вопросов
слов: слова
завод: отрегулировано
постоя: выдавать постоянно постоянном постоянного
отказ: отказов
сдела: сделать собрала
откашливател: откашливатель откашливателя кровати
выдава: согласны
невнятн: невнятная
деактивирова: нажмите
сложн: сложные сложное сложно
пут: путях
русск: разговариваю мамы
стабилизирова: стабилизировалось
приставк: приставку
процедур: процедура пройти
подач: прямой
систем: финансовая отработанной
выход: выходит выходят
упрощен: действовать
срочн: срочно
выхож: выхожу
краматорск: краматорска документами
узна: узнала узнают
летн: летняя внешности
натал: людям
выж: выжить
частн: невролога
труд: трудом
трудн: трудно
путешеств: путешествия
сожален: сожалению
лета: ракеты
сша: отключены
машин: машина
немедлен: немедленно
лидер: гиперзвуковой
процесс: процесс
аппарат: идет мешок аппарат
групп: группы
балаших: балашихе
перемен: перемену
техник: техника
заказыва: заказывать
европ: говорили едете
постепен: постепенно
достойн: гражданином
хотел: хотели
размест: разместиться
культур: культура
лнр: популярные
букв: букве
случайн: случайно
обраща: многое обращалась обращались
помоч: помочь
помога: помогают пытаются помогает
вечер: вечером
бюрократическ: бюрократические растягивать
материа: материала
растягива: диагнозами
помощ: помощь помощью помощи
врач: врач врачи консультацию
здоров: здоровье охране
заключ: заключили
отчаян: отчаяние
ведомств: ждать
опасн: опасна склерозом
боков: боковой пациентов
мышц: мышц
кроват: электрической
жител: распоряжение
светла: существует
регулирован: шевченко общефедерального
оплачива: оплачивать благотворительный
средств: взять средств
заклюют: заклюют
отключ: комментарии
спецпроект: спецпроекты
генера: начальника
закон: хуже
плох: плохо
росс: россии россия россию сотрудничать
помогл: сильно
регистрац: временной
фбр: пентагона
выявля: средства
мотор: мотор
нотариус: нотариусов нотариуса нотариусы
ситуац: ситуации усугубило боюсь
перевозк: перевозки
счита: ветров
выжива: выживать
эвакуирова: эвакуировались
задыха: задыхается задыхаться
лент: ленте ленту ленты лента
финансирован: дополнительном
опечатк: нашли
вынужд: объективно
сиделк: сиделку
миграц: миграции
российск: офис территорий российской получать
невролог: врача
уезжа: уезжали
дактилоскоп: взятия
директор: луговая
неинвазивн: неинвазивной
искусствен: аппаратах
врачебн: пациента
иностра: считаются
всяк: кучу
однушк: однушке
юр: юрий
пройт: требуется
примерн: примерно
начнут: увидят
лисицын: павел
сказа: сказали
ссср: ссср
знаком: знакомые знакомых знакомыми
комисс: врачебная
казаков: казакова валентины
кормлен: кормления
тащ: тащить
организац: финансировании
невозможн: невозможно
юрист: рекомендации
отслежива: отслеживающую
параллельмо: параллельмоя
транспортирова: транспортировать
записыва: записываю
так: организовать таких
нормальн: нормальную
мрачнеют: мрачнеют
течен: течение
мощн: мощнейший
блогерш: летней
назва: пригожин
головн: операцию
здравоохранен: числе
умерл: умерла
забюрократизирова: оборудования
подума: думаешь
соглаша: соглашаются
количеств: исходя большое
попа: попал
оформлен: оформление прочем
кратчайш: жизнедеятельности
спорт: спорт
бас: бас
единовремен: единовременную единовременной
специальн: специальные специальный специальную
транспорт: транспорт
разновидн: разновидностей
друз: друзья
зна: знаю
услов: условия
представля: представляете представляю
звон: звонила
друг: голову другим
лисковец: лисковец
бежа: бежала
приход: приходится
теоретическ: здравоохранения
сбор: сбор
поня: поняла
менеджер: менеджером
компан: компанию
благотворительн: шунт
ограничен: людьми ограниченную
электрическ: нивл
программ: россией
тяжелобольн: тяжелобольным тяжелобольные
получа: получила инвалидность
главн: главное главного облегчить
кислород: подачи подключат
фамил: фамилия
страда: страдающим
пят: респираторное
приезжа: приезжают
таис: таисия
состоян: состоянии состояние
девят: девяти
региональн: лисицын
раз: раза
магазин: магазине
созда: решения
паспорт: паспорта
исход: потребности
взаиморасчет: система
интернет: интернет
предоставля: вынужден
общефедеральн: субъекты
московск: частной
всеобществополитикапроисшествиярегионымоскв: всеобществополитикапроисшествиярегионымосква
официальн: официальный
пришл: студентке
полн: полна
знат: можем
беженк: беженке
матрас: матрас
достав: доставить
знан: европе
знал: знала знал
комментар: гранина
беженц: беженцам сложность беженцы видел
сотрудник: приедут пришлют
проч: материалах
сертификат: сертификаты
работа: работает регистрацией
сильн: пособие
загадыва: загадывать
нанесен: блогерши
копейк: копейки
прос: просить
долг: долгое долгая
долж: отнести
вызва: вызвать
услуг: услуги
оставля: оставляю
пособ: российское
необходим: необходима которое необходимое
подходя: подходящего
числ: назвал составе
пятьдес: новых
подозрева: арестовало
вынужден: вынужденных
сложност: главная наблюдаются
сотруднича: иран
комнат: комнат
подава: подавать
виде: видео
остр: остро
нигд: нигде
вруч: вручили
посоветова: появится
выйд: выйду
реб: ребят
необход: необходим
оста: остается остались
быстр: самый
депутат: тумусов
нивл: ивл
тип: вариантов
бумаг: бумагу нужных
реч: речь
общ: общем
пригожин: политике
честн: честно
обитан: обитания
недел: российского
федот: заявляют
включ: включая
амиотрофическ: амиотрофический боковым
повод: поводу
прикреп: прикрепиться
оформ: оформить
материальн: материальную
откос: откос
удобн: удобную быстрый
неходяч: гражданство
сред: среда
соста: состав
расходн: аспираторах
чувств: чувствует
мног: многих медицинская
наблюда: ответственность
снят: снять
похуден: уколов
потреб: потребуется
язык: знания русском удалить
заместител: госдумы
фот: фото
взят: закупку сотрудников
респираторн: заявку
закинул: закинули
взял: взяла
завтр: завтра
документооборот: представить
люд: отказывать
отвеча: организации
пакет: пакеты получается
лагер: лагере
конкретн: конкретно
куратор: куратором
комитет: оказывается председателя
потеря: потерявшим
реанимац: стандартную
волк: волк
героин: героини
растянут: региона
знает: знаете
одн: одна одних одним
мал: малая малейшая
истерик: обратно
мам: родственники мама
продаж: выставил
осмотрет: должна
согласн: минздравы
тоб: тоби
пода: подать
обращен: дней граждане
улиц: улицу
столиц: столице
потребн: рассчитывали объяснили
действова: случае
помощник: помощник
столик: столик
выда: выдают недель выдали
мвд: мвд
расплака: расплакалась
плюс: плюс
находя: находящегося
врод: вроде
запрос: количество
регион: зависит взаиморасчетов
поскольк: поскольку
мокрот: мокрота мокроту
кресл: кресло кресле
горазд: летают
март: марта
передвига: передвигается
испытан: стало
войт: войти
еха: ехали ехать
проща: прощался
фонд: фонд фонда фондом
состав: интеграцией
попад: попадем
сраз: сразу
гражданин: стать
порядк: порядке
валентин: валентина лейтенанта
болезн: болезни
украинск: украинским
всяческ: всяческую
ракет: живы
приедут: опасно
палаточн: палаточном
новост: новости
существ: знать
перв: первой первые первая первое
непрост: непросто
откашля: откашлять
ухудша: ухудшалось
бок: боку
добр: деактивирована добра
основ: платной
держ: держимся
голов: свежую
как: валиться
фиксир: фиксирует
опек: опеки опекой опеку
голос: голосом
паллиативн: законодательно решают оказывающими процедуры
рассматрива: нестандартные госдуме
заполн: заполнила
прошл: прошла
памперс: памперсов
реальн: пожаловать
тяжел: тяжело тяжелых
коляск: коляску коляски
сфер: программе
признан: признанию
аспиратор: аспиратор подъемниках
признак: признаки
ходяч: ходячий
компьютерн: компьютерную
парализова: парализован
рекоменд: например
разговарива: русские разговаривать разговаривали
быва: слабости
обрат: юристов
максимальн: максимально
найт: найти
нереальн: нереальная
заявк: сформировать
влиян: оценили
студентк: похудения
запредельн: запредельна
ждет: дактилоскопии
жительств: жительства
маленьк: маленький маленькую
соглас: согласился
появ: скоро
успех: гарантирует
случа: тупик
удал: пришлось
практическ: практически
доступ: упрощенный
вернут: вернуться
мозг: головном
вообщ: вообще
единствен: единственные
личност: раскрыли
переселенц: переселенцев
шпиц: шпиц
сообщ: сообщили
поэт: поэтому
оформля: местах
квартир: квартире квартиру
вариант: варианта никаких
вывест: вывести
диагноз: диагноз подобным ситуацию
отнест: паллиативного
мир: мир
укол: популярных
срыв: нервного
рассчитыва: покупку
прописк: постоянной
нестандартн: исключаю
внешност: удивились
вагнер: чвк
скор: скорую скорая возможно
девушк: девушка
нажм: опечатку
вытянул: вытянули
получ: получится получить документ
начальник: начальник приемную
перевод: сделала
клиник: московской
фронт: утечки
город: города город
декабр: декабре декабрь
рук: руках
украин: очков украины
столкнул: столкнулись
гранат: соседа
отец: отец
раскр: сша
выстав: лидер
сдава: сдавать
прям: противопоказано менталитет
больн: больные больным больно
ивл: искусственной
измеря: измеряет
могл: могли могла
сдат: сдать
дешевл: дешевле
продуктов: продуктовые
выделя: выделяет
больш: большая директор
щелковск: щелковской
мест: месту сложности места
ждат: тратить
спрашива: спрашивать
соцзащит: соцзащиту
вход: краматорск
офис: лично
направлен: законопроекты
полутораметров: полутораметровый
удаленк: удаленке
эффективн: оценил
запреща: закон
видет: видеть
жизнедеятельн: пациенты
редк: редко редкий
редакциярекламаконтактыпресс: всу
надея: надеялась
видел: здоровья
жизн: жизни
отработа: режиме
зашедш: заявили
формальн: пропиской
сформирова: нуждающимся
чвк: уничтоженных
мог: могу
индивидуальн: рассматривать
пыта: территориях пытались
полноцен: полноценно
мож: обращений
момент: момент
смог: смогу
охран: комитета
основн: основная
вышл: входит
сможет: сможете сможет
поликлиник: поликлинику
неплох: неплохой
преодолева: преодолевать
арендатор: арендатора
утечк: подозреваемого влияние
решен: алгоритм направленные
закупк: такую
удив: сети
почк: почку
провод: начнут
личн: привезти продажу личное
средн: среднем
нужн: нужны пакет
отц: отца рекомендуют отцом
вылож: личность
убира: убирать
финансист: финансист
вызыва: вызывать
объективн: системы
полож: положена
павел: аппарата
недееспособн: недееспособными
дал: дали
документ: документы повториться выдать документов
приезд: ждет
михайлов: михайлова
приезж: приезжих
выплачива: выплачивали
менталитет: страну
вначал: вначале
хозяев: хозяева
жен: жена
собак: собаку собаки
дан: личные
установ: мозге
подрабатыва: подрабатывала
посторон: постороннему
раскрыт: рекорд
донбасс: донбасса
отрегулирова: деле
гиперзвуков: новой
медицинск: доступны медицинского доступ медицинскую медицинских
пожалова: добро
нотариальн: нотариальная нотариальную
деньг: деньги
брат: братом брата брат
жалоб: казаковой
пришлют: позвонили
очк: умных
доступн: стали доступна
увид: диагнозом
спасен: спасение
галер: галереи
оцен: украине нато
политик: зашедшей
полис: полиса
вмест: вместе
уход: уход уходе ухода
финансов: финансовых помогло работать
алфавит: алфавита
зарабатыва: зарабатывать
увидел: увидела
жив: тепле живи посмотреть
тупик: заводит
обнов: манхэттене
жил: жилье жила аренды
вал: известно
ван: ванной
заня: занять занялись
наступлен: зеленского
резервн: дыхательный
медиа: утечке
медик: медика
гарантир: паллиативной
маяк: маяком
полгод: полгода
полза: ползает
стул: стул
минут: истерика
стольк: столько
дел: дело паллиативную
вопрос: вопросы регулированием встанет занимаются вопросам
рассказа: рассказано
стремительн: стремительно
специализир: специализируется
простуд: простуда
ответ: ответил ответить справок
москв: москву москве
никт: никто
полност: полностью
сталкива: сотрудники сталкиваются
срок: кратчайшие
встанет: думаю
покупк: отвечающие
ручн: решается
измен: изменены
уда: удалось
территор: растет жители
алгоритм: удобный
отказыва: запрещает
людьм: распоряжения
материал: расходных материале
ирин: ирина
вентиляц: вентиляции
гранин: приезда
снима: снимаем
отношен: оформляются
иска: искала искали
куп: купить
обща: общаться
саш: саша саши сашу ситуация
куч: пережили
услыша: услышала
кита: испытании
посмотрет: смотришь
район: районе
практик: ним
последн: последние
заявлен: заявление
месяц: месяц месяцев
сам: наравне самое
полугод: полугода
захотел: захотел
жми: жми
организова: пятьдесят
бо: впасть
оказыва: регионами которым
образован: образованию вопросами
подобн: сталкивались
абсолютн: кислород
попутчик: попутчики
давлен: давление
управлен: управления
ира: макияжа
стресс: стресс всякого
нашл: ооо
женщин: женщине
заболеван: заболевание
нервн: пару
складыва: складываются
смысл: смысла
начина: начинает
инвалид: инвалидами инвалиды инвалида инвалидов инвалидам
мешок: резервный
популярн: эффективность музыки
смертельн: смертельно язык
усугуб: стресса
барьер: барьеры
инвалидн: обращаться
пентагон: секретные
спин: спине
сво: своим
уеха: уехать
приемн: обратилась
нача: начались начал
реша: решать ведомства отношении
пациент: обращения необходимо консультируются паллиативные практике
слаб: слабые
специалист: клинике
лежа: лежать
значительн: операция
прода: продать
неразборчив: неразборчиво
исключа: создавшейся
рекорд: обновила
санитарн: санитарном санитарное
нужда: признать нуждаются
вещ: вещами
ощутим: какое
консультац: оплачивал
мыт: мытья
представ: растянуться
переж: медицинской
гражданств: российским жалобой гражданства
контрол: контролем
обеспечен: образования
уничтожен: число
оборудован: оборудование оформления
ежемесячн: ежемесячно
пользова: пользовались
зеленск: потребность
поеха: поехали поехала
хвата: хватает
ценност: ценности
пар: прямо
ед: истерила
треб: требуют беженцами
ел: еле
истор: историей бюрократическую
филипп: филиппов
ход: ходить ходит
двум: двумя
сумочк: сумочку
тепл: живем
легч: гражданством
склероз: склероза склероз амиотрофическим
сем: семьям семье семьи
понесл: понеслось
легк: легкие легких
представител: данные представитель
сет: наступлении
распоряжен: вышло ждите
днр: днр
мастер: мастер
привезл: привезли
чуд: чудо
доход: срыва
курир: курирует
договор: договор
повтор: сашей
наук: наука
дне: сроки
сумм: сумму
платн: денег
хоч: хочу
сумк: сумки
дни: дни
дом: дом дома
способн: способность
известн: количества
погуля: погулять
исполн: исполнился
сторон: стороны
крым: крым
поддержк: поддержки поддержка
смотр: другому
сиж: сижу
призна: осмотреть
обстрел: обстрел
тысяч: тысячи
родственник: родственникам родственниками языка
родн: родных
хорош: хорошие
стоимост: стоимость
пуст: пустить
привезт: посоветовали
защищ: защищены
наш: нашей
улучш: значительно
слабост: минуты
обзванива: обзванивать
плат: плата
умн: выпуска
арестова: фбр
выгон: выгоню
прибор: пяти прибором
маникюр: маникюра
нат: представителей
информац: редакциярекламаконтактыпресс
больниц: гражданами
лугов: наталья
заболел: заболел
трат: типа
выживет: понимаем
забра: забрать
россиян: успех
сашин: сашино
замен: заменили
минздрав: региональные
погод: погоды
дополнен: дополнение
трехкомнатн: трехкомнатную
лейтенант: генерал
хуж: гораздо
собра: получения
граждан: обеспечения иностранными
хозя: хозяев
скаплива: скапливалась
идет: приборы
микроинсульт: микроинсульт
например: критическое
самостоятельн: самостоятельно
живут: живут
забот: забота
расклад: раскладе
рекомендац: индивидуальном
надежд: надежды
приеха: приехавшим приехал
председател: заместитель
сми: сми
огромн: огромное
ма: мае
музык: громкой
ответствен: нести
федерац: федерации
вод: вода
наня: нанять
заплат: заплатила заплатить
стран: страна языке
аренд: медианная аренда
свет: свет
мо: моем
лаш: лашов
громк: гранатой
свеж: утром
качеств: улучшить качестве
наскольк: насколько
государств: россиянам
нехватк: нехватка
проблем: выявляем проблема
заяв: сфера
туалет: туалет
ждит: ничем
владимир: владимир
лучш: лучшем
космическ: стоит
истер: доходило
тумус: федот
дума: человечно думала бывают
корм: кормим
операц: специалист отцу
облегч: пациентам
подключат: реанимацию
оо: информация
возможн: возможностями ограниченными возможность возможностей
всу: бойцов
коробк: коробки
брос: россиянин
утр: подумаю
хочет: хочет
адекватн: адекватные
судебн: судебном
взгляд: взгляд
загруз: загрузили
шунт: установить
бойц: вагнер
растет: запросов
выпуск: раскрыты
выгулива: выгуливать
бывш: бывший
изначальн: изначально
наверняк: наверняка
шевченк: светлана
стандартн: проводить
консультир: находят
выплат: выплаты выплат
июл: июля
ри: риа
впаст: кислорода
наход: помогать находиться
справля: справляемся
никак: никак документооборот
killnet: killnet
ctrl: ctrl
appl: apple
enter: enter
