случ: настроения
ру: ру
говор: осторожно держится взаимодействовать
слух: русский
понима: далее
значен: политическое
стат: статьи
воен: военный частной военно
леж: пассивно
экспорт: экспорт несырьевом
обычн: обычную
европейск: европейские отстаем
нил: бассейна реки
стал: стала поставщиками стало
стабилизир: зернохранилища
поддерж: принципы
вуз: российских российские
центр: центра внешними другим республика внешние
завис: зависят многое
работ: системную
окуна: верующий
дополнительн: увлекательным
север: компании
арх: архив
замедл: игроков
экономик: экономике комплементарные экономика
пандем: пандемии
торговл: долю экономики
инфраструктур: энергетической
пол: оставаться
сто: такую
рудн: факультета
поступ: явиться
лес: сокращение
каса: самое
то: той
проголосова: последний
присутств: аспект
амер: амер
должн: должны должна
структур: структуры
студент: числа предоставить великолепных
колонизирова: пытаться
человеческ: вложения
котор: которое которую вопросы
денег: тратят
провест: порядка
осабаримб: огуаа
саммит: саммита
доверительн: выстроить
силов: силовые
запад: запад условием противостояния
приостановл: приостановлено
гвин: гвинеи
прав: правят инклюзивны
связа: саранчи
природн: беспокоят
атт: квеси
обратн: информации
нараста: египтом
либ: элитами
проект: намерениям российский
связ: экономическим политические связей связях
совместн: совместная
заб: пришел
оторва: элиты
дела: оппозиции тунис
режим: режимы
честност: ждет
навяза: уйти
позитивн: позитивную
исключен: поддержала
рамштайн: формате
увеличива: ежегодно
союзник: союзников ключевой
врем: советских
лин: финансирование
позвол: честности технологии
сосед: проблем
вред: большого
пересмотрел: поставок
лиц: лицом
встреч: церемонии
справедлив: восприятии
православн: переподготовки
крещен: празднования
уровен: уровень
очевидн: внести
нов: президенте новых новые сотрудничестве
внешн: внешней внешняя различными центрами
конгресс: национальный
вшэ: вшэ
част: различных понять часть уязвимых
выпад: подобные воспринимать
цифров: базы
партнерств: стратегическое
традицион: среды облачен
слов: иными
цк: цк
дворц: общины
излож: резолюциях
отказ: понимают
системн: выстраивать инфраструктуры провести
буркин: буркина
сдела: проблему резолюцию факультетах пересмотрели
выдава: оппонентов
абдел: абдель
деактивирова: нажмите
дают: решения
выставк: выставке
пут: ставку путем
разыгра: разыграли
торг: удобрений
фарватер: фарватере
активн: прошлом
пример: хороший советовал
русск: изучение обучение языки
фигурир: риторике
колониальн: копировать
хранилищ: привязанный
выход: оптом
строительств: говоря
вкладыва: вкладывал направление
кооперац: расширение
государствен: государственного
торгов: торговых
частн: сотрудники
труд: разделение
путешеств: путешествия
лета: ворвалась
обрабатыва: обрабатывающей
курс: такими
сша: сша
ресурс: ресурсов
лидер: лидеров египет атта
процесс: замедлить
групп: объединяют
молодеж: золотой
шел: шел
квот: увеличивать
техник: техника
окружа: явления
европ: европе колонизируют франкоязычной
требован: алжире
культур: культура условии
геополитическ: геополитическая
прозрачн: действовать
актуальн: сохраняются
случайн: удачную
помоч: популяции
помога: помогаем
советова: нелояльна
бесплатн: однозначно
рынк: рынков позиции работу торговле рынки
помощ: оказанию
врач: агрономов
выш: говорили
бразил: бразилии
климат: считается начинании
тонк: приглашать
попытк: попытки постколониализм
враг: суммы моего
вклад: забыл
инклюзивн: развивать
промышлен: промышленности
текст: общепонятным
показател: воздержались
задет: говорить
оговорк: ботсвана
будущ: воспитывают будущее качество таком
наоборот: наоборот
шир: февраля
спокойн: руто
каир: урожая
продовольствен: проблемам
фас: фасо
сыр: сырье сырья
интерес: интересами интерес наших институтами интереса интересы
прерва: ввела
конкуренц: сдерживают
инвестиц: касается
средств: средства
арен: арене
нацизм: героизации
борьб: анк пример
танзан: поступила
приобрета: диаспоры
спецпроект: спецпроекты
закон: стандартов
конкурентн: открытыми
осуществля: внутренний
положительн: долларов
плох: рядовых
взаимн: базис
рост: рост роста
росс: россии россия россией россию
обширн: вложить
едв: едва
газ: нефть
мотор: мотор
разорва: уровнях
ситуац: ситуацию ситуация
имеет: любая
вовлеч: нужны
некорректн: запада
счита: традиционно
причин: бедности
рычаг: удержаться
бизнесмен: дипломатов
переломн: переломный
цел: целом цели целей
цен: огромной
воздержа: нескольких
лент: ленте лента ленту
финансирован: сотрудничали получать
руководител: дополнительное
опечатк: нашли
настро: спокойнее
эл: частью
российск: российская возьмите образование языке российской
ган: кост
канал: доверительные
внешнеполитическ: внешнеполитические
уезжа: английском
политическ: гуманитарное торговли политически фотография важнейших
директор: директор
создава: стандарты
золот: африканской
синерг: огромную
сальд: положительное
спор: предметом
конфронтац: навязанной
иностра: усилить осваивают
частност: частности
серьезн: серьезные
налич: хранилищу
использова: использовать
прекрасн: притяжения
логик: врага конфронтационную
шахматн: воспринимает
африк: африке африкой африку африка африки
растущ: растущие
медиаповестк: прозрачно
неоднородн: неоднородное
достаточн: достаточно
примерн: примерно
общин: лидерами
кадр: кадры
ссср: ссср
знаком: технологов
яв: поддержки
слев: слева
институт: инспирируются
аргентин: аргентине
организац: организации
невозможн: почву
концепц: концепции концепцию
логистик: издержек инструментом
злу: сыграть
суверенитет: реализации
квалификац: повышение
эминцимадз: дворце
коротк: план
так: путь уделять доступа поддержит понятнее удивляются
картин: достоверную
поменя: поменялось настройка поменялся
уязвим: изменений чувствует
духанин: дмитрий
событ: сегодняшнее
колонизир: колонии
техническ: технической
баз: доказательной обширная
заметн: заметно добилась
отслеживан: прикладные
внест: выпускники
товар: поставляет
собира: собираемся
ученик: интересах
привлекательн: привлекательна повысить
нанос: вреда
брикс: рамках
обсуд: шварцман
некотор: некоторые
противостоян: втянуть рода
церемон: церемония официальной
остава: конфронтации
спорт: спорт
бедност: истоки
друз: друзья друзей
услов: прокормить отказ благоприятные
стро: строили позволяет стамбул
друг: другими нарастающей многому работать близкий
питер: питер
тунис: марокко
искажа: необходимости
приход: смену
спорн: партнеры
пшениц: требования оружия появилась
сбор: фермер
поня: регионах
фашизм: нацизма
кластер: суверенитета
компан: дипломом военной
программ: дорогостоящая англоязычных
коммуникац: вовлечены коммуникаций
получа: хотите денег
главн: главное
осматрива: осматривает
действ: действуют совершенные проектам
авиаперевозк: нарастила
восприимчив: слух
страда: повестку
наруша: нехорошо
октябр: октября
втянут: последовательно
приезжа: логика
стратегическ: алжир занять системное
состоян: состоянии мониторинга
игрок: игроки конкуренцию
асуанск: асуанской
рад: дали рады
имеют: имеют
привилег: информацию местного
кейп: эминцимадзе
нараст: кратно
отдельн: результатов
занов: попытка
муниципальн: опыт
омдурма: алкамайире
интернет: интернет
реализац: составляющая практическую
колоссальн: оказывается
наращиван: прогресса инструмент
зернохранилищ: построй наличие
тем: освещать шутку
воева: мол
официальн: кииру
великобритан: примеру
пришл: пришли
уделя: уделяют ответственности
фотограф: недатированная
выстраива: сильные
формулировок: зависит
выстро: свете
привлека: программ
поставк: стоимостью
рамк: числе
конкурирова: конкурировать
сотрудник: выигрываем
сильн: сильнее забывать привлекают
работа: линии уезжают
копейк: сделала
долг: огромные
долж: планирования
африканск: африканским язык поддерживал африканском африканского африканских африканские африканскими южно
вызва: вызвано
услуг: медицинских навязывает
эталон: управления
десятилет: рассчитана
капита: человеческий
русл: русло ряд
заинтересова: заинтересовать заинтересована никак заинтересованы
кандидат: кандидат кандидата
оказан: рамштайн
необходим: привилегия африканцев
преподаван: пользоваться
числ: хорошая прекрасные
период: период
пожима: путин
нейтральн: нигерией
модел: постколониальные
вынужден: процесс
сотруднича: сотрудничать ради
вниман: внимание внимания
очеред: очередь
опор: опорой
чита: старшей
виде: видео
обстановк: обстановка
намет: наметились
президентск: президентские
продовольств: продовольствия
оаэ: оаэ
историческ: исторически
процветан: процветании
нынешн: руководителей
оста: данных оставшихся остались
спрос: огромный
враждова: центры
предмет: становится
воспринима: стоит вагнером риторики
объединен: объединением объединенной
оар: оар
распространен: каналы
альтернативн: искать
реч: достигнуть колонизировать
международн: международных конфликтов международной
общ: основана общие находят
залож: финансировании
иран: иране
честн: действия
совпада: совпадают
обитан: обитания
набор: расширяется
поддержива: поддерживают поддерживали поддерживающих брикс
возросл: противоречие
египетск: удается
рек: берегу
воздержива: многие
включ: биобезопасности
болот: метана
сред: окружающей среда среди
алкамайир: нил
устойчив: устойчивую
чувств: соседями
мног: отличие нестабильности газ танзания равняться
нулев: категориями
наблюда: наблюдается
люб: любит украины
восстанавлива: восстанавливается
контакт: дипломатические
язык: русском русского иностранные восприимчивость общий
планирован: горизонт
фот: фото
товарооборот: сальдо
фактор: фактор фактора факторов
происходя: картину
мониторинг: наладить цифрового
взят: многом
правд: правда
избирательн: избирательные
фермер: египетский
алжир: союзник естественно влиянием
планет: планеты
год: годах годы годов
звен: высшего
сдержива: сдерживающих европейцами
конкретн: насколько
портов: оборудовать
облач: харрис
интерв: интервью
министр: министр
акцент: десятилетия
беспоко: волнуют
зачаст: спекуляций
комитет: комитета
ставк: делать
рассужда: рассуждать
подъ: подъем
отрица: западом
прич: причем
ближ: чиновники
волн: темы
одн: одни выпад
мал: мали
постколониализм: проблемой
широк: нашего отдельный
реклам: неплохая
пода: событие
улиц: улице
саранч: голода
выпускник: будущие
действова: позволить
глубж: другому
петр: петр
расширя: наносят студентов юридически
инструмент: важнейшим эффективный упоминается языка
склон: обращена
достоверн: правдивую
плюс: китая
объединя: правило
масл: маслов
апрел: апреля
заработок: рассматривать
участ: участие
траектор: траекторию
устран: преодолении
голосован: упомянули воздерживаются
регион: странах
горазд: гораздо
сентябр: москва
март: марта
войт: войти
спровоцирова: климатический
конечн: выходить
динамик: отслеживание динамика
глав: встречи кенте
состав: составит
глаз: привлекательность
деятельн: деятельность
сраз: конкурентным
порядк: составляет
валентин: думать
непорожн: непорожный
франкоязычн: актуальна
упомина: политических
празднован: воду
половин: половина
похож: похожа
горизонт: вкладывать европу
модерирова: модерировать
вполн: вполне
переподготовк: курсами
начинан: поддержать
благоприятн: создавало
новост: новости
существ: существуют
перв: первую родных первым первая
засух: уровня
посет: посетил
близк: рынок
приня: приняла
добр: деактивирована добра
благоприятств: законов
изменен: климатическими спровоцировал климатических
осужден: резолюции
разноглас: споров
энергетик: энергетике
франц: франции францию
голод: засух
держ: синергию
прокорм: удобрениями
противореч: устранить
как: какую акцент каких какие
освеща: обратной
препятств: честно труда
участниц: правительств
кпсс: кпсс
плотин: плотины
великолепн: добиться развиваются
повлия: повлияла
окупа: вопросе
преодолен: преодоления привязан
рассматрива: зарабатывая
пассивн: доску
дистанцир: повестка
прошл: кения
род: горизонте
высок: товары
оппонент: действиям
калашников: калашникова
реальн: пожаловать
втор: вторая
комплементарн: плюс
нефт: таких
рол: роль роли
точк: точки
дешев: страну
партнер: партнеров партнер партнеру возросло
сфер: сфере
однозначн: сделать
марокк: участвуют
форм: голосования
продукц: знакомить
долгосрочн: долгосрочные лучших
легитимн: легитимное
неоколониализм: термин
термина: портовый
обрат: набор
готов: готовились вузах
максимальн: бесплатным
терроризм: терроризма
влиян: влияния влияние постколониальным
энергетическ: мостов
информацион: января информационных шире
коронавирус: коронавируса
независим: независимость независимыми независимой независимости независимее
ввод: вводить
учет: экономические
ждет: препятствиях
дорог: строительстве
аспект: обсуждаемый
электрификац: электрификации
ребенок: ребенок
появ: сразу появились
случа: случай коем
петербург: петербурге
практическ: фашизма расширять
доступ: препятствиям
вернут: вернуться
климатическ: связано новую потепления хотят
вернул: вернула
конг: болот
предел: позволят
спекуляц: остаются
конфликт: причины
винтовк: винтовку
александр: александр александров
отста: объективно
приглаша: брать
алжирц: времен
санкц: санкции
инвестирова: остальными
харрис: камалы
потреблен: потреблении
стремлен: захватить
макрон: макрон
ожида: ожидать
санкт: санкт
хрущ: хрущев
дава: можем
коммерсантъ: духанин
х: х
вмеша: вмешаться
поэт: поэтому
мир: мир мире
конспект: читает
рассчитыва: рассчитывают
совершен: совершенно намерения
обсужда: широко
безопасн: продовольственная
вагнер: тему двигатель вагнер
скор: скорее
нажм: опечатку
феврал: судан
нелояльн: случилось
джентльм: логику
оон: оон
шутк: злую
кен: новый оговорками
власт: власти
получ: получилось привязывают
французск: коммерсантъ опирались
вложен: финансовой
обращ: глубже
важн: важную основных поставки осуществляются инструментах территорий разорвали пшеницы развитии кластеру
ищет: ищет
экономическ: экономической великолепно экономических экономически давлением широкий вклад
декабр: декабрь
национальн: африканский
рук: пожимает
украин: помощи целостность
ежегодн: необходимо
внутр: враждовать
конфронтацион: отрицают
одеян: традиционное
диплом: возможность
выстав: выставить
рут: уильям
позиц: оставления стратегические
дипл: дешевый
удержа: сил пытаются
мета: выбросы
движен: движений
эмхофф: дуг
повышен: спрос
больш: большие сохраняют очевидного палки приобретают большая
миллиард: миллиарда миллиардов
подготовительн: иностранного
мест: место
дипломатическ: прервала
счет: счету счет
андр: андрей
равня: должен
опт: торгует
направлен: случайность
пристальн: пристальное
эффективн: присутствие
видет: видеть
расшир: взять
мягк: мягкая
ритуа: большому
редакциярекламаконтактыпресс: обсудить
вспомн: заинтересованность
арабск: арабской
жизн: жизни
кит: европейского
экстремизм: экстремизма
населен: населения население
формальн: украине
чвк: чвк
индивидуальн: индивидуальный
сокращен: снегов
проводник: стали
пыта: пытается силами позиций
мож: привилегией
шварцма: валентина
провал: провалились
копирова: случае
медикамент: услуг
мол: текстом
момент: момент момента
американц: приезжают американцев
смож: база
развива: связи либо
основн: ключевые экспорте основное
вышл: вышли вышла
популяц: динамики
категор: мыслят
сторонник: будущих
оставлен: вынужденного
неплох: наверное европейцев
основа: информационная
апартеид: борьбу
решен: кластерные
привязыва: сильно
средн: чиновников
племен: главой
нужн: диплом
советск: советского советский советскому друг
удачн: заработок
аккуратн: аккуратно
почв: технологиями
чиновник: квалификации решают
меня: меняться
нигер: центром нигерии
повыс: политику
ввел: одна
хак: хаким
результат: заметных
объективн: объективный конго юар
турецк: становятся
дав: начинают
рынок: важнейший
сближен: окупается
настройк: тонкая
дал: такого кооперации
явлен: природные
пониман: расширяются
поблагодар: поблагодарили
последовательн: заинтересован
взрывн: взрывной
выросл: выросло
восприят: восприятие общем
повестк: климатическую западная
дан: объективных сталкиваются
удивля: ответ
дат: первых
осторожн: речи
египет: логистике
разыгрыва: лежит
медицинск: оборудования студенты
кор: корее
пожалова: добро
кластерн: медикаментов
привяза: терминал ним
внесен: землепользования
брат: возможности
предлож: гана
достиг: системные
изоляц: изоляции
старш: ученик
дипломат: политиков
галер: галереи
границ: признанные
проявля: проявляется
рядов: климата
незакон: незаконным
англоязычн: внедрили
глобальн: страдает
политик: политика политики молодежи информационную
вмест: вместить
рассчита: медиаповестка
финансов: логистики
зарабатыва: покупателе инвестировать
достич: достичь
муж: эмхофф
правительств: государств
резолюц: осуждающую уязвимой проект
настроен: учитывают
перифер: периферии
начал: начале
ворва: авиаперевозки
инспирир: зачастую
экспертн: экспертном
возвращен: возвращение
отход: некорректно
заня: занял невозможно
путин: владимир
учитыва: оторваны
навязыва: выбор
высш: капитал среднего
преимуществ: преимущество
повернул: повернулась
потеплен: глобального
ориентирова: группы
дел: делят делах
вопрос: ближе конкретно
европейц: плохо благоприятствуют
рассказа: рассказал
игра: играл играет
жит: жить
сохраня: важнее рычаги
внутрен: стабилизирует
десяток: имеет
постр: зерно
пришел: апартеидом
камал: президента
прикладн: включая
доск: шахматную
двигател: реклама
проход: студентам
изучен: изучения высшее
ответ: работаете
кент: одеяние
москв: москве рудн
инд: приходит индия
усил: срок
гидростроител: гидростроитель
сталкива: континент которыми
срок: короткий
собствен: воспринимается собственных
измен: изменить
территор: пределах территория
уда: последнее
расширен: расширении заложены
афросоюз: афросоюзе
абитуриент: русскоговорящих
целостн: признать
восстановлен: восстановление
смен: инвестиций
доказательн: хватает
обучен: рынках смогут
отношен: отношений отношения отношениях отношении отношение
иска: великобритании
турц: турции турция сторонников
базис: свой
землепользован: культуры
кита: долги китай
заинтересован: взаимная строить
мысл: партия
практик: проходить
ряд: ряда контакты
последн: лидер сближение партнерство
квес: осабаримбой
сам: рынке
жми: жми
возлага: возлагает
членств: членства
потребител: конечного
школ: больницы
оказыва: относиться
недатирова: севере
самм: саммит
подобн: возможны
образован: квоты
давлен: колоссальное сделал
управлен: муниципального
влож: преподавание
нашл: ооо
записа: записаны
женщин: женщина
юридическ: практику
снег: таяние
начина: американцы
стандарт: удержать французские
внедр: вузы
очередн: очередной
вер: православный
западн: западных западными западные раздувать климат
вес: веса вес
сотрудничеств: сотрудничества дистанцируются сотрудничество
заведом: вносят
приоритетн: приоритетному
минеральн: минеральных
кампан: кампании
сво: поведения происходящего
взаимодействова: элит
распределен: справедливости
нача: начал
эммануэл: эммануэль
реша: проблемы непонятно
посольств: посольств
забыва: важно
станов: турцией нила становились
оруж: покупатель
го: муж
парт: разыгрывается
прода: зарабатываем
дорогостоя: ценой
энергоносител: энергоносителей
теря: европа больший
развит: развития ровные развитие
правдив: давать
интенсивн: интенсивность
нестабильн: политической
оборудован: турецкого
предсто: предстоит
технолог: врачей технологий потребителя состояния
факультет: подготовительных медицинского
задач: противостояние задачи
происход: получают
придержива: услуги
пользова: языкам
различн: ориентированные воды
хвата: неплохо
трет: третье третья
уил: кении
континент: неоколониализм континенте континента
достигнут: рынками
смогут: большой
ценност: ценности
сегодняшн: какое
зерн: продаешь
исток: безопасность
истор: истории
зрен: зрения
увлекательн: максимально
ботсва: либерия
тепл: теплые алжирцы
пробл: решать десяток
внос: показатель
героизац: осуждением
репутац: спорной
уйт: задача
налад: помочь
сет: расширила
метропол: бывшие метрополий
всплеск: всплеск
юар: связям
естествен: пшеница
виц: вице
нескольк: исключением
урож: сбора
несырьев: речь
наук: наука
стрем: стремится
прогресс: достиг
хот: давить изменениями
позволя: экономический
сумм: нулевой
мост: дорог
дол: теряют
способн: способна
поддержа: колонизаторами практически
покупател: метрополии стратегический
сторон: стороны
сальватор: судана
кратн: сеть
интеграцион: интеграционным
сид: конспекты
поддержк: поддержке форма поддержку
гамал: гамаль
предостав: компаниях
остальн: происходит
призна: нарушать границы
раздува: вагнера
пройдет: пройдет
предпосылк: предпосылки
доб: копейки поменяв
принцип: изложены
родн: коммуникацию
хорош: важны бизнесменов хорошие
стоимост: добавленной
колон: задеть
никит: никита
из: стремление
ледян: окунается
бассейн: частях
опира: прежде
предыдущ: выступала
наш: западным выше проводниками
ин: интересов
общепонятн: заведомо
возьм: формулировок
республик: республики африканская
демограф: демографии
сыгра: наращивания
школьник: русскоязычных
успешн: успешно
палк: делают
обретен: обретения
выгод: выгоден
большинств: заинтересованности большинство
сил: силы света индией сила изо
план: долгосрочный
доллар: зарабатывает
швец: дания
элит: большинстве будущими
оборудова: зернохранилище
держав: державы
составля: товарооборот важнейшая
гуманитарн: важнейшее
информац: искажать редакциярекламаконтактыпресс распространения
выброс: лесов
выгодн: подать алжира
больниц: строит
поставля: основном
предотвращен: предотвращение
диаспор: теряет
ключев: репутацией вспомните
трат: выгодно
противник: нашим
берег: сидя
биобезопасн: важнейшие
забра: забрать
господн: крещения
ровн: нейтральные
колонизатор: бывшим
английск: получив
киир: сальваторе
огуа: племени
добавлен: высокой
оппозиц: альтернативные
ко: придерживаться
притяжен: центр
младш: младший
русскоговоря: школьников
идет: идет
производствен: производственного
например: например
подготовк: французском
робк: робкие
воспитыва: школы
самостоятельн: самостоятельнее самостоятельной
миров: мировых мировые мировой
стамбул: летают
забот: забота
африканц: африканцы швеция обучения африканцами
издержек: учетом
понятн: африканцам
надежд: надежды
секретар: секретарь
президент: президент руку го предыдущем
председател: председатель
поставок: условия
сми: сми
огромн: дают нынешних программа наращивании
осужда: проголосовал
ма: каир
ответствен: распределения
федерац: федерации
вод: ледяную мониторинг
союз: союз союза союзу союзом
стран: странами страны другую странам страна стран многих
январ: господня
уровн: уровне силу давление
отлич: последних
свет: выгодном частей
побед: победу
мо: враг
таян: разногласий
южн: относятся президенту
местн: внутри местные глазах
осваива: абитуриентов
либер: американской
насер: насер
укреплен: укреплении
зарабатыв: словами
отобра: сможем
качеств: обратить
участв: формально
разделен: международное
прошел: прошел
дуг: джентльмен
утрач: утрачена
выбор: собственный выборы
постколониальн: борьбы колониальные
государств: государства глав
наскольк: голосование
кост: кейп
ни: ниу
проблем: эталон сталкивается проблема таким
намерен: выдавать своим
поставщик: продукцией
удобрен: внесения значение
угроз: угроз
выигрыва: поле
об: оби
владимир: ритуал
лучш: отобрать
снайперск: снайперскую
борот: бороться
агроном: готовить
дума: склонен настроен
формат: выпады
относ: пониманием тепло
оо: информация
возможн: думаю реализацию дать
оп: звена
американск: русле
открыт: открытия сделали
увелич: увеличилась
буквальн: буквально
направ: направо
все: всей
упомянул: мая
дмитр: сентября
соч: сочи
анк: конгресс
взгляд: взгляд
суда: омдурман южного
растет: растет
риторик: участниц отходить
прежд: пшенице
наверн: противникам
миротворческ: миротворческая
поведен: модели
бывш: бывших предложить бывший изменения
становлен: становлении
выступа: активно
июл: июле
эстон: эстония
захват: заново
наход: находятся местных находился
русскоязычн: подготовка
египт: египта экономическое египте
нехорош: воевать
никак: инструменты
термин: фигурирует
непонятн: китаем
airlin: airlines
savostianov: savostianov
ctrl: ctrl
roger: roger
getti: getty
chirikov: chirikov
franc: france
nurphoto: nurphoto
enter: enter
sophi: sophie
ani: anis
franci: francis
french: french
bensemra: bensemra
ii: ii
armi: army
pool: pool
zohra: zohra
sergei: sergei
garcia: garcia
keyston: keystone
ap: ap
kokoroko: kokoroko
reuter: reuters
turkish: turkish
imag: images
dmitri: dmitry
gamma: gamma
