встал: встали
случ: случилось
всесвятск: всесвятской
слух: слухи
расцвечен: расцвеченных
банк: банках
стар: старому старый
пароход: пароходы
оказа: оказалась
обычн: обычные
подыма: подымался
окн: окна
рабоч: рабочий
конч: кончилась
горожа: горожан
стал: стали стала
маленьк: маленьких
ката: катались
отметк: отметки
случа: случае
центр: центре центр
частичн: частичное
эйн: эйнем
мародер: мародеров
берсеневск: берсеневской
арх: архив
правов: правовая
привлеч: привлечены
метеоролог: метеорологи метеорологов
вокзал: вокзале
сапог: сапоги
водн: водной
сто: стоит
визжа: визжали
разноцветн: разноцветными
пожарн: пожарные
вообщ: вообще
слома: сломанными
туч: тучи
пункт: пункте
единствен: единственным
лет: лето
москвич: москвичей москвичи москвичам
преврат: превратилась превратился
веревк: веревками
спада: спадала
валер: валерий
поезд: поезда
регулир: регулируют
дава: дававшая
крепк: крепкими
гудел: гудели
вывес: вывесило
сообщ: сообщило
серенад: серенад
запас: запасы
бурт: бурт
котор: которое котором которым
квартир: квартир квартиры
несл: неслась неслася
времен: временем
двер: двери
здан: здания
мин: мин
ветер: ветер
дрожа: дрожал
писа: писал писала
бурн: бурные бурным
продава: продавались
ящик: ящики
водоотводн: водоотводном
репортаж: репортаж
доста: досталось
истринск: истринское
прав: права
этаж: этажей этажах этажа
клев: клева
ламп: лампы
скор: скорее
нажм: нажмите
весл: веслами
резк: резкий
ушл: ушла
весн: весна
тревожн: тревожнее
прозева: прозевали
власт: властей власти
мордаст: мордасти
крича: кричали
устоя: устояла
французск: французского
раствор: растворились
несущ: несущиеся несущий
киевск: киевском
провел: провели
устраива: устраивали
город: город города городе
репортер: репортер
газет: газете газеты газета
проснул: проснулось
скарб: скарбом
вдол: вдоль
расхвата: расхватали
льдин: льдин
метр: метров метр
зал: залила
рубл: рублей
площад: площади
свободн: свободной
светл: светлое
могл: могла
справедлив: справедливости
лиц: лица
двинут: двинуться
заработа: заработали
хх: хх
уровен: уровень
безудержн: безудержному
нов: новые новейшей
нарушен: нарушений
кстат: кстати
больш: большая
хорошевск: хорошевской
балчуг: балчуга
мест: местами местах мест
натужн: натужно
част: часть части
ждат: ждать
порядок: порядок
счет: счета
уезд: уезда
опубликова: опубликовано
слов: слово
завод: завода завод
пострада: пострадал пострадавшим
сдела: сделано
отда: отдали
художник: художника
плеска: плескалась
поднож: подножия
расшир: расширили
цар: царила царе
вспомн: вспомнила
камн: камни
видел: видел видела
пут: пути
драматическ: драматический
окружен: окруженные окруженного
свыш: свыше
загна: загнали
русск: русское
лодк: лодки лодка лодках
ноч: ночь
граб: грабят
природ: природу
батюшк: батюшке
кремл: кремля
злобн: злобной
спасан: спасания
особняк: особняки
лишн: лишним
проезд: проезд
трудн: трудно
нема: немало
арбат: арбат
бородинск: бородинский
константин: константином
ушков: ушкова
поведа: поведал
мослентыподписа: мослентыподписаться
шел: шел
окрестн: окрестности
дошл: дошло
кондитерск: кондитерской
достойн: достойная
сахарн: сахарного
бесследн: бесследно
владельц: владельца
размест: разместило
комментирова: комментировать
христов: христово
завал: завалены
нрав: нрав
укроща: укрощать
бедолаг: бедолагам
храбрец: храбрецов
помощ: помощи
белокамен: белокаменной
ушаков: ушакова
джунковск: джунковский
дорогомилов: дорогомилова дорогомилово
сооруж: сооружены
передвижен: передвижения
маслянист: маслянистой
выступ: выступила
проеха: проехать
айвазовск: айвазовского
склад: склады
враг: врага
лом: ломая
витрин: витрины
буйн: буйный
малин: малину
тасс: тасс
текст: текст
глух: глухо
жител: жители
лодок: лодок
колыхан: колыханье
укреп: укрепили
наоборот: наоборот
взор: взору
словн: словно
задержа: задержать
бешен: бешеный
керосинов: керосиновые
елизавет: елизаветой
затопл: затоплен
средств: средств
трубн: трубную
дам: дамы
сапер: саперы
суббот: субботы
отключ: отключить
парийск: парийский
весьм: весьма
хамовник: хамовники
отделен: отделение
генера: генерал
ехидн: ехидной
негодован: негодование
стихотворен: стихотворение
толп: толпа
замосквореч: замоскворечья замоскворечье
лужник: лужники
волост: волости
камен: каменного каменном
освобожден: освобожденные
извест: известие
кор: корить
медлен: медленно
виноват: виноватых
прибыва: прибывала
построек: построек
цел: целях целого
цен: цену
брал: брала
окон: окон
устьинск: устьинский
опечатк: опечатку
безрассудн: безрассудных
катаклизм: катаклизмов
российск: российской
безумствова: безумствовала
сохран: сохранились
канал: канале каналами
политик: политика
множеств: множество
княгин: княгиней
вмест: вместо
уход: уходили
перепуга: перепуганные
полиц: полицию
мостов: мостовых мостовой
коммерческ: коммерческих
жив: живое
лавк: лавках
горожан: горожанам горожане
серьезн: серьезных
удочк: удочкой
терехов: терехово
неописуем: неописуемая
якиманск: якиманской
продолжен: продолжение
соболезнован: соболезнования
многочислен: многочисленных
сладк: сладкая сладкой
поруш: порушено
княз: князем
жертвовател: жертвователей
слеп: слепую
выключ: выключена
кадр: кадры
бревн: бревна
паровоз: паровозы
воскресен: воскресенье
освещен: освещения
энерг: энергию
ссср: ссср
корпус: корпуса
выдел: выделите
вспомина: вспоминал
след: следы следует следующее
сокол: сокола
строк: строки
жарк: жаркая
стремительн: стремительно
заряд: зарядье
константинович: константиновичем
вскор: вскоре
развлечен: развлечения
озер: озера
доск: досками
губернатор: губернатор
так: такого таких
обывател: обыватели обывателей
письмен: письменного
москв: москвы москву москве москва
никт: никто
обществ: общества
картин: картина
храм: храма
копирован: копирование
редакц: редакции редакция
зеркал: зеркале зеркалом
бульвар: бульвар
станц: станция
смея: смеялись
мощн: мощное мощнейшее
красот: красота
уда: удалось
тая: таять
переулк: переулков
заметк: заметки заметке
материал: материалы материалов
христ: христа
поднима: подниматься поднималась поднимали
зажжен: зажженными
брянск: брянском
откуд: откуда
некотор: некоторых
решеток: решеток
иска: искать
мчс: мчс
кур: курили
аэропорт: аэропорта
твор: творились
кинохроник: кинохроники
район: район
баш: башен
пощад: пощаде
зна: знаем
услов: условия
сам: самое
ворча: ворчала
кист: кисти
друг: другого
возвраща: возвращались
поприбра: поприбралось
приход: приходили
невниман: невнимание
затоплен: затопленные
сбор: сбор
окрест: окрест
народ: народ
извин: извините
электрическ: электрическая
вчер: вчера
бочк: бочками
поспешн: поспешно
несравним: несравнимо несравнимое
действ: действующим
беспощадн: беспощадно
нашл: нашли
вскач: вскачь
грабител: грабителей
ва: ва
поскуп: поскупился
нервн: нервно
пят: пятую
велик: великой великим
низк: низких
пресн: пресню
снег: снег
век: века
укрот: укротили
фонар: фонарями
рузск: рузское
павелецк: павелецком
прогноз: прогнозам
болотн: болотной
залит: залитой залито
девят: девяти
коллектор: коллектор
гондол: гондол
мужчин: мужчины
рад: ради
исчеза: исчезали
магазин: магазинов
церкв: церквей церкви
ран: раннее раннего
уеха: уехали
сво: свой
нижн: нижних
нын: ныне
нача: начал начался
сток: стоки
слаб: слабее
деревн: деревни
обломк: обломки
необычн: необычно
московск: московского московские московское московский
лавок: лавок
бега: бегали
припас: припасов
унесл: унесло
напор: напором напора
полн: полное
бед: беды
спаст: спасти
переж: пережила
угрожающ: угрожающе
нависл: нависли
сайт: сайта
выруч: выручить
оборудован: оборудование
различн: различным
сильн: сильного сильных сильным
гранитн: гранитными
фотографическ: фотографических
русл: русло
раззя: раззяв
оказан: оказанию
телефон: телефон
истор: истории история
зацеп: зацепу
устав: уставая
разрез: разрезая
верхн: верхней
дворянств: дворянство
озернинск: озернинское
пожелтел: пожелтели
клуб: клубиться
несчастн: несчастного
беш: бешено
раушск: раушской
автор: автор
убыва: убывать
вид: вид
конфиденциальн: конфиденциальности
захар: захаров
распоряжен: распоряжения
унесен: унесенным
разрешен: разрешения
громадн: громадные
забива: забивались
изгна: изгнанные
краск: краски
нынешн: нынешнего
километр: километров
оста: остались
быстр: быстро
кубе: кубеев
брызг: брызг
виновн: виновные
полянк: полянка
памя: память
разреш: разрешено
ненадежн: ненадежный
дне: дней
сумм: суммы
мост: мосту мосты моста мостах мост
платк: платками
крыш: крышах
переезд: переезде
дом: доме домов домах дома
посмеива: посмеивался
известн: известного
общ: общем
сторон: сторон
цитир: цитирую
поток: поток потоки потоком
прелюд: прелюдия
страдан: страданиями
маринист: мариниста
резинов: резиновые
рек: реку реки река реке реках
тогдашн: тогдашней
глубок: глубока
дня: дня
федоровн: федоровной
защищ: защищены
мневник: мневники
бассейн: бассейна
сред: среди
маха: махали
ил: илом
денежн: денежных
жут: жуть
устраша: устрашающая
плащ: плащи
мног: многие
наблюда: наблюдали
неосторожн: неосторожных
неглинк: неглинку
стих: стихия стихию стихии
третьяковск: третьяковская
фот: фото
стил: стилю
самотечн: самотечную
погибш: погибшим
стенк: стенками
информац: информация
керосин: керосин
земл: земли
москворецк: москворецкой
уцелевш: уцелевшим
берег: берегов берега
дожд: дождь
ровн: ровно
спуст: спустя
впор: впору
огн: огнями
скрыл: скрылась
двор: дворов
вмиг: вмиг
открыва: открывался открывались открывалась
зевак: зевак
требова: требовали
законодательств: законодательством
отража: отражались
безучастн: безучастно
комитет: комитеты
упа: упал
капитулянт: капитулянты
водохранилищ: водохранилища
набережн: набережным набережной
размещен: размещение
навоз: навоза
текл: текли текла
вывод: выводов
участлив: участливо
упл: уплыли
черт: черте
привод: приводили
затопля: затопляла
затоп: затопило
волн: волны
одн: одним
бенгальск: бенгальскими
широк: широка
смыв: смывая
никола: николай
реклам: рекламу рекламы
почуя: почуявши
страх: страха
понятн: понятно
улиц: улица улиц улицы
пароходн: пароходного
отпущ: отпущены
столиц: столица столице
соответств: соответствии
сооружа: сооружаться
краснохолмск: краснохолмского
приеха: приехали
пожертвова: пожертвовал
выда: выдалась
подземн: подземный
губернск: губернский
подня: поднялся
апрел: апреле апреля
стен: стен стена стены
стихийн: стихийное
ответствен: ответственности
вод: вода вод водах воды воде водой
федерац: федерации
наводнен: наводнение наводнения наводнении наводнений
заплат: заплатила
предупрежда: предупреждали
свеч: свечами свечи
гнев: гнев
вол: волю
буйств: буйству
использован: использования
неведом: неведомо
душ: душу
моля: молящие
страстн: страстной
сидел: сидели
корреспондент: корреспондент
существова: существовало
лошад: лошади
венец: венеции венецию
состав: составы
ливн: ливней
счаст: счастью
дул: дул
желт: желтые
унос: уносили
обнаружен: обнаружения
выражен: выражения
барж: баржи
угроз: угрозой
жела: желала
располага: располагавшийся
нек: некому
новост: новости
владимир: владимир
бог: богу
можайск: можайское
неглин: неглинный
фабрик: фабрики
ок: ока
присла: приславшее
государ: государь
партнерск: партнерские
ошалел: ошалелые
крайн: крайне
возможн: возможности
интересн: интересного
галере: галерея
выбра: выбраться
кремлевск: кремлевской
повер: поверить
кадаш: кадаши
утр: утро утра
расщедр: расщедрился
боя: боялся
пассажир: пассажирами пассажиры
как: какую
засмалива: засмаливались
сочувств: сочувствия
голос: голос
сокруш: сокрушая
плотин: плотины
гепнер: гепнера
кирпичн: кирпичная
химическ: химический
упомянут: упомянуть упомянутым
перепачка: перепачканы
бедств: бедствие
пустын: пустынной
прежд: прежде
втор: второго
тяжел: тяжелую
круг: круги
лома: ломают
изображен: изображений
спасител: спасителя
мертв: мертвого мертвое
откр: открылись
способ: способом
усест: усесться
полицейск: полицейские
ри: риа
прошляп: прошляпили
одежд: одежды
никак: никаких
мослент: мослента
страст: страсти
повылетел: повылетели
aa: aa
getti: getty
art: art
rss: rss
moslenta: moslenta
fine: fine
ctrl: ctrl
telegram: telegram
imag: images
enter: enter
heritag: heritage
